PokerStars Hand #98794686061: Tournament #734961465, $0.23+$0.02 USD Hold'em No Limit - Level I (10/20) - 2013/05/19 9:46:11 BRT [2013/05/19 8:46:11 ET]
Table '734961465 2' 9-max Seat #1 is the button
Seat 1: ximenes.cr (1500 in chips) 
Seat 2: guma475 (1500 in chips) 
Seat 3: LuckyDayRS (1500 in chips) 
Seat 4: llleopold (1500 in chips) 
Seat 5: dfcastro.net (1500 in chips) 
Seat 6: rifkat_ham (1500 in chips) 
Seat 7: Fauxpas123 (1500 in chips) 
Seat 8: 1DMITRYSPb1 (1500 in chips) 
Seat 9: masha02468 (1500 in chips) 
guma475: posts small blind 10
LuckyDayRS: posts big blind 20
*** HOLE CARDS ***
Dealt to dfcastro.net [5h 5c]
llleopold: folds 
dfcastro.net: calls 20
rifkat_ham: folds 
Fauxpas123: calls 20
1DMITRYSPb1: folds 
masha02468: folds 
ximenes.cr: folds 
guma475: calls 10
LuckyDayRS: checks 
*** FLOP *** [7c 4h Ac]
guma475: bets 20
LuckyDayRS: folds 
dfcastro.net: calls 20
Fauxpas123: folds 
*** TURN *** [7c 4h Ac] [Td]
guma475: bets 20
dfcastro.net: calls 20
*** RIVER *** [7c 4h Ac Td] [9h]
guma475: bets 20
dfcastro.net: calls 20
*** SHOW DOWN ***
guma475: shows [2h As] (a pair of Aces)
dfcastro.net: mucks hand 
guma475 collected 200 from pot
*** SUMMARY ***
Total pot 200 | Rake 0 
Board [7c 4h Ac Td 9h]
Seat 1: ximenes.cr (button) folded before Flop (didn't bet)
Seat 2: guma475 (small blind) showed [2h As] and won (200) with a pair of Aces
Seat 3: LuckyDayRS (big blind) folded on the Flop
Seat 4: llleopold folded before Flop (didn't bet)
Seat 5: dfcastro.net mucked [5h 5c]
Seat 6: rifkat_ham folded before Flop (didn't bet)
Seat 7: Fauxpas123 folded on the Flop
Seat 8: 1DMITRYSPb1 folded before Flop (didn't bet)
Seat 9: masha02468 folded before Flop (didn't bet)



PokerStars Hand #98794749556: Tournament #734961465, $0.23+$0.02 USD Hold'em No Limit - Level I (10/20) - 2013/05/19 9:47:58 BRT [2013/05/19 8:47:58 ET]
Table '734961465 2' 9-max Seat #2 is the button
Seat 1: ximenes.cr (1500 in chips) 
Seat 2: guma475 (1620 in chips) 
Seat 3: LuckyDayRS (1480 in chips) 
Seat 4: llleopold (1500 in chips) 
Seat 5: dfcastro.net (1420 in chips) 
Seat 6: rifkat_ham (1500 in chips) 
Seat 7: Fauxpas123 (1480 in chips) 
Seat 8: 1DMITRYSPb1 (1500 in chips) 
Seat 9: masha02468 (1500 in chips) 
LuckyDayRS: posts small blind 10
llleopold: posts big blind 20
*** HOLE CARDS ***
Dealt to dfcastro.net [2d Qc]
dfcastro.net: folds 
rifkat_ham: folds 
Fauxpas123: calls 20
1DMITRYSPb1: folds 
masha02468: folds 
ximenes.cr: folds 
guma475: calls 20
LuckyDayRS: folds 
llleopold: raises 80 to 100
Fauxpas123: calls 80
guma475: calls 80
*** FLOP *** [6d 8s Th]
llleopold: bets 210
Fauxpas123: folds 
guma475: calls 210
*** TURN *** [6d 8s Th] [5h]
llleopold: bets 496
guma475: calls 496
*** RIVER *** [6d 8s Th 5h] [Ad]
llleopold: checks 
guma475: bets 20
llleopold: calls 20
*** SHOW DOWN ***
guma475: shows [Kd 9c] (high card Ace)
llleopold: shows [Jd Js] (a pair of Jacks)
llleopold collected 1762 from pot
*** SUMMARY ***
Total pot 1762 | Rake 0 
Board [6d 8s Th 5h Ad]
Seat 1: ximenes.cr folded before Flop (didn't bet)
Seat 2: guma475 (button) showed [Kd 9c] and lost with high card Ace
Seat 3: LuckyDayRS (small blind) folded before Flop
Seat 4: llleopold (big blind) showed [Jd Js] and won (1762) with a pair of Jacks
Seat 5: dfcastro.net folded before Flop (didn't bet)
Seat 6: rifkat_ham folded before Flop (didn't bet)
Seat 7: Fauxpas123 folded on the Flop
Seat 8: 1DMITRYSPb1 folded before Flop (didn't bet)
Seat 9: masha02468 folded before Flop (didn't bet)



PokerStars Hand #98794787308: Tournament #734961465, $0.23+$0.02 USD Hold'em No Limit - Level I (10/20) - 2013/05/19 9:49:04 BRT [2013/05/19 8:49:04 ET]
Table '734961465 2' 9-max Seat #3 is the button
Seat 1: ximenes.cr (1500 in chips) 
Seat 2: guma475 (794 in chips) 
Seat 3: LuckyDayRS (1470 in chips) 
Seat 4: llleopold (2436 in chips) 
Seat 5: dfcastro.net (1420 in chips) 
Seat 6: rifkat_ham (1500 in chips) 
Seat 7: Fauxpas123 (1380 in chips) 
Seat 8: 1DMITRYSPb1 (1500 in chips) 
Seat 9: masha02468 (1500 in chips) 
llleopold: posts small blind 10
dfcastro.net: posts big blind 20
*** HOLE CARDS ***
Dealt to dfcastro.net [5d 3s]
rifkat_ham: folds 
Fauxpas123: calls 20
1DMITRYSPb1: folds 
masha02468: folds 
ximenes.cr: folds 
guma475: folds 
LuckyDayRS: raises 50 to 70
llleopold: folds 
dfcastro.net: folds 
Fauxpas123: calls 50
*** FLOP *** [Qh Qd Tc]
Fauxpas123: bets 60
LuckyDayRS: raises 60 to 120
Fauxpas123: calls 60
*** TURN *** [Qh Qd Tc] [8h]
Fauxpas123: bets 100
LuckyDayRS: raises 220 to 320
Fauxpas123: calls 220
*** RIVER *** [Qh Qd Tc 8h] [Kd]
Fauxpas123: bets 120
LuckyDayRS: raises 840 to 960 and is all-in
Fauxpas123: folds 
Uncalled bet (840) returned to LuckyDayRS
LuckyDayRS collected 1290 from pot
LuckyDayRS: doesn't show hand 
*** SUMMARY ***
Total pot 1290 | Rake 0 
Board [Qh Qd Tc 8h Kd]
Seat 1: ximenes.cr folded before Flop (didn't bet)
Seat 2: guma475 folded before Flop (didn't bet)
Seat 3: LuckyDayRS (button) collected (1290)
Seat 4: llleopold (small blind) folded before Flop
Seat 5: dfcastro.net (big blind) folded before Flop
Seat 6: rifkat_ham folded before Flop (didn't bet)
Seat 7: Fauxpas123 folded on the River
Seat 8: 1DMITRYSPb1 folded before Flop (didn't bet)
Seat 9: masha02468 folded before Flop (didn't bet)



PokerStars Hand #98794834922: Tournament #734961465, $0.23+$0.02 USD Hold'em No Limit - Level I (10/20) - 2013/05/19 9:50:27 BRT [2013/05/19 8:50:27 ET]
Table '734961465 2' 9-max Seat #4 is the button
Seat 1: ximenes.cr (1500 in chips) 
Seat 2: guma475 (794 in chips) 
Seat 3: LuckyDayRS (2130 in chips) 
Seat 4: llleopold (2426 in chips) 
Seat 5: dfcastro.net (1400 in chips) 
Seat 6: rifkat_ham (1500 in chips) 
Seat 7: Fauxpas123 (750 in chips) 
Seat 8: 1DMITRYSPb1 (1500 in chips) 
Seat 9: masha02468 (1500 in chips) 
dfcastro.net: posts small blind 10
rifkat_ham: posts big blind 20
*** HOLE CARDS ***
Dealt to dfcastro.net [Jh 3d]
Fauxpas123: calls 20
1DMITRYSPb1: folds 
masha02468: calls 20
ximenes.cr: folds 
guma475: folds 
LuckyDayRS: folds 
llleopold: folds 
dfcastro.net: folds 
rifkat_ham: checks 
*** FLOP *** [3c 8s 5c]
rifkat_ham: checks 
Fauxpas123: checks 
masha02468: checks 
*** TURN *** [3c 8s 5c] [2s]
rifkat_ham: bets 60
Fauxpas123: folds 
masha02468: calls 60
*** RIVER *** [3c 8s 5c 2s] [Ah]
rifkat_ham: bets 140
masha02468: calls 140
*** SHOW DOWN ***
rifkat_ham: shows [4d Ad] (a straight, Ace to Five)
masha02468: mucks hand 
rifkat_ham collected 470 from pot
*** SUMMARY ***
Total pot 470 | Rake 0 
Board [3c 8s 5c 2s Ah]
Seat 1: ximenes.cr folded before Flop (didn't bet)
Seat 2: guma475 folded before Flop (didn't bet)
Seat 3: LuckyDayRS folded before Flop (didn't bet)
Seat 4: llleopold (button) folded before Flop (didn't bet)
Seat 5: dfcastro.net (small blind) folded before Flop
Seat 6: rifkat_ham (big blind) showed [4d Ad] and won (470) with a straight, Ace to Five
Seat 7: Fauxpas123 folded on the Turn
Seat 8: 1DMITRYSPb1 folded before Flop (didn't bet)
Seat 9: masha02468 mucked [Td Ac]



PokerStars Hand #98794863630: Tournament #734961465, $0.23+$0.02 USD Hold'em No Limit - Level I (10/20) - 2013/05/19 9:51:17 BRT [2013/05/19 8:51:17 ET]
Table '734961465 2' 9-max Seat #5 is the button
Seat 1: ximenes.cr (1500 in chips) 
Seat 2: guma475 (794 in chips) 
Seat 3: LuckyDayRS (2130 in chips) 
Seat 4: llleopold (2426 in chips) 
Seat 5: dfcastro.net (1390 in chips) 
Seat 6: rifkat_ham (1750 in chips) 
Seat 7: Fauxpas123 (730 in chips) 
Seat 8: 1DMITRYSPb1 (1500 in chips) 
Seat 9: masha02468 (1280 in chips) 
rifkat_ham: posts small blind 10
Fauxpas123: posts big blind 20
*** HOLE CARDS ***
Dealt to dfcastro.net [Qc 7h]
1DMITRYSPb1: folds 
masha02468: calls 20
ximenes.cr: folds 
guma475: folds 
LuckyDayRS: folds 
llleopold: folds 
dfcastro.net: folds 
rifkat_ham: folds 
Fauxpas123: checks 
*** FLOP *** [5h Tc 4c]
Fauxpas123: checks 
masha02468: checks 
*** TURN *** [5h Tc 4c] [4d]
Fauxpas123: bets 40
masha02468: folds 
Uncalled bet (40) returned to Fauxpas123
Fauxpas123 collected 50 from pot
*** SUMMARY ***
Total pot 50 | Rake 0 
Board [5h Tc 4c 4d]
Seat 1: ximenes.cr folded before Flop (didn't bet)
Seat 2: guma475 folded before Flop (didn't bet)
Seat 3: LuckyDayRS folded before Flop (didn't bet)
Seat 4: llleopold folded before Flop (didn't bet)
Seat 5: dfcastro.net (button) folded before Flop (didn't bet)
Seat 6: rifkat_ham (small blind) folded before Flop
Seat 7: Fauxpas123 (big blind) collected (50)
Seat 8: 1DMITRYSPb1 folded before Flop (didn't bet)
Seat 9: masha02468 folded on the Turn



PokerStars Hand #98794886254: Tournament #734961465, $0.23+$0.02 USD Hold'em No Limit - Level I (10/20) - 2013/05/19 9:51:56 BRT [2013/05/19 8:51:56 ET]
Table '734961465 2' 9-max Seat #6 is the button
Seat 1: ximenes.cr (1500 in chips) 
Seat 2: guma475 (794 in chips) 
Seat 3: LuckyDayRS (2130 in chips) 
Seat 4: llleopold (2426 in chips) 
Seat 5: dfcastro.net (1390 in chips) 
Seat 6: rifkat_ham (1740 in chips) 
Seat 7: Fauxpas123 (760 in chips) 
Seat 8: 1DMITRYSPb1 (1500 in chips) 
Seat 9: masha02468 (1260 in chips) 
Fauxpas123: posts small blind 10
1DMITRYSPb1: posts big blind 20
*** HOLE CARDS ***
Dealt to dfcastro.net [4d Th]
masha02468: calls 20
ximenes.cr: folds 
guma475: raises 774 to 794 and is all-in
LuckyDayRS: folds 
llleopold: folds 
dfcastro.net: folds 
rifkat_ham: folds 
Fauxpas123: folds 
1DMITRYSPb1: folds 
masha02468: folds 
Uncalled bet (774) returned to guma475
guma475 collected 70 from pot
guma475: doesn't show hand 
*** SUMMARY ***
Total pot 70 | Rake 0 
Seat 1: ximenes.cr folded before Flop (didn't bet)
Seat 2: guma475 collected (70)
Seat 3: LuckyDayRS folded before Flop (didn't bet)
Seat 4: llleopold folded before Flop (didn't bet)
Seat 5: dfcastro.net folded before Flop (didn't bet)
Seat 6: rifkat_ham (button) folded before Flop (didn't bet)
Seat 7: Fauxpas123 (small blind) folded before Flop
Seat 8: 1DMITRYSPb1 (big blind) folded before Flop
Seat 9: masha02468 folded before Flop



PokerStars Hand #98794901783: Tournament #734961465, $0.23+$0.02 USD Hold'em No Limit - Level I (10/20) - 2013/05/19 9:52:23 BRT [2013/05/19 8:52:23 ET]
Table '734961465 2' 9-max Seat #7 is the button
Seat 2: guma475 (844 in chips) 
Seat 3: LuckyDayRS (2130 in chips) 
Seat 4: llleopold (2426 in chips) 
Seat 5: dfcastro.net (1390 in chips) 
Seat 6: rifkat_ham (1740 in chips) 
Seat 7: Fauxpas123 (750 in chips) 
Seat 8: 1DMITRYSPb1 (1480 in chips) 
Seat 9: masha02468 (1240 in chips) 
1DMITRYSPb1: posts small blind 10
masha02468: posts big blind 20
*** HOLE CARDS ***
Dealt to dfcastro.net [7h 6s]
guma475: folds 
LuckyDayRS: folds 
llleopold: folds 
dfcastro.net: folds 
rifkat_ham: folds 
Fauxpas123: calls 20
1DMITRYSPb1: calls 10
masha02468: checks 
*** FLOP *** [Qh Ks 3c]
1DMITRYSPb1: checks 
masha02468: bets 40
Fauxpas123: calls 40
1DMITRYSPb1: calls 40
*** TURN *** [Qh Ks 3c] [5c]
1DMITRYSPb1: checks 
masha02468: bets 20
Fauxpas123: raises 40 to 60
1DMITRYSPb1: calls 60
masha02468: calls 40
*** RIVER *** [Qh Ks 3c 5c] [7d]
1DMITRYSPb1: checks 
masha02468: checks 
Fauxpas123: bets 80
1DMITRYSPb1: calls 80
masha02468: folds 
*** SHOW DOWN ***
Fauxpas123: shows [Jc Kh] (a pair of Kings)
1DMITRYSPb1: mucks hand 
Fauxpas123 collected 520 from pot
*** SUMMARY ***
Total pot 520 | Rake 0 
Board [Qh Ks 3c 5c 7d]
Seat 2: guma475 folded before Flop (didn't bet)
Seat 3: LuckyDayRS folded before Flop (didn't bet)
Seat 4: llleopold folded before Flop (didn't bet)
Seat 5: dfcastro.net folded before Flop (didn't bet)
Seat 6: rifkat_ham folded before Flop (didn't bet)
Seat 7: Fauxpas123 (button) showed [Jc Kh] and won (520) with a pair of Kings
Seat 8: 1DMITRYSPb1 (small blind) mucked [4c Qc]
Seat 9: masha02468 (big blind) folded on the River



PokerStars Hand #98794934657: Tournament #734961465, $0.23+$0.02 USD Hold'em No Limit - Level I (10/20) - 2013/05/19 9:53:21 BRT [2013/05/19 8:53:21 ET]
Table '734961465 2' 9-max Seat #8 is the button
Seat 2: guma475 (844 in chips) 
Seat 3: LuckyDayRS (2130 in chips) 
Seat 4: llleopold (2426 in chips) 
Seat 5: dfcastro.net (1390 in chips) 
Seat 6: rifkat_ham (1740 in chips) 
Seat 7: Fauxpas123 (1070 in chips) 
Seat 8: 1DMITRYSPb1 (1280 in chips) 
Seat 9: masha02468 (1120 in chips) 
masha02468: posts small blind 10
guma475: posts big blind 20
*** HOLE CARDS ***
Dealt to dfcastro.net [Ad 5s]
LuckyDayRS: folds 
llleopold: folds 
dfcastro.net: folds 
rifkat_ham: folds 
Fauxpas123: calls 20
1DMITRYSPb1: calls 20
masha02468: folds 
guma475: checks 
*** FLOP *** [2h 5c 3s]
guma475: checks 
Fauxpas123: checks 
1DMITRYSPb1: checks 
*** TURN *** [2h 5c 3s] [Jd]
guma475: checks 
Fauxpas123: checks 
1DMITRYSPb1: checks 
*** RIVER *** [2h 5c 3s Jd] [Ac]
guma475: checks 
Fauxpas123: bets 60
1DMITRYSPb1: raises 60 to 120
guma475: folds 
Fauxpas123: calls 60
*** SHOW DOWN ***
1DMITRYSPb1: shows [4d 3d] (a straight, Ace to Five)
Fauxpas123: shows [Qd 4c] (a straight, Ace to Five)
Fauxpas123 collected 155 from pot
1DMITRYSPb1 collected 155 from pot
*** SUMMARY ***
Total pot 310 | Rake 0 
Board [2h 5c 3s Jd Ac]
Seat 2: guma475 (big blind) folded on the River
Seat 3: LuckyDayRS folded before Flop (didn't bet)
Seat 4: llleopold folded before Flop (didn't bet)
Seat 5: dfcastro.net folded before Flop (didn't bet)
Seat 6: rifkat_ham folded before Flop (didn't bet)
Seat 7: Fauxpas123 showed [Qd 4c] and won (155) with a straight, Ace to Five
Seat 8: 1DMITRYSPb1 (button) showed [4d 3d] and won (155) with a straight, Ace to Five
Seat 9: masha02468 (small blind) folded before Flop



PokerStars Hand #98794968287: Tournament #734961465, $0.23+$0.02 USD Hold'em No Limit - Level I (10/20) - 2013/05/19 9:54:20 BRT [2013/05/19 8:54:20 ET]
Table '734961465 2' 9-max Seat #9 is the button
Seat 2: guma475 (824 in chips) 
Seat 3: LuckyDayRS (2130 in chips) 
Seat 4: llleopold (2426 in chips) 
Seat 5: dfcastro.net (1390 in chips) 
Seat 6: rifkat_ham (1740 in chips) 
Seat 7: Fauxpas123 (1085 in chips) 
Seat 8: 1DMITRYSPb1 (1295 in chips) 
Seat 9: masha02468 (1110 in chips) 
guma475: posts small blind 10
LuckyDayRS: posts big blind 20
*** HOLE CARDS ***
Dealt to dfcastro.net [Jc Ts]
llleopold: folds 
dfcastro.net: folds 
rifkat_ham: folds 
Fauxpas123: calls 20
1DMITRYSPb1: folds 
masha02468: folds 
guma475: calls 10
LuckyDayRS: checks 
*** FLOP *** [Js 2h Td]
guma475: checks 
LuckyDayRS: checks 
Fauxpas123: checks 
*** TURN *** [Js 2h Td] [Jd]
guma475: checks 
LuckyDayRS: checks 
Fauxpas123: checks 
*** RIVER *** [Js 2h Td Jd] [4h]
guma475: checks 
LuckyDayRS: checks 
Fauxpas123: checks 
*** SHOW DOWN ***
guma475: shows [Ah Qs] (a pair of Jacks)
LuckyDayRS: mucks hand 
Fauxpas123: mucks hand 
guma475 collected 60 from pot
*** SUMMARY ***
Total pot 60 | Rake 0 
Board [Js 2h Td Jd 4h]
Seat 2: guma475 (small blind) showed [Ah Qs] and won (60) with a pair of Jacks
Seat 3: LuckyDayRS (big blind) mucked [3c 7c]
Seat 4: llleopold folded before Flop (didn't bet)
Seat 5: dfcastro.net folded before Flop (didn't bet)
Seat 6: rifkat_ham folded before Flop (didn't bet)
Seat 7: Fauxpas123 mucked [7d 3d]
Seat 8: 1DMITRYSPb1 folded before Flop (didn't bet)
Seat 9: masha02468 (button) folded before Flop (didn't bet)



PokerStars Hand #98794993977: Tournament #734961465, $0.23+$0.02 USD Hold'em No Limit - Level I (10/20) - 2013/05/19 9:55:05 BRT [2013/05/19 8:55:05 ET]
Table '734961465 2' 9-max Seat #2 is the button
Seat 2: guma475 (864 in chips) 
Seat 3: LuckyDayRS (2110 in chips) 
Seat 4: llleopold (2426 in chips) 
Seat 5: dfcastro.net (1390 in chips) 
Seat 6: rifkat_ham (1740 in chips) 
Seat 7: Fauxpas123 (1065 in chips) 
Seat 8: 1DMITRYSPb1 (1295 in chips) 
Seat 9: masha02468 (1110 in chips) 
LuckyDayRS: posts small blind 10
llleopold: posts big blind 20
*** HOLE CARDS ***
Dealt to dfcastro.net [Kh 2s]
dfcastro.net: folds 
rifkat_ham: raises 60 to 80
Fauxpas123: calls 80
1DMITRYSPb1: folds 
masha02468: folds 
guma475: folds 
LuckyDayRS: folds 
llleopold: folds 
*** FLOP *** [4h 3s Jd]
rifkat_ham: bets 140
Fauxpas123: folds 
Uncalled bet (140) returned to rifkat_ham
rifkat_ham collected 190 from pot
*** SUMMARY ***
Total pot 190 | Rake 0 
Board [4h 3s Jd]
Seat 2: guma475 (button) folded before Flop (didn't bet)
Seat 3: LuckyDayRS (small blind) folded before Flop
Seat 4: llleopold (big blind) folded before Flop
Seat 5: dfcastro.net folded before Flop (didn't bet)
Seat 6: rifkat_ham collected (190)
Seat 7: Fauxpas123 folded on the Flop
Seat 8: 1DMITRYSPb1 folded before Flop (didn't bet)
Seat 9: masha02468 folded before Flop (didn't bet)



PokerStars Hand #98795165698: Tournament #734961465, $0.23+$0.02 USD Hold'em No Limit - Level I (10/20) - 2013/05/19 10:01:07 BRT [2013/05/19 9:01:07 ET]
Table '734961465 2' 9-max Seat #3 is the button
Seat 2: guma475 (864 in chips) 
Seat 3: LuckyDayRS (2100 in chips) 
Seat 4: llleopold (2406 in chips) is sitting out
Seat 5: dfcastro.net (1390 in chips) 
Seat 6: rifkat_ham (1850 in chips) 
Seat 7: Fauxpas123 (985 in chips) 
Seat 8: 1DMITRYSPb1 (1295 in chips) 
Seat 9: masha02468 (1110 in chips) 
llleopold: posts small blind 10
dfcastro.net: posts big blind 20
*** HOLE CARDS ***
Dealt to dfcastro.net [5c 6d]
rifkat_ham: folds 
Fauxpas123: calls 20
1DMITRYSPb1: folds 
masha02468: calls 20
guma475: raises 20 to 40
LuckyDayRS: folds 
llleopold: folds 
dfcastro.net: folds 
Fauxpas123: calls 20
masha02468: calls 20
*** FLOP *** [5s Ah 9s]
Fauxpas123: checks 
masha02468: checks 
guma475: bets 20
Fauxpas123: folds 
masha02468: calls 20
*** TURN *** [5s Ah 9s] [9h]
masha02468: checks 
guma475: bets 804 and is all-in
masha02468: folds 
Uncalled bet (804) returned to guma475
llleopold has returned
guma475 collected 190 from pot
guma475: doesn't show hand 
*** SUMMARY ***
Total pot 190 | Rake 0 
Board [5s Ah 9s 9h]
Seat 2: guma475 collected (190)
Seat 3: LuckyDayRS (button) folded before Flop (didn't bet)
Seat 4: llleopold (small blind) folded before Flop
Seat 5: dfcastro.net (big blind) folded before Flop
Seat 6: rifkat_ham folded before Flop (didn't bet)
Seat 7: Fauxpas123 folded on the Flop
Seat 8: 1DMITRYSPb1 folded before Flop (didn't bet)
Seat 9: masha02468 folded on the Turn



PokerStars Hand #98795211694: Tournament #734961465, $0.23+$0.02 USD Hold'em No Limit - Level II (15/30) - 2013/05/19 10:02:25 BRT [2013/05/19 9:02:25 ET]
Table '734961465 2' 9-max Seat #4 is the button
Seat 2: guma475 (994 in chips) 
Seat 3: LuckyDayRS (2100 in chips) 
Seat 4: llleopold (2396 in chips) 
Seat 5: dfcastro.net (1370 in chips) 
Seat 6: rifkat_ham (1850 in chips) 
Seat 7: Fauxpas123 (945 in chips) 
Seat 8: 1DMITRYSPb1 (1295 in chips) 
Seat 9: masha02468 (1050 in chips) 
dfcastro.net: posts small blind 15
rifkat_ham: posts big blind 30
*** HOLE CARDS ***
Dealt to dfcastro.net [Qc 7c]
Fauxpas123: raises 30 to 60
1DMITRYSPb1: folds 
masha02468: calls 60
guma475: folds 
LuckyDayRS: folds 
llleopold: folds 
dfcastro.net: folds 
rifkat_ham: folds 
*** FLOP *** [4c 6h Qs]
Fauxpas123: bets 90
masha02468: folds 
Uncalled bet (90) returned to Fauxpas123
Fauxpas123 collected 165 from pot
*** SUMMARY ***
Total pot 165 | Rake 0 
Board [4c 6h Qs]
Seat 2: guma475 folded before Flop (didn't bet)
Seat 3: LuckyDayRS folded before Flop (didn't bet)
Seat 4: llleopold (button) folded before Flop (didn't bet)
Seat 5: dfcastro.net (small blind) folded before Flop
Seat 6: rifkat_ham (big blind) folded before Flop
Seat 7: Fauxpas123 collected (165)
Seat 8: 1DMITRYSPb1 folded before Flop (didn't bet)
Seat 9: masha02468 folded on the Flop



PokerStars Hand #98795238781: Tournament #734961465, $0.23+$0.02 USD Hold'em No Limit - Level II (15/30) - 2013/05/19 10:03:09 BRT [2013/05/19 9:03:09 ET]
Table '734961465 2' 9-max Seat #5 is the button
Seat 2: guma475 (994 in chips) 
Seat 3: LuckyDayRS (2100 in chips) 
Seat 4: llleopold (2396 in chips) 
Seat 5: dfcastro.net (1355 in chips) 
Seat 6: rifkat_ham (1820 in chips) 
Seat 7: Fauxpas123 (1050 in chips) 
Seat 8: 1DMITRYSPb1 (1295 in chips) 
Seat 9: masha02468 (990 in chips) 
rifkat_ham: posts small blind 15
Fauxpas123: posts big blind 30
*** HOLE CARDS ***
Dealt to dfcastro.net [Ah 6s]
1DMITRYSPb1: folds 
masha02468: calls 30
guma475: calls 30
LuckyDayRS: folds 
llleopold: folds 
dfcastro.net: calls 30
rifkat_ham: folds 
Fauxpas123: checks 
*** FLOP *** [2c 4d Qh]
Fauxpas123: checks 
masha02468: checks 
guma475: checks 
dfcastro.net: checks 
*** TURN *** [2c 4d Qh] [4s]
Fauxpas123: checks 
masha02468: checks 
guma475: checks 
dfcastro.net: checks 
*** RIVER *** [2c 4d Qh 4s] [9d]
Fauxpas123: checks 
masha02468: checks 
guma475 has timed out
guma475: checks 
dfcastro.net: checks 
*** SHOW DOWN ***
Fauxpas123: shows [Js Kc] (a pair of Fours)
masha02468: shows [Jc Kd] (a pair of Fours)
guma475: shows [7h 2h] (two pair, Fours and Deuces)
dfcastro.net: mucks hand 
guma475 collected 135 from pot
*** SUMMARY ***
Total pot 135 | Rake 0 
Board [2c 4d Qh 4s 9d]
Seat 2: guma475 showed [7h 2h] and won (135) with two pair, Fours and Deuces
Seat 3: LuckyDayRS folded before Flop (didn't bet)
Seat 4: llleopold folded before Flop (didn't bet)
Seat 5: dfcastro.net (button) mucked [Ah 6s]
Seat 6: rifkat_ham (small blind) folded before Flop
Seat 7: Fauxpas123 (big blind) showed [Js Kc] and lost with a pair of Fours
Seat 8: 1DMITRYSPb1 folded before Flop (didn't bet)
Seat 9: masha02468 showed [Jc Kd] and lost with a pair of Fours



PokerStars Hand #98795364278: Tournament #734961465, $0.23+$0.02 USD Hold'em No Limit - Level II (15/30) - 2013/05/19 10:06:28 BRT [2013/05/19 9:06:28 ET]
Table '734961465 2' 9-max Seat #6 is the button
Seat 1: greenjack.eu (1930 in chips) 
Seat 2: guma475 (1099 in chips) 
Seat 4: llleopold (2396 in chips) 
Seat 5: dfcastro.net (1325 in chips) 
Seat 6: rifkat_ham (1805 in chips) 
Seat 7: Fauxpas123 (1020 in chips) 
Seat 8: 1DMITRYSPb1 (1295 in chips) 
Seat 9: masha02468 (960 in chips) 
Fauxpas123: posts small blind 15
1DMITRYSPb1: posts big blind 30
*** HOLE CARDS ***
Dealt to dfcastro.net [7s 2c]
masha02468: folds 
greenjack.eu: folds 
guma475: calls 30
llleopold: folds 
dfcastro.net: folds 
rifkat_ham: folds 
Fauxpas123: raises 90 to 120
1DMITRYSPb1: calls 90
guma475: calls 90
*** FLOP *** [Js 4d 5d]
Fauxpas123: checks 
1DMITRYSPb1: checks 
guma475: checks 
*** TURN *** [Js 4d 5d] [7d]
Fauxpas123: bets 150
1DMITRYSPb1: folds 
guma475: folds 
Uncalled bet (150) returned to Fauxpas123
Fauxpas123 collected 360 from pot
*** SUMMARY ***
Total pot 360 | Rake 0 
Board [Js 4d 5d 7d]
Seat 1: greenjack.eu folded before Flop (didn't bet)
Seat 2: guma475 folded on the Turn
Seat 4: llleopold folded before Flop (didn't bet)
Seat 5: dfcastro.net folded before Flop (didn't bet)
Seat 6: rifkat_ham (button) folded before Flop (didn't bet)
Seat 7: Fauxpas123 (small blind) collected (360)
Seat 8: 1DMITRYSPb1 (big blind) folded on the Turn
Seat 9: masha02468 folded before Flop (didn't bet)



PokerStars Hand #98795406984: Tournament #734961465, $0.23+$0.02 USD Hold'em No Limit - Level II (15/30) - 2013/05/19 10:07:37 BRT [2013/05/19 9:07:37 ET]
Table '734961465 2' 9-max Seat #7 is the button
Seat 1: greenjack.eu (1930 in chips) 
Seat 2: guma475 (979 in chips) 
Seat 4: llleopold (2396 in chips) 
Seat 5: dfcastro.net (1325 in chips) 
Seat 6: rifkat_ham (1805 in chips) 
Seat 7: Fauxpas123 (1260 in chips) 
Seat 8: 1DMITRYSPb1 (1175 in chips) 
Seat 9: masha02468 (960 in chips) 
1DMITRYSPb1: posts small blind 15
masha02468: posts big blind 30
*** HOLE CARDS ***
Dealt to dfcastro.net [Td Jc]
greenjack.eu: folds 
guma475: calls 30
llleopold: folds 
dfcastro.net: folds 
rifkat_ham: folds 
Fauxpas123: calls 30
1DMITRYSPb1: calls 15
masha02468: checks 
*** FLOP *** [8h 3s 7h]
1DMITRYSPb1: checks 
masha02468: checks 
guma475: bets 30
Fauxpas123: calls 30
1DMITRYSPb1: folds 
masha02468: folds 
*** TURN *** [8h 3s 7h] [Kc]
guma475: bets 30
Fauxpas123: calls 30
*** RIVER *** [8h 3s 7h Kc] [4d]
guma475: checks 
Fauxpas123: checks 
*** SHOW DOWN ***
guma475: shows [Jh Th] (high card King)
Fauxpas123: shows [8d Tc] (a pair of Eights)
Fauxpas123 collected 240 from pot
*** SUMMARY ***
Total pot 240 | Rake 0 
Board [8h 3s 7h Kc 4d]
Seat 1: greenjack.eu folded before Flop (didn't bet)
Seat 2: guma475 showed [Jh Th] and lost with high card King
Seat 4: llleopold folded before Flop (didn't bet)
Seat 5: dfcastro.net folded before Flop (didn't bet)
Seat 6: rifkat_ham folded before Flop (didn't bet)
Seat 7: Fauxpas123 (button) showed [8d Tc] and won (240) with a pair of Eights
Seat 8: 1DMITRYSPb1 (small blind) folded on the Flop
Seat 9: masha02468 (big blind) folded on the Flop



PokerStars Hand #98795442462: Tournament #734961465, $0.23+$0.02 USD Hold'em No Limit - Level II (15/30) - 2013/05/19 10:08:34 BRT [2013/05/19 9:08:34 ET]
Table '734961465 2' 9-max Seat #8 is the button
Seat 1: greenjack.eu (1930 in chips) 
Seat 2: guma475 (889 in chips) 
Seat 4: llleopold (2396 in chips) 
Seat 5: dfcastro.net (1325 in chips) 
Seat 6: rifkat_ham (1805 in chips) 
Seat 7: Fauxpas123 (1410 in chips) 
Seat 8: 1DMITRYSPb1 (1145 in chips) 
Seat 9: masha02468 (930 in chips) 
masha02468: posts small blind 15
greenjack.eu: posts big blind 30
*** HOLE CARDS ***
Dealt to dfcastro.net [Jd As]
guma475: raises 859 to 889 and is all-in
llleopold: folds 
dfcastro.net: folds 
rifkat_ham: folds 
Fauxpas123: folds 
1DMITRYSPb1: folds 
masha02468: folds 
masha02468 is sitting out
greenjack.eu: folds 
Uncalled bet (859) returned to guma475
guma475 collected 75 from pot
guma475: doesn't show hand 
*** SUMMARY ***
Total pot 75 | Rake 0 
Seat 1: greenjack.eu (big blind) folded before Flop
Seat 2: guma475 collected (75)
Seat 4: llleopold folded before Flop (didn't bet)
Seat 5: dfcastro.net folded before Flop (didn't bet)
Seat 6: rifkat_ham folded before Flop (didn't bet)
Seat 7: Fauxpas123 folded before Flop (didn't bet)
Seat 8: 1DMITRYSPb1 (button) folded before Flop (didn't bet)
Seat 9: masha02468 (small blind) folded before Flop



PokerStars Hand #98795457327: Tournament #734961465, $0.23+$0.02 USD Hold'em No Limit - Level II (15/30) - 2013/05/19 10:08:58 BRT [2013/05/19 9:08:58 ET]
Table '734961465 2' 9-max Seat #9 is the button
Seat 1: greenjack.eu (1900 in chips) 
Seat 2: guma475 (934 in chips) 
Seat 4: llleopold (2396 in chips) 
Seat 5: dfcastro.net (1325 in chips) 
Seat 6: rifkat_ham (1805 in chips) 
Seat 7: Fauxpas123 (1410 in chips) 
Seat 8: 1DMITRYSPb1 (1145 in chips) 
Seat 9: masha02468 (915 in chips) is sitting out
greenjack.eu: posts small blind 15
guma475: posts big blind 30
*** HOLE CARDS ***
Dealt to dfcastro.net [3h Tc]
llleopold: folds 
dfcastro.net: folds 
rifkat_ham: raises 90 to 120
Fauxpas123: calls 120
1DMITRYSPb1: folds 
masha02468: folds 
greenjack.eu: folds 
guma475: folds 
*** FLOP *** [6c Js Qd]
rifkat_ham: bets 210
Fauxpas123: folds 
Uncalled bet (210) returned to rifkat_ham
rifkat_ham collected 285 from pot
*** SUMMARY ***
Total pot 285 | Rake 0 
Board [6c Js Qd]
Seat 1: greenjack.eu (small blind) folded before Flop
Seat 2: guma475 (big blind) folded before Flop
Seat 4: llleopold folded before Flop (didn't bet)
Seat 5: dfcastro.net folded before Flop (didn't bet)
Seat 6: rifkat_ham collected (285)
Seat 7: Fauxpas123 folded on the Flop
Seat 8: 1DMITRYSPb1 folded before Flop (didn't bet)
Seat 9: masha02468 (button) folded before Flop (didn't bet)



PokerStars Hand #98795493350: Tournament #734961465, $0.23+$0.02 USD Hold'em No Limit - Level II (15/30) - 2013/05/19 10:09:56 BRT [2013/05/19 9:09:56 ET]
Table '734961465 2' 9-max Seat #1 is the button
Seat 1: greenjack.eu (1885 in chips) 
Seat 2: guma475 (904 in chips) 
Seat 4: llleopold (2396 in chips) 
Seat 5: dfcastro.net (1325 in chips) 
Seat 6: rifkat_ham (1970 in chips) 
Seat 7: Fauxpas123 (1290 in chips) 
Seat 8: 1DMITRYSPb1 (1145 in chips) 
Seat 9: masha02468 (915 in chips) is sitting out
guma475: posts small blind 15
llleopold: posts big blind 30
*** HOLE CARDS ***
Dealt to dfcastro.net [Ks 2s]
dfcastro.net: folds 
rifkat_ham: folds 
Fauxpas123: calls 30
1DMITRYSPb1: calls 30
masha02468: folds 
greenjack.eu: folds 
guma475: raises 874 to 904 and is all-in
llleopold: folds 
Fauxpas123: folds 
1DMITRYSPb1: folds 
Uncalled bet (874) returned to guma475
guma475 collected 120 from pot
guma475: doesn't show hand 
*** SUMMARY ***
Total pot 120 | Rake 0 
Seat 1: greenjack.eu (button) folded before Flop (didn't bet)
Seat 2: guma475 (small blind) collected (120)
Seat 4: llleopold (big blind) folded before Flop
Seat 5: dfcastro.net folded before Flop (didn't bet)
Seat 6: rifkat_ham folded before Flop (didn't bet)
Seat 7: Fauxpas123 folded before Flop
Seat 8: 1DMITRYSPb1 folded before Flop
Seat 9: masha02468 folded before Flop (didn't bet)



PokerStars Hand #98795510835: Tournament #734961465, $0.23+$0.02 USD Hold'em No Limit - Level II (15/30) - 2013/05/19 10:10:24 BRT [2013/05/19 9:10:24 ET]
Table '734961465 2' 9-max Seat #2 is the button
Seat 1: greenjack.eu (1885 in chips) 
Seat 2: guma475 (994 in chips) 
Seat 4: llleopold (2366 in chips) 
Seat 5: dfcastro.net (1325 in chips) 
Seat 6: rifkat_ham (1970 in chips) 
Seat 7: Fauxpas123 (1260 in chips) 
Seat 8: 1DMITRYSPb1 (1115 in chips) 
Seat 9: masha02468 (915 in chips) is sitting out
llleopold: posts small blind 15
dfcastro.net: posts big blind 30
*** HOLE CARDS ***
Dealt to dfcastro.net [8d 2c]
rifkat_ham: folds 
Fauxpas123: calls 30
1DMITRYSPb1: folds 
masha02468: folds 
greenjack.eu: folds 
guma475: calls 30
llleopold: folds 
dfcastro.net: checks 
*** FLOP *** [Ts Js Jh]
dfcastro.net: checks 
Fauxpas123: checks 
guma475: checks 
*** TURN *** [Ts Js Jh] [3s]
dfcastro.net: checks 
Fauxpas123: checks 
guma475: checks 
*** RIVER *** [Ts Js Jh 3s] [5d]
dfcastro.net: checks 
Fauxpas123: checks 
guma475: checks 
*** SHOW DOWN ***
dfcastro.net: shows [8d 2c] (a pair of Jacks)
Fauxpas123: shows [9c Kh] (a pair of Jacks - King kicker)
guma475: shows [7s Ad] (a pair of Jacks - Ace kicker)
guma475 collected 105 from pot
*** SUMMARY ***
Total pot 105 | Rake 0 
Board [Ts Js Jh 3s 5d]
Seat 1: greenjack.eu folded before Flop (didn't bet)
Seat 2: guma475 (button) showed [7s Ad] and won (105) with a pair of Jacks
Seat 4: llleopold (small blind) folded before Flop
Seat 5: dfcastro.net (big blind) showed [8d 2c] and lost with a pair of Jacks
Seat 6: rifkat_ham folded before Flop (didn't bet)
Seat 7: Fauxpas123 showed [9c Kh] and lost with a pair of Jacks
Seat 8: 1DMITRYSPb1 folded before Flop (didn't bet)
Seat 9: masha02468 folded before Flop (didn't bet)



PokerStars Hand #98795546317: Tournament #734961465, $0.23+$0.02 USD Hold'em No Limit - Level II (15/30) - 2013/05/19 10:11:21 BRT [2013/05/19 9:11:21 ET]
Table '734961465 2' 9-max Seat #4 is the button
Seat 1: greenjack.eu (1885 in chips) 
Seat 2: guma475 (1069 in chips) 
Seat 4: llleopold (2351 in chips) 
Seat 5: dfcastro.net (1295 in chips) 
Seat 6: rifkat_ham (1970 in chips) 
Seat 7: Fauxpas123 (1230 in chips) 
Seat 8: 1DMITRYSPb1 (1115 in chips) 
Seat 9: masha02468 (915 in chips) is sitting out
dfcastro.net: posts small blind 15
rifkat_ham: posts big blind 30
*** HOLE CARDS ***
Dealt to dfcastro.net [9c 5c]
Fauxpas123: calls 30
1DMITRYSPb1: folds 
masha02468: folds 
greenjack.eu: folds 
guma475: folds 
masha02468 has returned
llleopold: folds 
dfcastro.net: folds 
rifkat_ham: checks 
*** FLOP *** [4h 9d Jd]
rifkat_ham: checks 
Fauxpas123: checks 
*** TURN *** [4h 9d Jd] [3h]
rifkat_ham: checks 
Fauxpas123: checks 
*** RIVER *** [4h 9d Jd 3h] [8c]
rifkat_ham: checks 
Fauxpas123: checks 
*** SHOW DOWN ***
rifkat_ham: shows [Ks Td] (high card King)
Fauxpas123: shows [Kd 3c] (a pair of Threes)
Fauxpas123 collected 75 from pot
*** SUMMARY ***
Total pot 75 | Rake 0 
Board [4h 9d Jd 3h 8c]
Seat 1: greenjack.eu folded before Flop (didn't bet)
Seat 2: guma475 folded before Flop (didn't bet)
Seat 4: llleopold (button) folded before Flop (didn't bet)
Seat 5: dfcastro.net (small blind) folded before Flop
Seat 6: rifkat_ham (big blind) showed [Ks Td] and lost with high card King
Seat 7: Fauxpas123 showed [Kd 3c] and won (75) with a pair of Threes
Seat 8: 1DMITRYSPb1 folded before Flop (didn't bet)
Seat 9: masha02468 folded before Flop (didn't bet)



PokerStars Hand #98795573193: Tournament #734961465, $0.23+$0.02 USD Hold'em No Limit - Level II (15/30) - 2013/05/19 10:12:04 BRT [2013/05/19 9:12:04 ET]
Table '734961465 2' 9-max Seat #5 is the button
Seat 1: greenjack.eu (1885 in chips) 
Seat 2: guma475 (1069 in chips) 
Seat 4: llleopold (2351 in chips) 
Seat 5: dfcastro.net (1280 in chips) 
Seat 6: rifkat_ham (1940 in chips) 
Seat 7: Fauxpas123 (1275 in chips) 
Seat 8: 1DMITRYSPb1 (1115 in chips) 
Seat 9: masha02468 (915 in chips) 
rifkat_ham: posts small blind 15
Fauxpas123: posts big blind 30
*** HOLE CARDS ***
Dealt to dfcastro.net [3c Td]
1DMITRYSPb1: folds 
masha02468: calls 30
greenjack.eu: folds 
guma475: folds 
llleopold: folds 
dfcastro.net: folds 
rifkat_ham: folds 
Fauxpas123: checks 
*** FLOP *** [5s Kh Kc]
Fauxpas123: checks 
masha02468: checks 
*** TURN *** [5s Kh Kc] [As]
Fauxpas123: checks 
masha02468: bets 90
Fauxpas123: folds 
Uncalled bet (90) returned to masha02468
masha02468 collected 75 from pot
*** SUMMARY ***
Total pot 75 | Rake 0 
Board [5s Kh Kc As]
Seat 1: greenjack.eu folded before Flop (didn't bet)
Seat 2: guma475 folded before Flop (didn't bet)
Seat 4: llleopold folded before Flop (didn't bet)
Seat 5: dfcastro.net (button) folded before Flop (didn't bet)
Seat 6: rifkat_ham (small blind) folded before Flop
Seat 7: Fauxpas123 (big blind) folded on the Turn
Seat 8: 1DMITRYSPb1 folded before Flop (didn't bet)
Seat 9: masha02468 collected (75)



PokerStars Hand #98795602447: Tournament #734961465, $0.23+$0.02 USD Hold'em No Limit - Level III (25/50) - 2013/05/19 10:12:51 BRT [2013/05/19 9:12:51 ET]
Table '734961465 2' 9-max Seat #6 is the button
Seat 1: greenjack.eu (1885 in chips) 
Seat 2: guma475 (1069 in chips) 
Seat 4: llleopold (2351 in chips) 
Seat 5: dfcastro.net (1280 in chips) 
Seat 6: rifkat_ham (1925 in chips) 
Seat 7: Fauxpas123 (1245 in chips) 
Seat 8: 1DMITRYSPb1 (1115 in chips) 
Seat 9: masha02468 (960 in chips) 
Fauxpas123: posts small blind 25
1DMITRYSPb1: posts big blind 50
*** HOLE CARDS ***
Dealt to dfcastro.net [Th Qs]
masha02468: folds 
greenjack.eu: folds 
guma475: calls 50
llleopold: folds 
dfcastro.net: folds 
rifkat_ham: folds 
Fauxpas123: calls 25
1DMITRYSPb1: checks 
*** FLOP *** [3s Td 6d]
Fauxpas123: checks 
1DMITRYSPb1: checks 
guma475: checks 
*** TURN *** [3s Td 6d] [Qh]
Fauxpas123: checks 
1DMITRYSPb1: checks 
guma475: checks 
*** RIVER *** [3s Td 6d Qh] [Tc]
Fauxpas123: checks 
1DMITRYSPb1: bets 150
guma475: folds 
Fauxpas123: folds 
Uncalled bet (150) returned to 1DMITRYSPb1
1DMITRYSPb1 collected 150 from pot
1DMITRYSPb1: doesn't show hand 
*** SUMMARY ***
Total pot 150 | Rake 0 
Board [3s Td 6d Qh Tc]
Seat 1: greenjack.eu folded before Flop (didn't bet)
Seat 2: guma475 folded on the River
Seat 4: llleopold folded before Flop (didn't bet)
Seat 5: dfcastro.net folded before Flop (didn't bet)
Seat 6: rifkat_ham (button) folded before Flop (didn't bet)
Seat 7: Fauxpas123 (small blind) folded on the River
Seat 8: 1DMITRYSPb1 (big blind) collected (150)
Seat 9: masha02468 folded before Flop (didn't bet)



PokerStars Hand #98795646630: Tournament #734961465, $0.23+$0.02 USD Hold'em No Limit - Level III (25/50) - 2013/05/19 10:14:02 BRT [2013/05/19 9:14:02 ET]
Table '734961465 2' 9-max Seat #7 is the button
Seat 1: greenjack.eu (1885 in chips) 
Seat 2: guma475 (1019 in chips) 
Seat 4: llleopold (2351 in chips) 
Seat 5: dfcastro.net (1280 in chips) 
Seat 6: rifkat_ham (1925 in chips) 
Seat 7: Fauxpas123 (1195 in chips) 
Seat 8: 1DMITRYSPb1 (1215 in chips) 
Seat 9: masha02468 (960 in chips) 
1DMITRYSPb1: posts small blind 25
masha02468: posts big blind 50
*** HOLE CARDS ***
Dealt to dfcastro.net [5d 3s]
greenjack.eu: folds 
guma475: folds 
llleopold: folds 
dfcastro.net: folds 
rifkat_ham: folds 
Fauxpas123: calls 50
1DMITRYSPb1: calls 25
masha02468: checks 
*** FLOP *** [Tc 5c Qc]
1DMITRYSPb1: checks 
masha02468: bets 150
Fauxpas123: folds 
1DMITRYSPb1: folds 
Uncalled bet (150) returned to masha02468
masha02468 collected 150 from pot
*** SUMMARY ***
Total pot 150 | Rake 0 
Board [Tc 5c Qc]
Seat 1: greenjack.eu folded before Flop (didn't bet)
Seat 2: guma475 folded before Flop (didn't bet)
Seat 4: llleopold folded before Flop (didn't bet)
Seat 5: dfcastro.net folded before Flop (didn't bet)
Seat 6: rifkat_ham folded before Flop (didn't bet)
Seat 7: Fauxpas123 (button) folded on the Flop
Seat 8: 1DMITRYSPb1 (small blind) folded on the Flop
Seat 9: masha02468 (big blind) collected (150)



PokerStars Hand #98795674440: Tournament #734961465, $0.23+$0.02 USD Hold'em No Limit - Level III (25/50) - 2013/05/19 10:14:46 BRT [2013/05/19 9:14:46 ET]
Table '734961465 2' 9-max Seat #8 is the button
Seat 1: greenjack.eu (1885 in chips) 
Seat 2: guma475 (1019 in chips) 
Seat 4: llleopold (2351 in chips) 
Seat 5: dfcastro.net (1280 in chips) 
Seat 6: rifkat_ham (1925 in chips) 
Seat 7: Fauxpas123 (1145 in chips) 
Seat 8: 1DMITRYSPb1 (1165 in chips) 
Seat 9: masha02468 (1060 in chips) 
masha02468: posts small blind 25
greenjack.eu: posts big blind 50
*** HOLE CARDS ***
Dealt to dfcastro.net [6c 2c]
guma475: folds 
llleopold: folds 
dfcastro.net: folds 
rifkat_ham: folds 
Fauxpas123: calls 50
1DMITRYSPb1: folds 
masha02468: calls 25
greenjack.eu: raises 150 to 200
Fauxpas123: folds 
masha02468: calls 150
*** FLOP *** [Kc 9h Ac]
masha02468: bets 100
greenjack.eu: calls 100
*** TURN *** [Kc 9h Ac] [Th]
masha02468: bets 50
greenjack.eu: calls 50
*** RIVER *** [Kc 9h Ac Th] [4c]
masha02468: bets 50
greenjack.eu: calls 50
*** SHOW DOWN ***
masha02468: shows [Ah Jd] (a pair of Aces)
greenjack.eu: mucks hand 
masha02468 collected 850 from pot
*** SUMMARY ***
Total pot 850 | Rake 0 
Board [Kc 9h Ac Th 4c]
Seat 1: greenjack.eu (big blind) mucked [Qh Qc]
Seat 2: guma475 folded before Flop (didn't bet)
Seat 4: llleopold folded before Flop (didn't bet)
Seat 5: dfcastro.net folded before Flop (didn't bet)
Seat 6: rifkat_ham folded before Flop (didn't bet)
Seat 7: Fauxpas123 folded before Flop
Seat 8: 1DMITRYSPb1 (button) folded before Flop (didn't bet)
Seat 9: masha02468 (small blind) showed [Ah Jd] and won (850) with a pair of Aces



PokerStars Hand #98795708796: Tournament #734961465, $0.23+$0.02 USD Hold'em No Limit - Level III (25/50) - 2013/05/19 10:15:41 BRT [2013/05/19 9:15:41 ET]
Table '734961465 2' 9-max Seat #9 is the button
Seat 1: greenjack.eu (1485 in chips) 
Seat 2: guma475 (1019 in chips) 
Seat 4: llleopold (2351 in chips) 
Seat 5: dfcastro.net (1280 in chips) 
Seat 6: rifkat_ham (1925 in chips) 
Seat 7: Fauxpas123 (1095 in chips) 
Seat 8: 1DMITRYSPb1 (1165 in chips) 
Seat 9: masha02468 (1510 in chips) 
greenjack.eu: posts small blind 25
guma475: posts big blind 50
*** HOLE CARDS ***
Dealt to dfcastro.net [Th 4s]
llleopold: folds 
dfcastro.net: folds 
rifkat_ham: folds 
Fauxpas123: calls 50
1DMITRYSPb1: folds 
masha02468: folds 
greenjack.eu: raises 150 to 200
guma475: calls 150
Fauxpas123: calls 150
*** FLOP *** [Qd 6h Kd]
greenjack.eu: checks 
guma475: checks 
Fauxpas123: checks 
*** TURN *** [Qd 6h Kd] [8c]
greenjack.eu: checks 
guma475: checks 
Fauxpas123: bets 200
greenjack.eu: calls 200
guma475: folds 
*** RIVER *** [Qd 6h Kd 8c] [Kh]
greenjack.eu: checks 
Fauxpas123: bets 300
greenjack.eu: calls 300
*** SHOW DOWN ***
Fauxpas123: shows [5d Ks] (three of a kind, Kings)
greenjack.eu: mucks hand 
Fauxpas123 collected 1600 from pot
*** SUMMARY ***
Total pot 1600 | Rake 0 
Board [Qd 6h Kd 8c Kh]
Seat 1: greenjack.eu (small blind) mucked [Ts Tc]
Seat 2: guma475 (big blind) folded on the Turn
Seat 4: llleopold folded before Flop (didn't bet)
Seat 5: dfcastro.net folded before Flop (didn't bet)
Seat 6: rifkat_ham folded before Flop (didn't bet)
Seat 7: Fauxpas123 showed [5d Ks] and won (1600) with three of a kind, Kings
Seat 8: 1DMITRYSPb1 folded before Flop (didn't bet)
Seat 9: masha02468 (button) folded before Flop (didn't bet)



PokerStars Hand #98795760366: Tournament #734961465, $0.23+$0.02 USD Hold'em No Limit - Level III (25/50) - 2013/05/19 10:17:02 BRT [2013/05/19 9:17:02 ET]
Table '734961465 2' 9-max Seat #1 is the button
Seat 1: greenjack.eu (785 in chips) 
Seat 2: guma475 (819 in chips) 
Seat 4: llleopold (2351 in chips) 
Seat 5: dfcastro.net (1280 in chips) 
Seat 6: rifkat_ham (1925 in chips) 
Seat 7: Fauxpas123 (1995 in chips) 
Seat 8: 1DMITRYSPb1 (1165 in chips) 
Seat 9: masha02468 (1510 in chips) 
guma475: posts small blind 25
llleopold: posts big blind 50
*** HOLE CARDS ***
Dealt to dfcastro.net [Ah Th]
dfcastro.net: raises 60 to 110
rifkat_ham: folds 
Fauxpas123: calls 110
1DMITRYSPb1: folds 
masha02468: folds 
greenjack.eu: folds 
guma475: folds 
llleopold: calls 60
*** FLOP *** [Jh 8c 9c]
llleopold: checks 
dfcastro.net: checks 
Fauxpas123: checks 
*** TURN *** [Jh 8c 9c] [Qh]
llleopold: checks 
dfcastro.net: bets 250
Fauxpas123: folds 
llleopold: folds 
Uncalled bet (250) returned to dfcastro.net
dfcastro.net collected 355 from pot
dfcastro.net: doesn't show hand 
*** SUMMARY ***
Total pot 355 | Rake 0 
Board [Jh 8c 9c Qh]
Seat 1: greenjack.eu (button) folded before Flop (didn't bet)
Seat 2: guma475 (small blind) folded before Flop
Seat 4: llleopold (big blind) folded on the Turn
Seat 5: dfcastro.net collected (355)
Seat 6: rifkat_ham folded before Flop (didn't bet)
Seat 7: Fauxpas123 folded on the Turn
Seat 8: 1DMITRYSPb1 folded before Flop (didn't bet)
Seat 9: masha02468 folded before Flop (didn't bet)



PokerStars Hand #98795801162: Tournament #734961465, $0.23+$0.02 USD Hold'em No Limit - Level III (25/50) - 2013/05/19 10:18:07 BRT [2013/05/19 9:18:07 ET]
Table '734961465 2' 9-max Seat #2 is the button
Seat 1: greenjack.eu (785 in chips) 
Seat 2: guma475 (794 in chips) 
Seat 4: llleopold (2241 in chips) 
Seat 5: dfcastro.net (1525 in chips) 
Seat 6: rifkat_ham (1925 in chips) 
Seat 7: Fauxpas123 (1885 in chips) 
Seat 8: 1DMITRYSPb1 (1165 in chips) 
Seat 9: masha02468 (1510 in chips) 
llleopold: posts small blind 25
dfcastro.net: posts big blind 50
*** HOLE CARDS ***
Dealt to dfcastro.net [8d 8c]
rifkat_ham: folds 
Fauxpas123: calls 50
1DMITRYSPb1: folds 
masha02468: folds 
greenjack.eu: raises 50 to 100
guma475: calls 100
llleopold: raises 300 to 400
dfcastro.net: folds 
Fauxpas123: folds 
greenjack.eu: folds 
guma475: raises 394 to 794 and is all-in
llleopold: calls 394
*** FLOP *** [2h Td Jd]
*** TURN *** [2h Td Jd] [3h]
*** RIVER *** [2h Td Jd 3h] [4s]
*** SHOW DOWN ***
llleopold: shows [As Ad] (a pair of Aces)
guma475: shows [7c 9d] (high card Jack)
llleopold collected 1788 from pot
guma475 finished the tournament in 31st place
*** SUMMARY ***
Total pot 1788 | Rake 0 
Board [2h Td Jd 3h 4s]
Seat 1: greenjack.eu folded before Flop
Seat 2: guma475 (button) showed [7c 9d] and lost with high card Jack
Seat 4: llleopold (small blind) showed [As Ad] and won (1788) with a pair of Aces
Seat 5: dfcastro.net (big blind) folded before Flop
Seat 6: rifkat_ham folded before Flop (didn't bet)
Seat 7: Fauxpas123 folded before Flop
Seat 8: 1DMITRYSPb1 folded before Flop (didn't bet)
Seat 9: masha02468 folded before Flop (didn't bet)



PokerStars Hand #98795852240: Tournament #734961465, $0.23+$0.02 USD Hold'em No Limit - Level III (25/50) - 2013/05/19 10:19:28 BRT [2013/05/19 9:19:28 ET]
Table '734961465 2' 9-max Seat #4 is the button
Seat 1: greenjack.eu (685 in chips) 
Seat 4: llleopold (3235 in chips) 
Seat 5: dfcastro.net (1475 in chips) 
Seat 6: rifkat_ham (1925 in chips) 
Seat 7: Fauxpas123 (1835 in chips) 
Seat 8: 1DMITRYSPb1 (1165 in chips) 
Seat 9: masha02468 (1510 in chips) 
dfcastro.net: posts small blind 25
rifkat_ham: posts big blind 50
*** HOLE CARDS ***
Dealt to dfcastro.net [8h Qc]
Fauxpas123: raises 100 to 150
1DMITRYSPb1: folds 
masha02468: folds 
greenjack.eu: folds 
llleopold: folds 
dfcastro.net: folds 
rifkat_ham: folds 
Uncalled bet (100) returned to Fauxpas123
Fauxpas123 collected 125 from pot
*** SUMMARY ***
Total pot 125 | Rake 0 
Seat 1: greenjack.eu folded before Flop (didn't bet)
Seat 4: llleopold (button) folded before Flop (didn't bet)
Seat 5: dfcastro.net (small blind) folded before Flop
Seat 6: rifkat_ham (big blind) folded before Flop
Seat 7: Fauxpas123 collected (125)
Seat 8: 1DMITRYSPb1 folded before Flop (didn't bet)
Seat 9: masha02468 folded before Flop (didn't bet)



PokerStars Hand #98795871420: Tournament #734961465, $0.23+$0.02 USD Hold'em No Limit - Level III (25/50) - 2013/05/19 10:19:58 BRT [2013/05/19 9:19:58 ET]
Table '734961465 2' 9-max Seat #5 is the button
Seat 1: greenjack.eu (685 in chips) 
Seat 4: llleopold (3235 in chips) 
Seat 5: dfcastro.net (1450 in chips) 
Seat 6: rifkat_ham (1875 in chips) 
Seat 7: Fauxpas123 (1910 in chips) 
Seat 8: 1DMITRYSPb1 (1165 in chips) 
Seat 9: masha02468 (1510 in chips) 
rifkat_ham: posts small blind 25
Fauxpas123: posts big blind 50
*** HOLE CARDS ***
Dealt to dfcastro.net [Td Tc]
1DMITRYSPb1: folds 
masha02468: folds 
greenjack.eu: raises 50 to 100
llleopold: folds 
dfcastro.net: calls 100
rifkat_ham: folds 
Fauxpas123: calls 50
*** FLOP *** [9c 6c 2h]
Fauxpas123: checks 
greenjack.eu: checks 
dfcastro.net: bets 190
Fauxpas123: folds 
greenjack.eu: raises 395 to 585 and is all-in
dfcastro.net: calls 395
*** TURN *** [9c 6c 2h] [Qc]
*** RIVER *** [9c 6c 2h Qc] [9s]
*** SHOW DOWN ***
greenjack.eu: shows [7s 6h] (two pair, Nines and Sixes)
dfcastro.net: shows [Td Tc] (two pair, Tens and Nines)
dfcastro.net collected 1495 from pot
greenjack.eu finished the tournament in 29th place
*** SUMMARY ***
Total pot 1495 | Rake 0 
Board [9c 6c 2h Qc 9s]
Seat 1: greenjack.eu showed [7s 6h] and lost with two pair, Nines and Sixes
Seat 4: llleopold folded before Flop (didn't bet)
Seat 5: dfcastro.net (button) showed [Td Tc] and won (1495) with two pair, Tens and Nines
Seat 6: rifkat_ham (small blind) folded before Flop
Seat 7: Fauxpas123 (big blind) folded on the Flop
Seat 8: 1DMITRYSPb1 folded before Flop (didn't bet)
Seat 9: masha02468 folded before Flop (didn't bet)



PokerStars Hand #98795916636: Tournament #734961465, $0.23+$0.02 USD Hold'em No Limit - Level III (25/50) - 2013/05/19 10:21:11 BRT [2013/05/19 9:21:11 ET]
Table '734961465 2' 9-max Seat #6 is the button
Seat 4: llleopold (3235 in chips) 
Seat 5: dfcastro.net (2260 in chips) 
Seat 6: rifkat_ham (1850 in chips) 
Seat 7: Fauxpas123 (1810 in chips) 
Seat 8: 1DMITRYSPb1 (1165 in chips) 
Seat 9: masha02468 (1510 in chips) 
Fauxpas123: posts small blind 25
1DMITRYSPb1: posts big blind 50
*** HOLE CARDS ***
Dealt to dfcastro.net [5d Kc]
masha02468: folds 
llleopold: folds 
dfcastro.net: folds 
rifkat_ham: raises 75 to 125
Fauxpas123: calls 100
1DMITRYSPb1: folds 
*** FLOP *** [8s Qd 2d]
Fauxpas123: bets 150
rifkat_ham: calls 150
*** TURN *** [8s Qd 2d] [9s]
Fauxpas123: bets 150
rifkat_ham: raises 200 to 350
Fauxpas123: calls 200
*** RIVER *** [8s Qd 2d 9s] [2s]
Fauxpas123: checks 
rifkat_ham: bets 1225 and is all-in
Fauxpas123: folds 
Uncalled bet (1225) returned to rifkat_ham
rifkat_ham collected 1300 from pot
*** SUMMARY ***
Total pot 1300 | Rake 0 
Board [8s Qd 2d 9s 2s]
Seat 4: llleopold folded before Flop (didn't bet)
Seat 5: dfcastro.net folded before Flop (didn't bet)
Seat 6: rifkat_ham (button) collected (1300)
Seat 7: Fauxpas123 (small blind) folded on the River
Seat 8: 1DMITRYSPb1 (big blind) folded before Flop
Seat 9: masha02468 folded before Flop (didn't bet)



PokerStars Hand #98795959399: Tournament #734961465, $0.23+$0.02 USD Hold'em No Limit - Level III (25/50) - 2013/05/19 10:22:19 BRT [2013/05/19 9:22:19 ET]
Table '734961465 2' 9-max Seat #7 is the button
Seat 1: Farmboy4321 (2896 in chips) 
Seat 2: Bastardo Q9 (5135 in chips) 
Seat 3: LuckyDayRS (2105 in chips) 
Seat 4: llleopold (3235 in chips) 
Seat 5: dfcastro.net (2260 in chips) 
Seat 6: rifkat_ham (2525 in chips) 
Seat 7: Fauxpas123 (1185 in chips) 
Seat 8: 1DMITRYSPb1 (1115 in chips) 
Seat 9: masha02468 (1510 in chips) 
1DMITRYSPb1: posts small blind 25
masha02468: posts big blind 50
*** HOLE CARDS ***
Dealt to dfcastro.net [5c 6h]
Farmboy4321: folds 
Bastardo Q9: folds 
LuckyDayRS: folds 
llleopold: folds 
dfcastro.net: folds 
rifkat_ham: folds 
Fauxpas123: calls 50
1DMITRYSPb1: calls 25
masha02468: checks 
*** FLOP *** [Ad 3d 7c]
1DMITRYSPb1: checks 
masha02468: checks 
Fauxpas123: checks 
*** TURN *** [Ad 3d 7c] [4h]
1DMITRYSPb1: checks 
masha02468: bets 50
Fauxpas123: calls 50
1DMITRYSPb1: calls 50
*** RIVER *** [Ad 3d 7c 4h] [Ks]
1DMITRYSPb1: checks 
masha02468: bets 50
Fauxpas123: raises 100 to 150
1DMITRYSPb1: folds 
masha02468: calls 100
*** SHOW DOWN ***
Fauxpas123: shows [Ac 3s] (two pair, Aces and Threes)
masha02468: mucks hand 
Fauxpas123 collected 600 from pot
*** SUMMARY ***
Total pot 600 | Rake 0 
Board [Ad 3d 7c 4h Ks]
Seat 1: Farmboy4321 folded before Flop (didn't bet)
Seat 2: Bastardo Q9 folded before Flop (didn't bet)
Seat 3: LuckyDayRS folded before Flop (didn't bet)
Seat 4: llleopold folded before Flop (didn't bet)
Seat 5: dfcastro.net folded before Flop (didn't bet)
Seat 6: rifkat_ham folded before Flop (didn't bet)
Seat 7: Fauxpas123 (button) showed [Ac 3s] and won (600) with two pair, Aces and Threes
Seat 8: 1DMITRYSPb1 (small blind) folded on the River
Seat 9: masha02468 (big blind) mucked [8c Kh]



PokerStars Hand #98796002660: Tournament #734961465, $0.23+$0.02 USD Hold'em No Limit - Level IV (50/100) - 2013/05/19 10:23:28 BRT [2013/05/19 9:23:28 ET]
Table '734961465 2' 9-max Seat #8 is the button
Seat 1: Farmboy4321 (2896 in chips) 
Seat 2: Bastardo Q9 (5135 in chips) 
Seat 3: LuckyDayRS (2105 in chips) 
Seat 4: llleopold (3235 in chips) 
Seat 5: dfcastro.net (2260 in chips) 
Seat 6: rifkat_ham (2525 in chips) 
Seat 7: Fauxpas123 (1535 in chips) 
Seat 8: 1DMITRYSPb1 (1015 in chips) 
Seat 9: masha02468 (1260 in chips) 
masha02468: posts small blind 50
Farmboy4321: posts big blind 100
*** HOLE CARDS ***
Dealt to dfcastro.net [Kc Qs]
Bastardo Q9: folds 
LuckyDayRS: folds 
llleopold: folds 
dfcastro.net: raises 120 to 220
rifkat_ham: folds 
Fauxpas123: folds 
1DMITRYSPb1: folds 
masha02468: folds 
Farmboy4321: folds 
Uncalled bet (120) returned to dfcastro.net
dfcastro.net collected 250 from pot
dfcastro.net: doesn't show hand 
*** SUMMARY ***
Total pot 250 | Rake 0 
Seat 1: Farmboy4321 (big blind) folded before Flop
Seat 2: Bastardo Q9 folded before Flop (didn't bet)
Seat 3: LuckyDayRS folded before Flop (didn't bet)
Seat 4: llleopold folded before Flop (didn't bet)
Seat 5: dfcastro.net collected (250)
Seat 6: rifkat_ham folded before Flop (didn't bet)
Seat 7: Fauxpas123 folded before Flop (didn't bet)
Seat 8: 1DMITRYSPb1 (button) folded before Flop (didn't bet)
Seat 9: masha02468 (small blind) folded before Flop



PokerStars Hand #98796031170: Tournament #734961465, $0.23+$0.02 USD Hold'em No Limit - Level IV (50/100) - 2013/05/19 10:24:13 BRT [2013/05/19 9:24:13 ET]
Table '734961465 2' 9-max Seat #9 is the button
Seat 1: Farmboy4321 (2796 in chips) 
Seat 2: Bastardo Q9 (5135 in chips) 
Seat 3: LuckyDayRS (2105 in chips) 
Seat 4: llleopold (3235 in chips) 
Seat 5: dfcastro.net (2410 in chips) 
Seat 6: rifkat_ham (2525 in chips) 
Seat 7: Fauxpas123 (1535 in chips) 
Seat 8: 1DMITRYSPb1 (1015 in chips) 
Seat 9: masha02468 (1210 in chips) 
Farmboy4321: posts small blind 50
Bastardo Q9: posts big blind 100
*** HOLE CARDS ***
Dealt to dfcastro.net [Kd 9d]
LuckyDayRS: folds 
llleopold: folds 
dfcastro.net: folds 
rifkat_ham: folds 
Fauxpas123: calls 100
1DMITRYSPb1 is disconnected 
1DMITRYSPb1 is connected 
1DMITRYSPb1: folds 
masha02468: calls 100
Farmboy4321: folds 
Bastardo Q9: raises 400 to 500
Fauxpas123: folds 
masha02468: folds 
Uncalled bet (400) returned to Bastardo Q9
Bastardo Q9 collected 350 from pot
Bastardo Q9: doesn't show hand 
*** SUMMARY ***
Total pot 350 | Rake 0 
Seat 1: Farmboy4321 (small blind) folded before Flop
Seat 2: Bastardo Q9 (big blind) collected (350)
Seat 3: LuckyDayRS folded before Flop (didn't bet)
Seat 4: llleopold folded before Flop (didn't bet)
Seat 5: dfcastro.net folded before Flop (didn't bet)
Seat 6: rifkat_ham folded before Flop (didn't bet)
Seat 7: Fauxpas123 folded before Flop
Seat 8: 1DMITRYSPb1 folded before Flop (didn't bet)
Seat 9: masha02468 (button) folded before Flop



PokerStars Hand #98796075910: Tournament #734961465, $0.23+$0.02 USD Hold'em No Limit - Level IV (50/100) - 2013/05/19 10:25:24 BRT [2013/05/19 9:25:24 ET]
Table '734961465 2' 9-max Seat #1 is the button
Seat 1: Farmboy4321 (2746 in chips) 
Seat 2: Bastardo Q9 (5385 in chips) 
Seat 3: LuckyDayRS (2105 in chips) 
Seat 4: llleopold (3235 in chips) 
Seat 5: dfcastro.net (2410 in chips) 
Seat 6: rifkat_ham (2525 in chips) 
Seat 7: Fauxpas123 (1435 in chips) 
Seat 8: 1DMITRYSPb1 (1015 in chips) 
Seat 9: masha02468 (1110 in chips) 
Bastardo Q9: posts small blind 50
LuckyDayRS: posts big blind 100
*** HOLE CARDS ***
Dealt to dfcastro.net [8d 3h]
llleopold: folds 
dfcastro.net: folds 
rifkat_ham: raises 150 to 250
Fauxpas123: folds 
1DMITRYSPb1: folds 
masha02468: folds 
Farmboy4321: folds 
Bastardo Q9: folds 
LuckyDayRS: folds 
Uncalled bet (150) returned to rifkat_ham
rifkat_ham collected 250 from pot
*** SUMMARY ***
Total pot 250 | Rake 0 
Seat 1: Farmboy4321 (button) folded before Flop (didn't bet)
Seat 2: Bastardo Q9 (small blind) folded before Flop
Seat 3: LuckyDayRS (big blind) folded before Flop
Seat 4: llleopold folded before Flop (didn't bet)
Seat 5: dfcastro.net folded before Flop (didn't bet)
Seat 6: rifkat_ham collected (250)
Seat 7: Fauxpas123 folded before Flop (didn't bet)
Seat 8: 1DMITRYSPb1 folded before Flop (didn't bet)
Seat 9: masha02468 folded before Flop (didn't bet)



PokerStars Hand #98796087592: Tournament #734961465, $0.23+$0.02 USD Hold'em No Limit - Level IV (50/100) - 2013/05/19 10:25:43 BRT [2013/05/19 9:25:43 ET]
Table '734961465 2' 9-max Seat #2 is the button
Seat 1: Farmboy4321 (2746 in chips) 
Seat 2: Bastardo Q9 (5335 in chips) 
Seat 3: LuckyDayRS (2005 in chips) 
Seat 4: llleopold (3235 in chips) 
Seat 5: dfcastro.net (2410 in chips) 
Seat 6: rifkat_ham (2675 in chips) 
Seat 7: Fauxpas123 (1435 in chips) 
Seat 8: 1DMITRYSPb1 (1015 in chips) 
Seat 9: masha02468 (1110 in chips) 
LuckyDayRS: posts small blind 50
llleopold: posts big blind 100
*** HOLE CARDS ***
Dealt to dfcastro.net [9d 3d]
dfcastro.net: folds 
rifkat_ham: folds 
Fauxpas123: calls 100
1DMITRYSPb1: raises 915 to 1015 and is all-in
masha02468: folds 
Farmboy4321: folds 
Bastardo Q9: folds 
LuckyDayRS: folds 
llleopold: folds 
Fauxpas123: calls 915
*** FLOP *** [Js 6d 3h]
*** TURN *** [Js 6d 3h] [2h]
*** RIVER *** [Js 6d 3h 2h] [Qs]
*** SHOW DOWN ***
Fauxpas123: shows [As 3s] (a pair of Threes)
1DMITRYSPb1: shows [Jd Jh] (three of a kind, Jacks)
1DMITRYSPb1 collected 2180 from pot
*** SUMMARY ***
Total pot 2180 | Rake 0 
Board [Js 6d 3h 2h Qs]
Seat 1: Farmboy4321 folded before Flop (didn't bet)
Seat 2: Bastardo Q9 (button) folded before Flop (didn't bet)
Seat 3: LuckyDayRS (small blind) folded before Flop
Seat 4: llleopold (big blind) folded before Flop
Seat 5: dfcastro.net folded before Flop (didn't bet)
Seat 6: rifkat_ham folded before Flop (didn't bet)
Seat 7: Fauxpas123 showed [As 3s] and lost with a pair of Threes
Seat 8: 1DMITRYSPb1 showed [Jd Jh] and won (2180) with three of a kind, Jacks
Seat 9: masha02468 folded before Flop (didn't bet)



PokerStars Hand #98796116955: Tournament #734961465, $0.23+$0.02 USD Hold'em No Limit - Level IV (50/100) - 2013/05/19 10:26:29 BRT [2013/05/19 9:26:29 ET]
Table '734961465 2' 9-max Seat #3 is the button
Seat 1: Farmboy4321 (2746 in chips) 
Seat 2: Bastardo Q9 (5335 in chips) 
Seat 3: LuckyDayRS (1955 in chips) 
Seat 4: llleopold (3135 in chips) 
Seat 5: dfcastro.net (2410 in chips) 
Seat 6: rifkat_ham (2675 in chips) 
Seat 7: Fauxpas123 (420 in chips) 
Seat 8: 1DMITRYSPb1 (2180 in chips) 
Seat 9: masha02468 (1110 in chips) 
llleopold: posts small blind 50
dfcastro.net: posts big blind 100
*** HOLE CARDS ***
Dealt to dfcastro.net [9d Qd]
rifkat_ham: folds 
Fauxpas123: folds 
1DMITRYSPb1: folds 
masha02468: folds 
Farmboy4321: folds 
Bastardo Q9: folds 
LuckyDayRS: folds 
llleopold: raises 106 to 206
dfcastro.net: folds 
Uncalled bet (106) returned to llleopold
llleopold collected 200 from pot
llleopold: doesn't show hand 
*** SUMMARY ***
Total pot 200 | Rake 0 
Seat 1: Farmboy4321 folded before Flop (didn't bet)
Seat 2: Bastardo Q9 folded before Flop (didn't bet)
Seat 3: LuckyDayRS (button) folded before Flop (didn't bet)
Seat 4: llleopold (small blind) collected (200)
Seat 5: dfcastro.net (big blind) folded before Flop
Seat 6: rifkat_ham folded before Flop (didn't bet)
Seat 7: Fauxpas123 folded before Flop (didn't bet)
Seat 8: 1DMITRYSPb1 folded before Flop (didn't bet)
Seat 9: masha02468 folded before Flop (didn't bet)



PokerStars Hand #98796136769: Tournament #734961465, $0.23+$0.02 USD Hold'em No Limit - Level IV (50/100) - 2013/05/19 10:27:00 BRT [2013/05/19 9:27:00 ET]
Table '734961465 2' 9-max Seat #4 is the button
Seat 1: Farmboy4321 (2746 in chips) 
Seat 2: Bastardo Q9 (5335 in chips) 
Seat 3: LuckyDayRS (1955 in chips) 
Seat 4: llleopold (3235 in chips) 
Seat 5: dfcastro.net (2310 in chips) 
Seat 6: rifkat_ham (2675 in chips) 
Seat 7: Fauxpas123 (420 in chips) 
Seat 8: 1DMITRYSPb1 (2180 in chips) 
Seat 9: masha02468 (1110 in chips) 
dfcastro.net: posts small blind 50
rifkat_ham: posts big blind 100
*** HOLE CARDS ***
Dealt to dfcastro.net [Qc Jc]
Fauxpas123: calls 100
1DMITRYSPb1: folds 
masha02468: folds 
Farmboy4321: raises 113 to 213
Bastardo Q9: folds 
LuckyDayRS: folds 
llleopold: folds 
dfcastro.net: calls 163
rifkat_ham: folds 
Fauxpas123: calls 113
*** FLOP *** [9d 7d Kc]
dfcastro.net: checks 
Fauxpas123: checks 
Farmboy4321: checks 
*** TURN *** [9d 7d Kc] [3h]
dfcastro.net: checks 
Fauxpas123: checks 
Farmboy4321: checks 
*** RIVER *** [9d 7d Kc 3h] [6d]
dfcastro.net: checks 
Fauxpas123: checks 
Farmboy4321: checks 
*** SHOW DOWN ***
dfcastro.net: shows [Qc Jc] (high card King)
Fauxpas123: shows [Ac 8h] (high card Ace)
Farmboy4321: shows [As Tc] (high card Ace - King+Ten kicker)
Farmboy4321 collected 739 from pot
*** SUMMARY ***
Total pot 739 | Rake 0 
Board [9d 7d Kc 3h 6d]
Seat 1: Farmboy4321 showed [As Tc] and won (739) with high card Ace
Seat 2: Bastardo Q9 folded before Flop (didn't bet)
Seat 3: LuckyDayRS folded before Flop (didn't bet)
Seat 4: llleopold (button) folded before Flop (didn't bet)
Seat 5: dfcastro.net (small blind) showed [Qc Jc] and lost with high card King
Seat 6: rifkat_ham (big blind) folded before Flop
Seat 7: Fauxpas123 showed [Ac 8h] and lost with high card Ace
Seat 8: 1DMITRYSPb1 folded before Flop (didn't bet)
Seat 9: masha02468 folded before Flop (didn't bet)



PokerStars Hand #98796197432: Tournament #734961465, $0.23+$0.02 USD Hold'em No Limit - Level IV (50/100) - 2013/05/19 10:28:36 BRT [2013/05/19 9:28:36 ET]
Table '734961465 2' 9-max Seat #5 is the button
Seat 1: Farmboy4321 (3272 in chips) 
Seat 2: Bastardo Q9 (5335 in chips) 
Seat 3: LuckyDayRS (1955 in chips) 
Seat 4: llleopold (3235 in chips) 
Seat 5: dfcastro.net (2097 in chips) 
Seat 6: rifkat_ham (2575 in chips) 
Seat 7: Fauxpas123 (207 in chips) 
Seat 8: 1DMITRYSPb1 (2180 in chips) 
Seat 9: masha02468 (1110 in chips) 
rifkat_ham: posts small blind 50
Fauxpas123: posts big blind 100
*** HOLE CARDS ***
Dealt to dfcastro.net [6d 6h]
1DMITRYSPb1: folds 
masha02468: folds 
Farmboy4321: folds 
Bastardo Q9: folds 
LuckyDayRS: folds 
llleopold: folds 
dfcastro.net: calls 100
rifkat_ham: raises 300 to 400
Fauxpas123: calls 107 and is all-in
dfcastro.net: calls 300
*** FLOP *** [As 5d 2c]
rifkat_ham: bets 500
dfcastro.net: folds 
Uncalled bet (500) returned to rifkat_ham
*** TURN *** [As 5d 2c] [Qc]
*** RIVER *** [As 5d 2c Qc] [4h]
*** SHOW DOWN ***
rifkat_ham: shows [Ks Kc] (a pair of Kings)
rifkat_ham collected 386 from side pot
Fauxpas123: shows [Kh 7c] (high card Ace)
rifkat_ham collected 621 from main pot
Fauxpas123 finished the tournament in 25th place
*** SUMMARY ***
Total pot 1007 Main pot 621. Side pot 386. | Rake 0 
Board [As 5d 2c Qc 4h]
Seat 1: Farmboy4321 folded before Flop (didn't bet)
Seat 2: Bastardo Q9 folded before Flop (didn't bet)
Seat 3: LuckyDayRS folded before Flop (didn't bet)
Seat 4: llleopold folded before Flop (didn't bet)
Seat 5: dfcastro.net (button) folded on the Flop
Seat 6: rifkat_ham (small blind) showed [Ks Kc] and won (1007) with a pair of Kings
Seat 7: Fauxpas123 (big blind) showed [Kh 7c] and lost with high card Ace
Seat 8: 1DMITRYSPb1 folded before Flop (didn't bet)
Seat 9: masha02468 folded before Flop (didn't bet)



PokerStars Hand #98796248478: Tournament #734961465, $0.23+$0.02 USD Hold'em No Limit - Level IV (50/100) - 2013/05/19 10:29:57 BRT [2013/05/19 9:29:57 ET]
Table '734961465 2' 9-max Seat #6 is the button
Seat 1: Farmboy4321 (3272 in chips) 
Seat 2: Bastardo Q9 (5335 in chips) 
Seat 3: LuckyDayRS (1955 in chips) 
Seat 4: llleopold (3235 in chips) 
Seat 5: dfcastro.net (1697 in chips) 
Seat 6: rifkat_ham (3182 in chips) 
Seat 8: 1DMITRYSPb1 (2180 in chips) 
Seat 9: masha02468 (1110 in chips) 
1DMITRYSPb1: posts small blind 50
masha02468: posts big blind 100
*** HOLE CARDS ***
Dealt to dfcastro.net [5s 6s]
Farmboy4321: folds 
Bastardo Q9: folds 
LuckyDayRS: folds 
llleopold: folds 
dfcastro.net: folds 
rifkat_ham: raises 150 to 250
1DMITRYSPb1: folds 
masha02468: folds 
Uncalled bet (150) returned to rifkat_ham
rifkat_ham collected 250 from pot
*** SUMMARY ***
Total pot 250 | Rake 0 
Seat 1: Farmboy4321 folded before Flop (didn't bet)
Seat 2: Bastardo Q9 folded before Flop (didn't bet)
Seat 3: LuckyDayRS folded before Flop (didn't bet)
Seat 4: llleopold folded before Flop (didn't bet)
Seat 5: dfcastro.net folded before Flop (didn't bet)
Seat 6: rifkat_ham (button) collected (250)
Seat 8: 1DMITRYSPb1 (small blind) folded before Flop
Seat 9: masha02468 (big blind) folded before Flop



PokerStars Hand #98796269693: Tournament #734961465, $0.23+$0.02 USD Hold'em No Limit - Level IV (50/100) - 2013/05/19 10:30:31 BRT [2013/05/19 9:30:31 ET]
Table '734961465 2' 9-max Seat #8 is the button
Seat 1: Farmboy4321 (3272 in chips) 
Seat 2: Bastardo Q9 (5335 in chips) 
Seat 3: LuckyDayRS (1955 in chips) 
Seat 4: llleopold (3235 in chips) 
Seat 5: dfcastro.net (1697 in chips) 
Seat 6: rifkat_ham (3332 in chips) 
Seat 8: 1DMITRYSPb1 (2130 in chips) 
Seat 9: masha02468 (1010 in chips) 
masha02468: posts small blind 50
Farmboy4321: posts big blind 100
*** HOLE CARDS ***
Dealt to dfcastro.net [Qc 2c]
Bastardo Q9: folds 
LuckyDayRS: folds 
llleopold: folds 
dfcastro.net: folds 
rifkat_ham: folds 
1DMITRYSPb1: folds 
masha02468: folds 
Uncalled bet (50) returned to Farmboy4321
Farmboy4321 collected 100 from pot
Farmboy4321: doesn't show hand 
*** SUMMARY ***
Total pot 100 | Rake 0 
Seat 1: Farmboy4321 (big blind) collected (100)
Seat 2: Bastardo Q9 folded before Flop (didn't bet)
Seat 3: LuckyDayRS folded before Flop (didn't bet)
Seat 4: llleopold folded before Flop (didn't bet)
Seat 5: dfcastro.net folded before Flop (didn't bet)
Seat 6: rifkat_ham folded before Flop (didn't bet)
Seat 8: 1DMITRYSPb1 (button) folded before Flop (didn't bet)
Seat 9: masha02468 (small blind) folded before Flop



PokerStars Hand #98796290505: Tournament #734961465, $0.23+$0.02 USD Hold'em No Limit - Level IV (50/100) - 2013/05/19 10:31:04 BRT [2013/05/19 9:31:04 ET]
Table '734961465 2' 9-max Seat #9 is the button
Seat 1: Farmboy4321 (3322 in chips) 
Seat 2: Bastardo Q9 (5335 in chips) 
Seat 3: LuckyDayRS (1955 in chips) 
Seat 4: llleopold (3235 in chips) 
Seat 5: dfcastro.net (1697 in chips) 
Seat 6: rifkat_ham (3332 in chips) 
Seat 8: 1DMITRYSPb1 (2130 in chips) 
Seat 9: masha02468 (960 in chips) 
Farmboy4321: posts small blind 50
Bastardo Q9: posts big blind 100
*** HOLE CARDS ***
Dealt to dfcastro.net [9h 5s]
LuckyDayRS: folds 
llleopold: folds 
dfcastro.net: folds 
rifkat_ham: folds 
1DMITRYSPb1: raises 110 to 210
masha02468: folds 
Farmboy4321: calls 160
Bastardo Q9: calls 110
*** FLOP *** [7h Ts 2c]
Farmboy4321: checks 
Bastardo Q9: checks 
1DMITRYSPb1: checks 
*** TURN *** [7h Ts 2c] [Jc]
Farmboy4321: checks 
Bastardo Q9: bets 425
1DMITRYSPb1: folds 
Farmboy4321: folds 
Uncalled bet (425) returned to Bastardo Q9
Bastardo Q9 collected 630 from pot
*** SUMMARY ***
Total pot 630 | Rake 0 
Board [7h Ts 2c Jc]
Seat 1: Farmboy4321 (small blind) folded on the Turn
Seat 2: Bastardo Q9 (big blind) collected (630)
Seat 3: LuckyDayRS folded before Flop (didn't bet)
Seat 4: llleopold folded before Flop (didn't bet)
Seat 5: dfcastro.net folded before Flop (didn't bet)
Seat 6: rifkat_ham folded before Flop (didn't bet)
Seat 8: 1DMITRYSPb1 folded on the Turn
Seat 9: masha02468 (button) folded before Flop (didn't bet)



PokerStars Hand #98796327905: Tournament #734961465, $0.23+$0.02 USD Hold'em No Limit - Level IV (50/100) - 2013/05/19 10:32:02 BRT [2013/05/19 9:32:02 ET]
Table '734961465 2' 9-max Seat #1 is the button
Seat 1: Farmboy4321 (3112 in chips) 
Seat 2: Bastardo Q9 (5755 in chips) 
Seat 3: LuckyDayRS (1955 in chips) 
Seat 4: llleopold (3235 in chips) 
Seat 5: dfcastro.net (1697 in chips) 
Seat 6: rifkat_ham (3332 in chips) 
Seat 8: 1DMITRYSPb1 (1920 in chips) 
Seat 9: masha02468 (960 in chips) 
Bastardo Q9: posts small blind 50
LuckyDayRS: posts big blind 100
*** HOLE CARDS ***
Dealt to dfcastro.net [7c Kh]
llleopold: folds 
dfcastro.net: folds 
rifkat_ham: folds 
1DMITRYSPb1: folds 
masha02468: folds 
Farmboy4321: folds 
Bastardo Q9: folds 
Uncalled bet (50) returned to LuckyDayRS
LuckyDayRS collected 100 from pot
*** SUMMARY ***
Total pot 100 | Rake 0 
Seat 1: Farmboy4321 (button) folded before Flop (didn't bet)
Seat 2: Bastardo Q9 (small blind) folded before Flop
Seat 3: LuckyDayRS (big blind) collected (100)
Seat 4: llleopold folded before Flop (didn't bet)
Seat 5: dfcastro.net folded before Flop (didn't bet)
Seat 6: rifkat_ham folded before Flop (didn't bet)
Seat 8: 1DMITRYSPb1 folded before Flop (didn't bet)
Seat 9: masha02468 folded before Flop (didn't bet)



PokerStars Hand #98796347844: Tournament #734961465, $0.23+$0.02 USD Hold'em No Limit - Level V (75/150) - 2013/05/19 10:32:34 BRT [2013/05/19 9:32:34 ET]
Table '734961465 2' 9-max Seat #2 is the button
Seat 1: Farmboy4321 (3112 in chips) 
Seat 2: Bastardo Q9 (5705 in chips) 
Seat 3: LuckyDayRS (2005 in chips) 
Seat 4: llleopold (3235 in chips) 
Seat 5: dfcastro.net (1697 in chips) 
Seat 6: rifkat_ham (3332 in chips) 
Seat 8: 1DMITRYSPb1 (1920 in chips) 
Seat 9: masha02468 (960 in chips) 
LuckyDayRS: posts small blind 75
llleopold: posts big blind 150
*** HOLE CARDS ***
Dealt to dfcastro.net [Ts Jh]
dfcastro.net: folds 
rifkat_ham: folds 
1DMITRYSPb1: folds 
masha02468: folds 
Farmboy4321: folds 
Bastardo Q9: folds 
LuckyDayRS: raises 225 to 375
llleopold: folds 
Uncalled bet (225) returned to LuckyDayRS
LuckyDayRS collected 300 from pot
*** SUMMARY ***
Total pot 300 | Rake 0 
Seat 1: Farmboy4321 folded before Flop (didn't bet)
Seat 2: Bastardo Q9 (button) folded before Flop (didn't bet)
Seat 3: LuckyDayRS (small blind) collected (300)
Seat 4: llleopold (big blind) folded before Flop
Seat 5: dfcastro.net folded before Flop (didn't bet)
Seat 6: rifkat_ham folded before Flop (didn't bet)
Seat 8: 1DMITRYSPb1 folded before Flop (didn't bet)
Seat 9: masha02468 folded before Flop (didn't bet)



PokerStars Hand #98796363942: Tournament #734961465, $0.23+$0.02 USD Hold'em No Limit - Level V (75/150) - 2013/05/19 10:32:59 BRT [2013/05/19 9:32:59 ET]
Table '734961465 2' 9-max Seat #3 is the button
Seat 1: Farmboy4321 (3112 in chips) 
Seat 2: Bastardo Q9 (5705 in chips) 
Seat 3: LuckyDayRS (2155 in chips) 
Seat 4: llleopold (3085 in chips) 
Seat 5: dfcastro.net (1697 in chips) 
Seat 6: rifkat_ham (3332 in chips) 
Seat 8: 1DMITRYSPb1 (1920 in chips) 
Seat 9: masha02468 (960 in chips) 
llleopold: posts small blind 75
dfcastro.net: posts big blind 150
*** HOLE CARDS ***
Dealt to dfcastro.net [9c 6s]
rifkat_ham: folds 
1DMITRYSPb1: folds 
masha02468: folds 
Farmboy4321: folds 
Bastardo Q9: folds 
LuckyDayRS: folds 
llleopold: raises 160 to 310
dfcastro.net: folds 
Uncalled bet (160) returned to llleopold
llleopold collected 300 from pot
llleopold: doesn't show hand 
*** SUMMARY ***
Total pot 300 | Rake 0 
Seat 1: Farmboy4321 folded before Flop (didn't bet)
Seat 2: Bastardo Q9 folded before Flop (didn't bet)
Seat 3: LuckyDayRS (button) folded before Flop (didn't bet)
Seat 4: llleopold (small blind) collected (300)
Seat 5: dfcastro.net (big blind) folded before Flop
Seat 6: rifkat_ham folded before Flop (didn't bet)
Seat 8: 1DMITRYSPb1 folded before Flop (didn't bet)
Seat 9: masha02468 folded before Flop (didn't bet)



PokerStars Hand #98796381912: Tournament #734961465, $0.23+$0.02 USD Hold'em No Limit - Level V (75/150) - 2013/05/19 10:33:28 BRT [2013/05/19 9:33:28 ET]
Table '734961465 2' 9-max Seat #4 is the button
Seat 1: Farmboy4321 (3112 in chips) 
Seat 2: Bastardo Q9 (5705 in chips) 
Seat 3: LuckyDayRS (2155 in chips) 
Seat 4: llleopold (3235 in chips) 
Seat 5: dfcastro.net (1547 in chips) 
Seat 6: rifkat_ham (3332 in chips) 
Seat 8: 1DMITRYSPb1 (1920 in chips) 
Seat 9: masha02468 (960 in chips) 
dfcastro.net: posts small blind 75
rifkat_ham: posts big blind 150
*** HOLE CARDS ***
Dealt to dfcastro.net [Tc 8c]
1DMITRYSPb1: folds 
masha02468: folds 
Farmboy4321: folds 
Bastardo Q9: folds 
LuckyDayRS: raises 187 to 337
llleopold: folds 
dfcastro.net: folds 
rifkat_ham: calls 187
*** FLOP *** [2s 4c Ac]
rifkat_ham: checks 
LuckyDayRS: checks 
*** TURN *** [2s 4c Ac] [Ad]
rifkat_ham: bets 450
LuckyDayRS: calls 450
*** RIVER *** [2s 4c Ac Ad] [8s]
rifkat_ham: checks 
LuckyDayRS: checks 
*** SHOW DOWN ***
rifkat_ham: shows [Kc Qs] (a pair of Aces)
LuckyDayRS: shows [Jc Jd] (two pair, Aces and Jacks)
LuckyDayRS collected 1649 from pot
*** SUMMARY ***
Total pot 1649 | Rake 0 
Board [2s 4c Ac Ad 8s]
Seat 1: Farmboy4321 folded before Flop (didn't bet)
Seat 2: Bastardo Q9 folded before Flop (didn't bet)
Seat 3: LuckyDayRS showed [Jc Jd] and won (1649) with two pair, Aces and Jacks
Seat 4: llleopold (button) folded before Flop (didn't bet)
Seat 5: dfcastro.net (small blind) folded before Flop
Seat 6: rifkat_ham (big blind) showed [Kc Qs] and lost with a pair of Aces
Seat 8: 1DMITRYSPb1 folded before Flop (didn't bet)
Seat 9: masha02468 folded before Flop (didn't bet)



PokerStars Hand #98796419821: Tournament #734961465, $0.23+$0.02 USD Hold'em No Limit - Level V (75/150) - 2013/05/19 10:34:26 BRT [2013/05/19 9:34:26 ET]
Table '734961465 2' 9-max Seat #5 is the button
Seat 1: Farmboy4321 (3112 in chips) 
Seat 2: Bastardo Q9 (5705 in chips) 
Seat 3: LuckyDayRS (3017 in chips) 
Seat 4: llleopold (3235 in chips) 
Seat 5: dfcastro.net (1472 in chips) 
Seat 6: rifkat_ham (2545 in chips) 
Seat 8: 1DMITRYSPb1 (1920 in chips) 
Seat 9: masha02468 (960 in chips) 
rifkat_ham: posts small blind 75
1DMITRYSPb1: posts big blind 150
*** HOLE CARDS ***
Dealt to dfcastro.net [2d 3h]
masha02468: calls 150
Farmboy4321: folds 
Bastardo Q9: folds 
LuckyDayRS: folds 
llleopold: calls 150
dfcastro.net: folds 
rifkat_ham: calls 75
1DMITRYSPb1: checks 
*** FLOP *** [As 9s 4s]
rifkat_ham: checks 
1DMITRYSPb1: bets 300
masha02468: calls 300
llleopold: folds 
rifkat_ham: folds 
*** TURN *** [As 9s 4s] [Jc]
1DMITRYSPb1: bets 300
masha02468: raises 210 to 510 and is all-in
1DMITRYSPb1: calls 210
*** RIVER *** [As 9s 4s Jc] [9d]
*** SHOW DOWN ***
1DMITRYSPb1: shows [Ad 8s] (two pair, Aces and Nines)
masha02468: shows [Ac Th] (two pair, Aces and Nines)
1DMITRYSPb1 collected 1110 from pot
masha02468 collected 1110 from pot
*** SUMMARY ***
Total pot 2220 | Rake 0 
Board [As 9s 4s Jc 9d]
Seat 1: Farmboy4321 folded before Flop (didn't bet)
Seat 2: Bastardo Q9 folded before Flop (didn't bet)
Seat 3: LuckyDayRS folded before Flop (didn't bet)
Seat 4: llleopold folded on the Flop
Seat 5: dfcastro.net (button) folded before Flop (didn't bet)
Seat 6: rifkat_ham (small blind) folded on the Flop
Seat 8: 1DMITRYSPb1 (big blind) showed [Ad 8s] and won (1110) with two pair, Aces and Nines
Seat 9: masha02468 showed [Ac Th] and won (1110) with two pair, Aces and Nines



PokerStars Hand #98796454380: Tournament #734961465, $0.23+$0.02 USD Hold'em No Limit - Level V (75/150) - 2013/05/19 10:35:19 BRT [2013/05/19 9:35:19 ET]
Table '734961465 2' 9-max Seat #6 is the button
Seat 1: Farmboy4321 (3112 in chips) 
Seat 2: Bastardo Q9 (5705 in chips) 
Seat 3: LuckyDayRS (3017 in chips) 
Seat 4: llleopold (3085 in chips) 
Seat 5: dfcastro.net (1472 in chips) 
Seat 6: rifkat_ham (2395 in chips) 
Seat 8: 1DMITRYSPb1 (2070 in chips) 
Seat 9: masha02468 (1110 in chips) 
1DMITRYSPb1: posts small blind 75
masha02468: posts big blind 150
*** HOLE CARDS ***
Dealt to dfcastro.net [8d As]
Farmboy4321: folds 
Bastardo Q9: folds 
LuckyDayRS: folds 
llleopold: folds 
dfcastro.net: raises 180 to 330
rifkat_ham: folds 
1DMITRYSPb1: folds 
masha02468: folds 
Uncalled bet (180) returned to dfcastro.net
dfcastro.net collected 375 from pot
dfcastro.net: doesn't show hand 
*** SUMMARY ***
Total pot 375 | Rake 0 
Seat 1: Farmboy4321 folded before Flop (didn't bet)
Seat 2: Bastardo Q9 folded before Flop (didn't bet)
Seat 3: LuckyDayRS folded before Flop (didn't bet)
Seat 4: llleopold folded before Flop (didn't bet)
Seat 5: dfcastro.net collected (375)
Seat 6: rifkat_ham (button) folded before Flop (didn't bet)
Seat 8: 1DMITRYSPb1 (small blind) folded before Flop
Seat 9: masha02468 (big blind) folded before Flop



PokerStars Hand #98796472325: Tournament #734961465, $0.23+$0.02 USD Hold'em No Limit - Level V (75/150) - 2013/05/19 10:35:47 BRT [2013/05/19 9:35:47 ET]
Table '734961465 2' 9-max Seat #8 is the button
Seat 1: Farmboy4321 (3112 in chips) 
Seat 2: Bastardo Q9 (5705 in chips) 
Seat 3: LuckyDayRS (3017 in chips) 
Seat 4: llleopold (3085 in chips) 
Seat 5: dfcastro.net (1697 in chips) 
Seat 6: rifkat_ham (2395 in chips) 
Seat 8: 1DMITRYSPb1 (1995 in chips) 
Seat 9: masha02468 (960 in chips) 
masha02468: posts small blind 75
Farmboy4321: posts big blind 150
*** HOLE CARDS ***
Dealt to dfcastro.net [7c Jd]
Bastardo Q9: folds 
LuckyDayRS: raises 187 to 337
llleopold: folds 
dfcastro.net: folds 
rifkat_ham: folds 
1DMITRYSPb1: folds 
masha02468: folds 
Farmboy4321: folds 
Uncalled bet (187) returned to LuckyDayRS
LuckyDayRS collected 375 from pot
LuckyDayRS: doesn't show hand 
*** SUMMARY ***
Total pot 375 | Rake 0 
Seat 1: Farmboy4321 (big blind) folded before Flop
Seat 2: Bastardo Q9 folded before Flop (didn't bet)
Seat 3: LuckyDayRS collected (375)
Seat 4: llleopold folded before Flop (didn't bet)
Seat 5: dfcastro.net folded before Flop (didn't bet)
Seat 6: rifkat_ham folded before Flop (didn't bet)
Seat 8: 1DMITRYSPb1 (button) folded before Flop (didn't bet)
Seat 9: masha02468 (small blind) folded before Flop



PokerStars Hand #98796489512: Tournament #734961465, $0.23+$0.02 USD Hold'em No Limit - Level V (75/150) - 2013/05/19 10:36:13 BRT [2013/05/19 9:36:13 ET]
Table '734961465 2' 9-max Seat #9 is the button
Seat 1: Farmboy4321 (2962 in chips) 
Seat 2: Bastardo Q9 (5705 in chips) 
Seat 3: LuckyDayRS (3242 in chips) 
Seat 4: llleopold (3085 in chips) 
Seat 5: dfcastro.net (1697 in chips) 
Seat 6: rifkat_ham (2395 in chips) 
Seat 8: 1DMITRYSPb1 (1995 in chips) 
Seat 9: masha02468 (885 in chips) 
Farmboy4321: posts small blind 75
Bastardo Q9: posts big blind 150
*** HOLE CARDS ***
Dealt to dfcastro.net [Js Ah]
LuckyDayRS: folds 
llleopold: folds 
dfcastro.net: raises 180 to 330
rifkat_ham: folds 
1DMITRYSPb1: folds 
masha02468: folds 
Farmboy4321: folds 
Bastardo Q9: folds [2c]
Uncalled bet (180) returned to dfcastro.net
dfcastro.net collected 375 from pot
dfcastro.net: doesn't show hand 
*** SUMMARY ***
Total pot 375 | Rake 0 
Seat 1: Farmboy4321 (small blind) folded before Flop
Seat 2: Bastardo Q9 (big blind) folded before Flop
Seat 3: LuckyDayRS folded before Flop (didn't bet)
Seat 4: llleopold folded before Flop (didn't bet)
Seat 5: dfcastro.net collected (375)
Seat 6: rifkat_ham folded before Flop (didn't bet)
Seat 8: 1DMITRYSPb1 folded before Flop (didn't bet)
Seat 9: masha02468 (button) folded before Flop (didn't bet)



PokerStars Hand #98796513542: Tournament #734961465, $0.23+$0.02 USD Hold'em No Limit - Level V (75/150) - 2013/05/19 10:36:49 BRT [2013/05/19 9:36:49 ET]
Table '734961465 2' 9-max Seat #1 is the button
Seat 1: Farmboy4321 (2887 in chips) 
Seat 2: Bastardo Q9 (5555 in chips) 
Seat 3: LuckyDayRS (3242 in chips) 
Seat 4: llleopold (3085 in chips) 
Seat 5: dfcastro.net (1922 in chips) 
Seat 6: rifkat_ham (2395 in chips) 
Seat 8: 1DMITRYSPb1 (1995 in chips) 
Seat 9: masha02468 (885 in chips) 
Bastardo Q9: posts small blind 75
LuckyDayRS: posts big blind 150
*** HOLE CARDS ***
Dealt to dfcastro.net [Ad 8d]
llleopold: folds 
dfcastro.net: folds 
rifkat_ham: folds 
1DMITRYSPb1: folds 
masha02468: raises 300 to 450
Farmboy4321: folds 
Bastardo Q9: folds 
LuckyDayRS: folds 
Uncalled bet (300) returned to masha02468
masha02468 collected 375 from pot
*** SUMMARY ***
Total pot 375 | Rake 0 
Seat 1: Farmboy4321 (button) folded before Flop (didn't bet)
Seat 2: Bastardo Q9 (small blind) folded before Flop
Seat 3: LuckyDayRS (big blind) folded before Flop
Seat 4: llleopold folded before Flop (didn't bet)
Seat 5: dfcastro.net folded before Flop (didn't bet)
Seat 6: rifkat_ham folded before Flop (didn't bet)
Seat 8: 1DMITRYSPb1 folded before Flop (didn't bet)
Seat 9: masha02468 collected (375)



PokerStars Hand #98796539417: Tournament #734961465, $0.23+$0.02 USD Hold'em No Limit - Level V (75/150) - 2013/05/19 10:37:28 BRT [2013/05/19 9:37:28 ET]
Table '734961465 2' 9-max Seat #2 is the button
Seat 1: Farmboy4321 (2887 in chips) 
Seat 2: Bastardo Q9 (5480 in chips) 
Seat 3: LuckyDayRS (3092 in chips) 
Seat 4: llleopold (3085 in chips) 
Seat 5: dfcastro.net (1922 in chips) 
Seat 6: rifkat_ham (2395 in chips) 
Seat 9: masha02468 (1110 in chips) 
LuckyDayRS: posts small blind 75
llleopold: posts big blind 150
*** HOLE CARDS ***
Dealt to dfcastro.net [Kd 6c]
dfcastro.net: folds 
rifkat_ham: folds 
masha02468: calls 150
Farmboy4321: folds 
Bastardo Q9: folds 
LuckyDayRS: folds 
llleopold: checks 
*** FLOP *** [2d 7h 4s]
llleopold: checks 
masha02468: bets 150
llleopold: raises 1950 to 2100
masha02468: folds 
Uncalled bet (1950) returned to llleopold
llleopold collected 675 from pot
llleopold: doesn't show hand 
*** SUMMARY ***
Total pot 675 | Rake 0 
Board [2d 7h 4s]
Seat 1: Farmboy4321 folded before Flop (didn't bet)
Seat 2: Bastardo Q9 (button) folded before Flop (didn't bet)
Seat 3: LuckyDayRS (small blind) folded before Flop
Seat 4: llleopold (big blind) collected (675)
Seat 5: dfcastro.net folded before Flop (didn't bet)
Seat 6: rifkat_ham folded before Flop (didn't bet)
Seat 9: masha02468 folded on the Flop



PokerStars Hand #98796567761: Tournament #734961465, $0.23+$0.02 USD Hold'em No Limit - Level V (75/150) - 2013/05/19 10:38:12 BRT [2013/05/19 9:38:12 ET]
Table '734961465 2' 9-max Seat #3 is the button
Seat 1: Farmboy4321 (2887 in chips) 
Seat 2: Bastardo Q9 (5480 in chips) 
Seat 3: LuckyDayRS (3017 in chips) 
Seat 4: llleopold (3460 in chips) 
Seat 5: dfcastro.net (1922 in chips) 
Seat 6: rifkat_ham (2395 in chips) 
Seat 9: masha02468 (810 in chips) 
llleopold: posts small blind 75
dfcastro.net: posts big blind 150
*** HOLE CARDS ***
Dealt to dfcastro.net [4d Kd]
rifkat_ham: folds 
masha02468: folds 
Farmboy4321: raises 2737 to 2887 and is all-in
Bastardo Q9: folds 
LuckyDayRS: folds 
llleopold: folds 
dfcastro.net: folds 
Uncalled bet (2737) returned to Farmboy4321
Farmboy4321 collected 375 from pot
Farmboy4321: doesn't show hand 
*** SUMMARY ***
Total pot 375 | Rake 0 
Seat 1: Farmboy4321 collected (375)
Seat 2: Bastardo Q9 folded before Flop (didn't bet)
Seat 3: LuckyDayRS (button) folded before Flop (didn't bet)
Seat 4: llleopold (small blind) folded before Flop
Seat 5: dfcastro.net (big blind) folded before Flop
Seat 6: rifkat_ham folded before Flop (didn't bet)
Seat 9: masha02468 folded before Flop (didn't bet)



PokerStars Hand #98796584802: Tournament #734961465, $0.23+$0.02 USD Hold'em No Limit - Level V (75/150) - 2013/05/19 10:38:38 BRT [2013/05/19 9:38:38 ET]
Table '734961465 2' 9-max Seat #4 is the button
Seat 1: Farmboy4321 (3112 in chips) 
Seat 2: Bastardo Q9 (5480 in chips) 
Seat 3: LuckyDayRS (3017 in chips) 
Seat 4: llleopold (3385 in chips) 
Seat 5: dfcastro.net (1772 in chips) 
Seat 6: rifkat_ham (2395 in chips) 
Seat 9: masha02468 (810 in chips) 
dfcastro.net: posts small blind 75
rifkat_ham: posts big blind 150
*** HOLE CARDS ***
Dealt to dfcastro.net [Ac Ts]
masha02468: calls 150
Farmboy4321: folds 
Bastardo Q9: calls 150
LuckyDayRS: folds 
llleopold: folds 
dfcastro.net: raises 300 to 450
rifkat_ham: folds 
masha02468: raises 300 to 750
Bastardo Q9: folds 
dfcastro.net: raises 1022 to 1772 and is all-in
masha02468: calls 60 and is all-in
Uncalled bet (962) returned to dfcastro.net
*** FLOP *** [4c Ad Kd]
*** TURN *** [4c Ad Kd] [6c]
*** RIVER *** [4c Ad Kd 6c] [8h]
*** SHOW DOWN ***
dfcastro.net: shows [Ac Ts] (a pair of Aces)
masha02468: shows [7c 7h] (a pair of Sevens)
dfcastro.net collected 1920 from pot
masha02468 finished the tournament in 20th place
*** SUMMARY ***
Total pot 1920 | Rake 0 
Board [4c Ad Kd 6c 8h]
Seat 1: Farmboy4321 folded before Flop (didn't bet)
Seat 2: Bastardo Q9 folded before Flop
Seat 3: LuckyDayRS folded before Flop (didn't bet)
Seat 4: llleopold (button) folded before Flop (didn't bet)
Seat 5: dfcastro.net (small blind) showed [Ac Ts] and won (1920) with a pair of Aces
Seat 6: rifkat_ham (big blind) folded before Flop
Seat 9: masha02468 showed [7c 7h] and lost with a pair of Sevens



PokerStars Hand #98796629321: Tournament #734961465, $0.23+$0.02 USD Hold'em No Limit - Level V (75/150) - 2013/05/19 10:39:47 BRT [2013/05/19 9:39:47 ET]
Table '734961465 2' 9-max Seat #5 is the button
Seat 1: Farmboy4321 (3112 in chips) 
Seat 2: Bastardo Q9 (5330 in chips) 
Seat 3: LuckyDayRS (3017 in chips) 
Seat 4: llleopold (3385 in chips) 
Seat 5: dfcastro.net (2882 in chips) 
Seat 6: rifkat_ham (2245 in chips) 
rifkat_ham: posts small blind 75
Farmboy4321: posts big blind 150
*** HOLE CARDS ***
Dealt to dfcastro.net [9s 5h]
Bastardo Q9: raises 280 to 430
LuckyDayRS: folds 
llleopold: folds 
dfcastro.net: folds 
rifkat_ham: folds 
Farmboy4321: folds 
Uncalled bet (280) returned to Bastardo Q9
Bastardo Q9 collected 375 from pot
Bastardo Q9: doesn't show hand 
*** SUMMARY ***
Total pot 375 | Rake 0 
Seat 1: Farmboy4321 (big blind) folded before Flop
Seat 2: Bastardo Q9 collected (375)
Seat 3: LuckyDayRS folded before Flop (didn't bet)
Seat 4: llleopold folded before Flop (didn't bet)
Seat 5: dfcastro.net (button) folded before Flop (didn't bet)
Seat 6: rifkat_ham (small blind) folded before Flop



PokerStars Hand #98796648293: Tournament #734961465, $0.23+$0.02 USD Hold'em No Limit - Level V (75/150) - 2013/05/19 10:40:16 BRT [2013/05/19 9:40:16 ET]
Table '734961465 2' 9-max Seat #6 is the button
Seat 1: Farmboy4321 (2962 in chips) 
Seat 2: Bastardo Q9 (5555 in chips) 
Seat 3: LuckyDayRS (3017 in chips) 
Seat 4: llleopold (3385 in chips) 
Seat 5: dfcastro.net (2882 in chips) 
Seat 6: rifkat_ham (2170 in chips) 
Farmboy4321: posts small blind 75
Bastardo Q9: posts big blind 150
*** HOLE CARDS ***
Dealt to dfcastro.net [2s Jc]
LuckyDayRS: folds 
llleopold: folds 
dfcastro.net: folds 
rifkat_ham: folds 
Farmboy4321: raises 169 to 319
Bastardo Q9: folds 
Uncalled bet (169) returned to Farmboy4321
Farmboy4321 collected 300 from pot
Farmboy4321: doesn't show hand 
*** SUMMARY ***
Total pot 300 | Rake 0 
Seat 1: Farmboy4321 (small blind) collected (300)
Seat 2: Bastardo Q9 (big blind) folded before Flop
Seat 3: LuckyDayRS folded before Flop (didn't bet)
Seat 4: llleopold folded before Flop (didn't bet)
Seat 5: dfcastro.net folded before Flop (didn't bet)
Seat 6: rifkat_ham (button) folded before Flop (didn't bet)



PokerStars Hand #98796673820: Tournament #734961465, $0.23+$0.02 USD Hold'em No Limit - Level V (75/150) - 2013/05/19 10:40:56 BRT [2013/05/19 9:40:56 ET]
Table '734961465 2' 9-max Seat #1 is the button
Seat 1: Farmboy4321 (3112 in chips) 
Seat 2: Bastardo Q9 (5405 in chips) 
Seat 3: LuckyDayRS (3017 in chips) 
Seat 4: llleopold (3385 in chips) 
Seat 5: dfcastro.net (2882 in chips) 
Seat 6: rifkat_ham (2170 in chips) 
Bastardo Q9: posts small blind 75
LuckyDayRS: posts big blind 150
*** HOLE CARDS ***
Dealt to dfcastro.net [2d 2c]
llleopold: folds 
dfcastro.net: folds 
rifkat_ham: folds 
Farmboy4321: folds 
Bastardo Q9: calls 75
LuckyDayRS: checks 
*** FLOP *** [7h 3s Qh]
Bastardo Q9: bets 175
LuckyDayRS: calls 175
*** TURN *** [7h 3s Qh] [9h]
Bastardo Q9: bets 280
LuckyDayRS: calls 280
*** RIVER *** [7h 3s Qh 9h] [8s]
Bastardo Q9: bets 800
LuckyDayRS: calls 800
*** SHOW DOWN ***
Bastardo Q9: shows [Kh 6h] (a flush, King high)
LuckyDayRS: shows [9s Qc] (two pair, Queens and Nines)
Bastardo Q9 collected 2810 from pot
*** SUMMARY ***
Total pot 2810 | Rake 0 
Board [7h 3s Qh 9h 8s]
Seat 1: Farmboy4321 (button) folded before Flop (didn't bet)
Seat 2: Bastardo Q9 (small blind) showed [Kh 6h] and won (2810) with a flush, King high
Seat 3: LuckyDayRS (big blind) showed [9s Qc] and lost with two pair, Queens and Nines
Seat 4: llleopold folded before Flop (didn't bet)
Seat 5: dfcastro.net folded before Flop (didn't bet)
Seat 6: rifkat_ham folded before Flop (didn't bet)



PokerStars Hand #98796729327: Tournament #734961465, $0.23+$0.02 USD Hold'em No Limit - Level VI (100/200) - 2013/05/19 10:42:21 BRT [2013/05/19 9:42:21 ET]
Table '734961465 2' 9-max Seat #2 is the button
Seat 1: Farmboy4321 (3112 in chips) 
Seat 2: Bastardo Q9 (6810 in chips) 
Seat 3: LuckyDayRS (1612 in chips) 
Seat 4: llleopold (3385 in chips) 
Seat 5: dfcastro.net (2882 in chips) 
Seat 6: rifkat_ham (2170 in chips) 
LuckyDayRS: posts small blind 100
llleopold: posts big blind 200
*** HOLE CARDS ***
Dealt to dfcastro.net [Kc 7d]
dfcastro.net: folds 
rifkat_ham: raises 400 to 600
Farmboy4321: folds 
Bastardo Q9: folds 
LuckyDayRS: folds 
llleopold: folds 
Uncalled bet (400) returned to rifkat_ham
rifkat_ham collected 500 from pot
*** SUMMARY ***
Total pot 500 | Rake 0 
Seat 1: Farmboy4321 folded before Flop (didn't bet)
Seat 2: Bastardo Q9 (button) folded before Flop (didn't bet)
Seat 3: LuckyDayRS (small blind) folded before Flop
Seat 4: llleopold (big blind) folded before Flop
Seat 5: dfcastro.net folded before Flop (didn't bet)
Seat 6: rifkat_ham collected (500)



PokerStars Hand #98796747893: Tournament #734961465, $0.23+$0.02 USD Hold'em No Limit - Level VI (100/200) - 2013/05/19 10:42:49 BRT [2013/05/19 9:42:49 ET]
Table '734961465 2' 9-max Seat #3 is the button
Seat 1: Farmboy4321 (3112 in chips) 
Seat 2: Bastardo Q9 (6810 in chips) 
Seat 3: LuckyDayRS (1512 in chips) 
Seat 4: llleopold (3185 in chips) 
Seat 5: dfcastro.net (2882 in chips) 
Seat 6: rifkat_ham (2470 in chips) 
llleopold: posts small blind 100
dfcastro.net: posts big blind 200
*** HOLE CARDS ***
Dealt to dfcastro.net [8c 7s]
rifkat_ham: folds 
Farmboy4321: folds 
Bastardo Q9: raises 260 to 460
LuckyDayRS: folds 
llleopold: folds 
dfcastro.net: folds 
Uncalled bet (260) returned to Bastardo Q9
Bastardo Q9 collected 500 from pot
*** SUMMARY ***
Total pot 500 | Rake 0 
Seat 1: Farmboy4321 folded before Flop (didn't bet)
Seat 2: Bastardo Q9 collected (500)
Seat 3: LuckyDayRS (button) folded before Flop (didn't bet)
Seat 4: llleopold (small blind) folded before Flop
Seat 5: dfcastro.net (big blind) folded before Flop
Seat 6: rifkat_ham folded before Flop (didn't bet)



PokerStars Hand #98796776641: Tournament #734961465, $0.23+$0.02 USD Hold'em No Limit - Level VI (100/200) - 2013/05/19 10:43:33 BRT [2013/05/19 9:43:33 ET]
Table '734961465 2' 9-max Seat #4 is the button
Seat 1: Farmboy4321 (3112 in chips) 
Seat 2: Bastardo Q9 (7110 in chips) 
Seat 3: LuckyDayRS (1512 in chips) 
Seat 4: llleopold (3085 in chips) 
Seat 5: dfcastro.net (2682 in chips) 
Seat 6: rifkat_ham (2470 in chips) 
dfcastro.net: posts small blind 100
rifkat_ham: posts big blind 200
*** HOLE CARDS ***
Dealt to dfcastro.net [8c Qs]
Farmboy4321: folds 
Bastardo Q9: folds 
LuckyDayRS: raises 1312 to 1512 and is all-in
llleopold: folds 
dfcastro.net: raises 1170 to 2682 and is all-in
rifkat_ham: folds 
Uncalled bet (1170) returned to dfcastro.net
*** FLOP *** [6s 6d 2s]
*** TURN *** [6s 6d 2s] [4h]
*** RIVER *** [6s 6d 2s 4h] [Qh]
*** SHOW DOWN ***
dfcastro.net: shows [8c Qs] (two pair, Queens and Sixes)
LuckyDayRS: shows [Ah Ts] (a pair of Sixes)
dfcastro.net collected 3224 from pot
LuckyDayRS finished the tournament in 18th place
*** SUMMARY ***
Total pot 3224 | Rake 0 
Board [6s 6d 2s 4h Qh]
Seat 1: Farmboy4321 folded before Flop (didn't bet)
Seat 2: Bastardo Q9 folded before Flop (didn't bet)
Seat 3: LuckyDayRS showed [Ah Ts] and lost with a pair of Sixes
Seat 4: llleopold (button) folded before Flop (didn't bet)
Seat 5: dfcastro.net (small blind) showed [8c Qs] and won (3224) with two pair, Queens and Sixes
Seat 6: rifkat_ham (big blind) folded before Flop



PokerStars Hand #98796803923: Tournament #734961465, $0.23+$0.02 USD Hold'em No Limit - Level VI (100/200) - 2013/05/19 10:44:15 BRT [2013/05/19 9:44:15 ET]
Table '734961465 2' 9-max Seat #5 is the button
Seat 1: Farmboy4321 (3112 in chips) 
Seat 2: Bastardo Q9 (7110 in chips) 
Seat 4: llleopold (3085 in chips) 
Seat 5: dfcastro.net (4394 in chips) 
Seat 6: rifkat_ham (2270 in chips) 
Seat 7: kesia545 (8317 in chips) 
Seat 8: Scarlett2710 (2130 in chips) 
Seat 9: roma_potarik (2750 in chips) 
rifkat_ham: posts small blind 100
kesia545: posts big blind 200
*** HOLE CARDS ***
Dealt to dfcastro.net [3h 5c]
Scarlett2710: folds 
roma_potarik: folds 
Farmboy4321: folds 
Bastardo Q9: raises 280 to 480
llleopold: folds 
dfcastro.net: folds 
rifkat_ham: folds 
kesia545: folds 
Uncalled bet (280) returned to Bastardo Q9
Bastardo Q9 collected 500 from pot
*** SUMMARY ***
Total pot 500 | Rake 0 
Seat 1: Farmboy4321 folded before Flop (didn't bet)
Seat 2: Bastardo Q9 collected (500)
Seat 4: llleopold folded before Flop (didn't bet)
Seat 5: dfcastro.net (button) folded before Flop (didn't bet)
Seat 6: rifkat_ham (small blind) folded before Flop
Seat 7: kesia545 (big blind) folded before Flop
Seat 8: Scarlett2710 folded before Flop (didn't bet)
Seat 9: roma_potarik folded before Flop (didn't bet)



PokerStars Hand #98796824566: Tournament #734961465, $0.23+$0.02 USD Hold'em No Limit - Level VI (100/200) - 2013/05/19 10:44:47 BRT [2013/05/19 9:44:47 ET]
Table '734961465 2' 9-max Seat #6 is the button
Seat 1: Farmboy4321 (3112 in chips) 
Seat 2: Bastardo Q9 (7410 in chips) 
Seat 4: llleopold (3085 in chips) 
Seat 5: dfcastro.net (4394 in chips) 
Seat 6: rifkat_ham (2170 in chips) 
Seat 7: kesia545 (8117 in chips) 
Seat 8: Scarlett2710 (2130 in chips) 
Seat 9: roma_potarik (2750 in chips) 
kesia545: posts small blind 100
Scarlett2710: posts big blind 200
*** HOLE CARDS ***
Dealt to dfcastro.net [Qh Td]
roma_potarik: folds 
Farmboy4321: folds 
Bastardo Q9: folds 
llleopold: folds 
dfcastro.net: folds 
rifkat_ham: folds 
kesia545: calls 100
Scarlett2710: checks 
*** FLOP *** [Qs Jd 9d]
kesia545: checks 
Scarlett2710: checks 
*** TURN *** [Qs Jd 9d] [9c]
kesia545: checks 
Scarlett2710: checks 
*** RIVER *** [Qs Jd 9d 9c] [Kh]
kesia545: checks 
Scarlett2710: checks 
*** SHOW DOWN ***
kesia545: shows [4c Ah] (a pair of Nines)
Scarlett2710: shows [8s Qc] (two pair, Queens and Nines)
Scarlett2710 collected 400 from pot
*** SUMMARY ***
Total pot 400 | Rake 0 
Board [Qs Jd 9d 9c Kh]
Seat 1: Farmboy4321 folded before Flop (didn't bet)
Seat 2: Bastardo Q9 folded before Flop (didn't bet)
Seat 4: llleopold folded before Flop (didn't bet)
Seat 5: dfcastro.net folded before Flop (didn't bet)
Seat 6: rifkat_ham (button) folded before Flop (didn't bet)
Seat 7: kesia545 (small blind) showed [4c Ah] and lost with a pair of Nines
Seat 8: Scarlett2710 (big blind) showed [8s Qc] and won (400) with two pair, Queens and Nines
Seat 9: roma_potarik folded before Flop (didn't bet)



PokerStars Hand #98796849999: Tournament #734961465, $0.23+$0.02 USD Hold'em No Limit - Level VI (100/200) - 2013/05/19 10:45:26 BRT [2013/05/19 9:45:26 ET]
Table '734961465 2' 9-max Seat #7 is the button
Seat 1: Farmboy4321 (3112 in chips) 
Seat 2: Bastardo Q9 (7410 in chips) 
Seat 4: llleopold (3085 in chips) 
Seat 5: dfcastro.net (4394 in chips) 
Seat 6: rifkat_ham (2170 in chips) 
Seat 7: kesia545 (7917 in chips) 
Seat 8: Scarlett2710 (2330 in chips) 
Seat 9: roma_potarik (2750 in chips) 
Scarlett2710: posts small blind 100
roma_potarik: posts big blind 200
*** HOLE CARDS ***
Dealt to dfcastro.net [Ks 6h]
Farmboy4321: folds 
Bastardo Q9: folds 
llleopold: raises 213 to 413
dfcastro.net: folds 
rifkat_ham: folds 
kesia545: folds 
Scarlett2710: folds 
roma_potarik: folds 
Uncalled bet (213) returned to llleopold
llleopold collected 500 from pot
llleopold: doesn't show hand 
*** SUMMARY ***
Total pot 500 | Rake 0 
Seat 1: Farmboy4321 folded before Flop (didn't bet)
Seat 2: Bastardo Q9 folded before Flop (didn't bet)
Seat 4: llleopold collected (500)
Seat 5: dfcastro.net folded before Flop (didn't bet)
Seat 6: rifkat_ham folded before Flop (didn't bet)
Seat 7: kesia545 (button) folded before Flop (didn't bet)
Seat 8: Scarlett2710 (small blind) folded before Flop
Seat 9: roma_potarik (big blind) folded before Flop



PokerStars Hand #98796862076: Tournament #734961465, $0.23+$0.02 USD Hold'em No Limit - Level VI (100/200) - 2013/05/19 10:45:44 BRT [2013/05/19 9:45:44 ET]
Table '734961465 2' 9-max Seat #8 is the button
Seat 1: Farmboy4321 (3112 in chips) 
Seat 2: Bastardo Q9 (7410 in chips) 
Seat 4: llleopold (3385 in chips) 
Seat 5: dfcastro.net (4394 in chips) 
Seat 6: rifkat_ham (2170 in chips) 
Seat 7: kesia545 (7917 in chips) 
Seat 8: Scarlett2710 (2230 in chips) 
Seat 9: roma_potarik (2550 in chips) 
roma_potarik: posts small blind 100
Farmboy4321: posts big blind 200
*** HOLE CARDS ***
Dealt to dfcastro.net [Ts Kh]
Bastardo Q9: folds 
llleopold: folds 
dfcastro.net: folds 
rifkat_ham: folds 
kesia545: folds 
Scarlett2710: folds 
roma_potarik: folds 
Uncalled bet (100) returned to Farmboy4321
Farmboy4321 collected 200 from pot
Farmboy4321: doesn't show hand 
*** SUMMARY ***
Total pot 200 | Rake 0 
Seat 1: Farmboy4321 (big blind) collected (200)
Seat 2: Bastardo Q9 folded before Flop (didn't bet)
Seat 4: llleopold folded before Flop (didn't bet)
Seat 5: dfcastro.net folded before Flop (didn't bet)
Seat 6: rifkat_ham folded before Flop (didn't bet)
Seat 7: kesia545 folded before Flop (didn't bet)
Seat 8: Scarlett2710 (button) folded before Flop (didn't bet)
Seat 9: roma_potarik (small blind) folded before Flop



PokerStars Hand #98796875712: Tournament #734961465, $0.23+$0.02 USD Hold'em No Limit - Level VI (100/200) - 2013/05/19 10:46:05 BRT [2013/05/19 9:46:05 ET]
Table '734961465 2' 9-max Seat #9 is the button
Seat 1: Farmboy4321 (3212 in chips) 
Seat 2: Bastardo Q9 (7410 in chips) 
Seat 4: llleopold (3385 in chips) 
Seat 5: dfcastro.net (4394 in chips) 
Seat 6: rifkat_ham (2170 in chips) 
Seat 7: kesia545 (7917 in chips) 
Seat 8: Scarlett2710 (2230 in chips) 
Seat 9: roma_potarik (2450 in chips) 
Farmboy4321: posts small blind 100
Bastardo Q9: posts big blind 200
*** HOLE CARDS ***
Dealt to dfcastro.net [4h Qh]
llleopold: folds 
dfcastro.net: folds 
rifkat_ham: raises 300 to 500
kesia545: folds 
Scarlett2710: folds 
roma_potarik: folds 
Farmboy4321: folds 
Bastardo Q9: folds 
Uncalled bet (300) returned to rifkat_ham
rifkat_ham collected 500 from pot
*** SUMMARY ***
Total pot 500 | Rake 0 
Seat 1: Farmboy4321 (small blind) folded before Flop
Seat 2: Bastardo Q9 (big blind) folded before Flop
Seat 4: llleopold folded before Flop (didn't bet)
Seat 5: dfcastro.net folded before Flop (didn't bet)
Seat 6: rifkat_ham collected (500)
Seat 7: kesia545 folded before Flop (didn't bet)
Seat 8: Scarlett2710 folded before Flop (didn't bet)
Seat 9: roma_potarik (button) folded before Flop (didn't bet)



PokerStars Hand #98796890496: Tournament #734961465, $0.23+$0.02 USD Hold'em No Limit - Level VI (100/200) - 2013/05/19 10:46:27 BRT [2013/05/19 9:46:27 ET]
Table '734961465 2' 9-max Seat #1 is the button
Seat 1: Farmboy4321 (3112 in chips) 
Seat 2: Bastardo Q9 (7210 in chips) 
Seat 4: llleopold (3385 in chips) 
Seat 5: dfcastro.net (4394 in chips) 
Seat 6: rifkat_ham (2470 in chips) 
Seat 7: kesia545 (7917 in chips) 
Seat 8: Scarlett2710 (2230 in chips) 
Seat 9: roma_potarik (2450 in chips) 
Bastardo Q9: posts small blind 100
llleopold: posts big blind 200
*** HOLE CARDS ***
Dealt to dfcastro.net [3s Ks]
dfcastro.net: folds 
rifkat_ham: folds 
kesia545: folds 
Scarlett2710: folds 
roma_potarik: folds 
Farmboy4321: folds 
Bastardo Q9: calls 100
llleopold: checks 
*** FLOP *** [Qh 9c Tc]
Bastardo Q9: bets 400
llleopold: folds 
Uncalled bet (400) returned to Bastardo Q9
Bastardo Q9 collected 400 from pot
Bastardo Q9: doesn't show hand 
*** SUMMARY ***
Total pot 400 | Rake 0 
Board [Qh 9c Tc]
Seat 1: Farmboy4321 (button) folded before Flop (didn't bet)
Seat 2: Bastardo Q9 (small blind) collected (400)
Seat 4: llleopold (big blind) folded on the Flop
Seat 5: dfcastro.net folded before Flop (didn't bet)
Seat 6: rifkat_ham folded before Flop (didn't bet)
Seat 7: kesia545 folded before Flop (didn't bet)
Seat 8: Scarlett2710 folded before Flop (didn't bet)
Seat 9: roma_potarik folded before Flop (didn't bet)



PokerStars Hand #98796913956: Tournament #734961465, $0.23+$0.02 USD Hold'em No Limit - Level VI (100/200) - 2013/05/19 10:47:03 BRT [2013/05/19 9:47:03 ET]
Table '734961465 2' 9-max Seat #2 is the button
Seat 1: Farmboy4321 (3112 in chips) 
Seat 2: Bastardo Q9 (7410 in chips) 
Seat 4: llleopold (3185 in chips) 
Seat 5: dfcastro.net (4394 in chips) 
Seat 6: rifkat_ham (2470 in chips) 
Seat 7: kesia545 (7917 in chips) 
Seat 8: Scarlett2710 (2230 in chips) 
Seat 9: roma_potarik (2450 in chips) 
llleopold: posts small blind 100
dfcastro.net: posts big blind 200
*** HOLE CARDS ***
Dealt to dfcastro.net [Jc 7d]
rifkat_ham: folds 
kesia545: folds 
Scarlett2710: folds 
roma_potarik: folds 
Farmboy4321: folds 
Bastardo Q9: folds 
llleopold: folds 
Uncalled bet (100) returned to dfcastro.net
dfcastro.net collected 200 from pot
dfcastro.net: doesn't show hand 
*** SUMMARY ***
Total pot 200 | Rake 0 
Seat 1: Farmboy4321 folded before Flop (didn't bet)
Seat 2: Bastardo Q9 (button) folded before Flop (didn't bet)
Seat 4: llleopold (small blind) folded before Flop
Seat 5: dfcastro.net (big blind) collected (200)
Seat 6: rifkat_ham folded before Flop (didn't bet)
Seat 7: kesia545 folded before Flop (didn't bet)
Seat 8: Scarlett2710 folded before Flop (didn't bet)
Seat 9: roma_potarik folded before Flop (didn't bet)



PokerStars Hand #98796929844: Tournament #734961465, $0.23+$0.02 USD Hold'em No Limit - Level VI (100/200) - 2013/05/19 10:47:27 BRT [2013/05/19 9:47:27 ET]
Table '734961465 2' 9-max Seat #4 is the button
Seat 1: Farmboy4321 (3112 in chips) 
Seat 2: Bastardo Q9 (7410 in chips) 
Seat 4: llleopold (3085 in chips) 
Seat 5: dfcastro.net (4494 in chips) 
Seat 6: rifkat_ham (2470 in chips) 
Seat 7: kesia545 (7917 in chips) 
Seat 8: Scarlett2710 (2230 in chips) 
Seat 9: roma_potarik (2450 in chips) 
dfcastro.net: posts small blind 100
rifkat_ham: posts big blind 200
*** HOLE CARDS ***
Dealt to dfcastro.net [3s 5d]
kesia545: folds 
Scarlett2710: folds 
roma_potarik: folds 
Farmboy4321: folds 
Bastardo Q9: folds 
llleopold: folds 
dfcastro.net: folds 
Uncalled bet (100) returned to rifkat_ham
rifkat_ham collected 200 from pot
*** SUMMARY ***
Total pot 200 | Rake 0 
Seat 1: Farmboy4321 folded before Flop (didn't bet)
Seat 2: Bastardo Q9 folded before Flop (didn't bet)
Seat 4: llleopold (button) folded before Flop (didn't bet)
Seat 5: dfcastro.net (small blind) folded before Flop
Seat 6: rifkat_ham (big blind) collected (200)
Seat 7: kesia545 folded before Flop (didn't bet)
Seat 8: Scarlett2710 folded before Flop (didn't bet)
Seat 9: roma_potarik folded before Flop (didn't bet)



PokerStars Hand #98796953538: Tournament #734961465, $0.23+$0.02 USD Hold'em No Limit - Level VI (100/200) - 2013/05/19 10:48:03 BRT [2013/05/19 9:48:03 ET]
Table '734961465 2' 9-max Seat #5 is the button
Seat 1: Farmboy4321 (3112 in chips) 
Seat 2: Bastardo Q9 (7410 in chips) 
Seat 4: llleopold (3085 in chips) 
Seat 5: dfcastro.net (4394 in chips) 
Seat 6: rifkat_ham (2570 in chips) 
Seat 7: kesia545 (7917 in chips) 
Seat 8: Scarlett2710 (2230 in chips) 
Seat 9: roma_potarik (2450 in chips) 
rifkat_ham: posts small blind 100
kesia545: posts big blind 200
*** HOLE CARDS ***
Dealt to dfcastro.net [5c 9d]
Scarlett2710: folds 
roma_potarik: folds 
Farmboy4321: folds 
Bastardo Q9: folds 
llleopold: raises 213 to 413
dfcastro.net: folds 
rifkat_ham: folds 
kesia545: calls 213
*** FLOP *** [8c Qc 5h]
kesia545: checks 
llleopold: bets 629
kesia545: folds 
Uncalled bet (629) returned to llleopold
llleopold collected 926 from pot
llleopold: doesn't show hand 
*** SUMMARY ***
Total pot 926 | Rake 0 
Board [8c Qc 5h]
Seat 1: Farmboy4321 folded before Flop (didn't bet)
Seat 2: Bastardo Q9 folded before Flop (didn't bet)
Seat 4: llleopold collected (926)
Seat 5: dfcastro.net (button) folded before Flop (didn't bet)
Seat 6: rifkat_ham (small blind) folded before Flop
Seat 7: kesia545 (big blind) folded on the Flop
Seat 8: Scarlett2710 folded before Flop (didn't bet)
Seat 9: roma_potarik folded before Flop (didn't bet)



PokerStars Hand #98796989624: Tournament #734961465, $0.23+$0.02 USD Hold'em No Limit - Level VI (100/200) - 2013/05/19 10:48:57 BRT [2013/05/19 9:48:57 ET]
Table '734961465 2' 9-max Seat #6 is the button
Seat 1: Farmboy4321 (3112 in chips) 
Seat 2: Bastardo Q9 (7410 in chips) 
Seat 4: llleopold (3598 in chips) 
Seat 5: dfcastro.net (4394 in chips) 
Seat 6: rifkat_ham (2470 in chips) 
Seat 7: kesia545 (7504 in chips) 
Seat 8: Scarlett2710 (2230 in chips) 
Seat 9: roma_potarik (2450 in chips) 
kesia545: posts small blind 100
Scarlett2710: posts big blind 200
*** HOLE CARDS ***
Dealt to dfcastro.net [8s 4h]
roma_potarik: folds 
Farmboy4321: folds 
Bastardo Q9: folds 
llleopold: folds 
dfcastro.net: folds 
rifkat_ham: folds 
kesia545: calls 100
Scarlett2710: checks 
*** FLOP *** [9h 5h 6h]
kesia545: checks 
Scarlett2710: checks 
*** TURN *** [9h 5h 6h] [3s]
kesia545: checks 
Scarlett2710: checks 
*** RIVER *** [9h 5h 6h 3s] [3h]
kesia545: bets 400
Scarlett2710: folds 
Uncalled bet (400) returned to kesia545
kesia545 collected 400 from pot
kesia545: doesn't show hand 
*** SUMMARY ***
Total pot 400 | Rake 0 
Board [9h 5h 6h 3s 3h]
Seat 1: Farmboy4321 folded before Flop (didn't bet)
Seat 2: Bastardo Q9 folded before Flop (didn't bet)
Seat 4: llleopold folded before Flop (didn't bet)
Seat 5: dfcastro.net folded before Flop (didn't bet)
Seat 6: rifkat_ham (button) folded before Flop (didn't bet)
Seat 7: kesia545 (small blind) collected (400)
Seat 8: Scarlett2710 (big blind) folded on the River
Seat 9: roma_potarik folded before Flop (didn't bet)



PokerStars Hand #98797016472: Tournament #734961465, $0.23+$0.02 USD Hold'em No Limit - Level VI (100/200) - 2013/05/19 10:49:37 BRT [2013/05/19 9:49:37 ET]
Table '734961465 2' 9-max Seat #7 is the button
Seat 1: Farmboy4321 (3112 in chips) 
Seat 2: Bastardo Q9 (7410 in chips) 
Seat 4: llleopold (3598 in chips) 
Seat 5: dfcastro.net (4394 in chips) 
Seat 6: rifkat_ham (2470 in chips) 
Seat 7: kesia545 (7704 in chips) 
Seat 8: Scarlett2710 (2030 in chips) 
Seat 9: roma_potarik (2450 in chips) 
Scarlett2710: posts small blind 100
roma_potarik: posts big blind 200
*** HOLE CARDS ***
Dealt to dfcastro.net [Jc 7d]
Farmboy4321: folds 
Bastardo Q9: folds 
llleopold: folds 
dfcastro.net: folds 
rifkat_ham: folds 
kesia545: folds 
Scarlett2710: raises 1830 to 2030 and is all-in
roma_potarik: folds 
Uncalled bet (1830) returned to Scarlett2710
Scarlett2710 collected 400 from pot
Scarlett2710: doesn't show hand 
*** SUMMARY ***
Total pot 400 | Rake 0 
Seat 1: Farmboy4321 folded before Flop (didn't bet)
Seat 2: Bastardo Q9 folded before Flop (didn't bet)
Seat 4: llleopold folded before Flop (didn't bet)
Seat 5: dfcastro.net folded before Flop (didn't bet)
Seat 6: rifkat_ham folded before Flop (didn't bet)
Seat 7: kesia545 (button) folded before Flop (didn't bet)
Seat 8: Scarlett2710 (small blind) collected (400)
Seat 9: roma_potarik (big blind) folded before Flop



PokerStars Hand #98797031037: Tournament #734961465, $0.23+$0.02 USD Hold'em No Limit - Level VI (100/200) - 2013/05/19 10:50:00 BRT [2013/05/19 9:50:00 ET]
Table '734961465 2' 9-max Seat #8 is the button
Seat 1: Farmboy4321 (3112 in chips) 
Seat 2: Bastardo Q9 (7410 in chips) 
Seat 4: llleopold (3598 in chips) 
Seat 5: dfcastro.net (4394 in chips) 
Seat 6: rifkat_ham (2470 in chips) 
Seat 7: kesia545 (7704 in chips) 
Seat 8: Scarlett2710 (2230 in chips) 
Seat 9: roma_potarik (2250 in chips) 
roma_potarik: posts small blind 100
Farmboy4321: posts big blind 200
*** HOLE CARDS ***
Dealt to dfcastro.net [4c Qd]
Bastardo Q9: folds 
llleopold: folds 
dfcastro.net: folds 
rifkat_ham: folds 
kesia545: folds 
Scarlett2710: folds 
roma_potarik: folds 
Uncalled bet (100) returned to Farmboy4321
Farmboy4321 collected 200 from pot
Farmboy4321: doesn't show hand 
*** SUMMARY ***
Total pot 200 | Rake 0 
Seat 1: Farmboy4321 (big blind) collected (200)
Seat 2: Bastardo Q9 folded before Flop (didn't bet)
Seat 4: llleopold folded before Flop (didn't bet)
Seat 5: dfcastro.net folded before Flop (didn't bet)
Seat 6: rifkat_ham folded before Flop (didn't bet)
Seat 7: kesia545 folded before Flop (didn't bet)
Seat 8: Scarlett2710 (button) folded before Flop (didn't bet)
Seat 9: roma_potarik (small blind) folded before Flop



PokerStars Hand #98797056976: Tournament #734961465, $0.23+$0.02 USD Hold'em No Limit - Level VI (100/200) - 2013/05/19 10:50:39 BRT [2013/05/19 9:50:39 ET]
Table '734961465 2' 9-max Seat #9 is the button
Seat 1: Farmboy4321 (3212 in chips) 
Seat 2: Bastardo Q9 (7410 in chips) 
Seat 4: llleopold (3598 in chips) 
Seat 5: dfcastro.net (4394 in chips) 
Seat 6: rifkat_ham (2470 in chips) 
Seat 7: kesia545 (7704 in chips) 
Seat 8: Scarlett2710 (2230 in chips) 
Seat 9: roma_potarik (2150 in chips) 
Farmboy4321: posts small blind 100
Bastardo Q9: posts big blind 200
*** HOLE CARDS ***
Dealt to dfcastro.net [Th Qs]
llleopold: folds 
dfcastro.net: folds 
rifkat_ham: folds 
kesia545: folds 
Scarlett2710: folds 
roma_potarik: folds 
Farmboy4321: raises 226 to 426
Bastardo Q9: folds 
Uncalled bet (226) returned to Farmboy4321
Farmboy4321 collected 400 from pot
*** SUMMARY ***
Total pot 400 | Rake 0 
Seat 1: Farmboy4321 (small blind) collected (400)
Seat 2: Bastardo Q9 (big blind) folded before Flop
Seat 4: llleopold folded before Flop (didn't bet)
Seat 5: dfcastro.net folded before Flop (didn't bet)
Seat 6: rifkat_ham folded before Flop (didn't bet)
Seat 7: kesia545 folded before Flop (didn't bet)
Seat 8: Scarlett2710 folded before Flop (didn't bet)
Seat 9: roma_potarik (button) folded before Flop (didn't bet)



PokerStars Hand #98797076799: Tournament #734961465, $0.23+$0.02 USD Hold'em No Limit - Level VI (100/200) - 2013/05/19 10:51:08 BRT [2013/05/19 9:51:08 ET]
Table '734961465 2' 9-max Seat #1 is the button
Seat 1: Farmboy4321 (3412 in chips) 
Seat 2: Bastardo Q9 (7210 in chips) 
Seat 4: llleopold (3598 in chips) 
Seat 5: dfcastro.net (4394 in chips) 
Seat 6: rifkat_ham (2470 in chips) 
Seat 7: kesia545 (7704 in chips) 
Seat 8: Scarlett2710 (2230 in chips) 
Seat 9: roma_potarik (2150 in chips) 
Bastardo Q9: posts small blind 100
llleopold: posts big blind 200
*** HOLE CARDS ***
Dealt to dfcastro.net [Kh 5c]
dfcastro.net: folds 
rifkat_ham: raises 400 to 600
kesia545: folds 
Scarlett2710: folds 
roma_potarik: folds 
Farmboy4321: folds 
Bastardo Q9: folds 
llleopold: folds 
Uncalled bet (400) returned to rifkat_ham
rifkat_ham collected 500 from pot
*** SUMMARY ***
Total pot 500 | Rake 0 
Seat 1: Farmboy4321 (button) folded before Flop (didn't bet)
Seat 2: Bastardo Q9 (small blind) folded before Flop
Seat 4: llleopold (big blind) folded before Flop
Seat 5: dfcastro.net folded before Flop (didn't bet)
Seat 6: rifkat_ham collected (500)
Seat 7: kesia545 folded before Flop (didn't bet)
Seat 8: Scarlett2710 folded before Flop (didn't bet)
Seat 9: roma_potarik folded before Flop (didn't bet)



PokerStars Hand #98797092544: Tournament #734961465, $0.23+$0.02 USD Hold'em No Limit - Level VI (100/200) - 2013/05/19 10:51:32 BRT [2013/05/19 9:51:32 ET]
Table '734961465 2' 9-max Seat #2 is the button
Seat 1: Farmboy4321 (3412 in chips) 
Seat 2: Bastardo Q9 (7110 in chips) 
Seat 4: llleopold (3398 in chips) 
Seat 5: dfcastro.net (4394 in chips) 
Seat 6: rifkat_ham (2770 in chips) 
Seat 7: kesia545 (7704 in chips) 
Seat 8: Scarlett2710 (2230 in chips) 
Seat 9: roma_potarik (2150 in chips) 
llleopold: posts small blind 100
dfcastro.net: posts big blind 200
*** HOLE CARDS ***
Dealt to dfcastro.net [Qc 8d]
rifkat_ham: folds 
kesia545: folds 
Scarlett2710: folds 
roma_potarik: folds 
Farmboy4321: folds 
Bastardo Q9: folds 
llleopold: calls 100
dfcastro.net: checks 
*** FLOP *** [2c Ah Tc]
llleopold: checks 
dfcastro.net: checks 
*** TURN *** [2c Ah Tc] [4h]
llleopold: bets 400
dfcastro.net: folds 
Uncalled bet (400) returned to llleopold
llleopold collected 400 from pot
llleopold: doesn't show hand 
*** SUMMARY ***
Total pot 400 | Rake 0 
Board [2c Ah Tc 4h]
Seat 1: Farmboy4321 folded before Flop (didn't bet)
Seat 2: Bastardo Q9 (button) folded before Flop (didn't bet)
Seat 4: llleopold (small blind) collected (400)
Seat 5: dfcastro.net (big blind) folded on the Turn
Seat 6: rifkat_ham folded before Flop (didn't bet)
Seat 7: kesia545 folded before Flop (didn't bet)
Seat 8: Scarlett2710 folded before Flop (didn't bet)
Seat 9: roma_potarik folded before Flop (didn't bet)



PokerStars Hand #98797113899: Tournament #734961465, $0.23+$0.02 USD Hold'em No Limit - Level VI (100/200) - 2013/05/19 10:52:04 BRT [2013/05/19 9:52:04 ET]
Table '734961465 2' 9-max Seat #4 is the button
Seat 1: Farmboy4321 (3412 in chips) 
Seat 2: Bastardo Q9 (7110 in chips) 
Seat 4: llleopold (3598 in chips) 
Seat 5: dfcastro.net (4194 in chips) 
Seat 6: rifkat_ham (2770 in chips) 
Seat 7: kesia545 (7704 in chips) 
Seat 8: Scarlett2710 (2230 in chips) 
Seat 9: roma_potarik (2150 in chips) 
dfcastro.net: posts small blind 100
rifkat_ham: posts big blind 200
*** HOLE CARDS ***
Dealt to dfcastro.net [Ac Ah]
kesia545: folds 
Scarlett2710: folds 
roma_potarik: folds 
Farmboy4321: folds 
Bastardo Q9: folds 
llleopold: folds 
dfcastro.net: raises 240 to 440
rifkat_ham: calls 240
*** FLOP *** [Jh 6s 3h]
dfcastro.net: bets 600
rifkat_ham: calls 600
*** TURN *** [Jh 6s 3h] [5d]
dfcastro.net: bets 1200
rifkat_ham: raises 530 to 1730 and is all-in
dfcastro.net: calls 530
*** RIVER *** [Jh 6s 3h 5d] [8c]
*** SHOW DOWN ***
dfcastro.net: shows [Ac Ah] (a pair of Aces)
rifkat_ham: shows [Kh Jd] (a pair of Jacks)
dfcastro.net collected 5540 from pot
rifkat_ham finished the tournament in 16th place
*** SUMMARY ***
Total pot 5540 | Rake 0 
Board [Jh 6s 3h 5d 8c]
Seat 1: Farmboy4321 folded before Flop (didn't bet)
Seat 2: Bastardo Q9 folded before Flop (didn't bet)
Seat 4: llleopold (button) folded before Flop (didn't bet)
Seat 5: dfcastro.net (small blind) showed [Ac Ah] and won (5540) with a pair of Aces
Seat 6: rifkat_ham (big blind) showed [Kh Jd] and lost with a pair of Jacks
Seat 7: kesia545 folded before Flop (didn't bet)
Seat 8: Scarlett2710 folded before Flop (didn't bet)
Seat 9: roma_potarik folded before Flop (didn't bet)



PokerStars Hand #98797165389: Tournament #734961465, $0.23+$0.02 USD Hold'em No Limit - Level VII (100/200) - 2013/05/19 10:53:22 BRT [2013/05/19 9:53:22 ET]
Table '734961465 2' 9-max Seat #5 is the button
Seat 1: Farmboy4321 (3412 in chips) 
Seat 2: Bastardo Q9 (7110 in chips) 
Seat 4: llleopold (3598 in chips) 
Seat 5: dfcastro.net (6964 in chips) 
Seat 7: kesia545 (7704 in chips) 
Seat 8: Scarlett2710 (2230 in chips) 
Seat 9: roma_potarik (2150 in chips) 
Farmboy4321: posts the ante 25
Bastardo Q9: posts the ante 25
llleopold: posts the ante 25
dfcastro.net: posts the ante 25
kesia545: posts the ante 25
Scarlett2710: posts the ante 25
roma_potarik: posts the ante 25
kesia545: posts small blind 100
Scarlett2710: posts big blind 200
*** HOLE CARDS ***
Dealt to dfcastro.net [8c 5c]
roma_potarik: folds 
Farmboy4321: folds 
Bastardo Q9: folds 
llleopold: folds 
dfcastro.net: folds 
kesia545: folds 
Uncalled bet (100) returned to Scarlett2710
Scarlett2710 collected 375 from pot
Scarlett2710: doesn't show hand 
*** SUMMARY ***
Total pot 375 | Rake 0 
Seat 1: Farmboy4321 folded before Flop (didn't bet)
Seat 2: Bastardo Q9 folded before Flop (didn't bet)
Seat 4: llleopold folded before Flop (didn't bet)
Seat 5: dfcastro.net (button) folded before Flop (didn't bet)
Seat 7: kesia545 (small blind) folded before Flop
Seat 8: Scarlett2710 (big blind) collected (375)
Seat 9: roma_potarik folded before Flop (didn't bet)



PokerStars Hand #98797179041: Tournament #734961465, $0.23+$0.02 USD Hold'em No Limit - Level VII (100/200) - 2013/05/19 10:53:43 BRT [2013/05/19 9:53:43 ET]
Table '734961465 2' 9-max Seat #7 is the button
Seat 1: Farmboy4321 (3387 in chips) 
Seat 2: Bastardo Q9 (7085 in chips) 
Seat 4: llleopold (3573 in chips) 
Seat 5: dfcastro.net (6939 in chips) 
Seat 7: kesia545 (7579 in chips) 
Seat 8: Scarlett2710 (2480 in chips) 
Seat 9: roma_potarik (2125 in chips) 
Farmboy4321: posts the ante 25
Bastardo Q9: posts the ante 25
llleopold: posts the ante 25
dfcastro.net: posts the ante 25
kesia545: posts the ante 25
Scarlett2710: posts the ante 25
roma_potarik: posts the ante 25
Scarlett2710: posts small blind 100
roma_potarik: posts big blind 200
*** HOLE CARDS ***
Dealt to dfcastro.net [Th 2c]
Farmboy4321: folds 
Bastardo Q9: raises 260 to 460
llleopold: folds 
dfcastro.net: folds 
kesia545: folds 
Scarlett2710: folds 
roma_potarik: folds 
Uncalled bet (260) returned to Bastardo Q9
Bastardo Q9 collected 675 from pot
*** SUMMARY ***
Total pot 675 | Rake 0 
Seat 1: Farmboy4321 folded before Flop (didn't bet)
Seat 2: Bastardo Q9 collected (675)
Seat 4: llleopold folded before Flop (didn't bet)
Seat 5: dfcastro.net folded before Flop (didn't bet)
Seat 7: kesia545 (button) folded before Flop (didn't bet)
Seat 8: Scarlett2710 (small blind) folded before Flop
Seat 9: roma_potarik (big blind) folded before Flop



PokerStars Hand #98797194327: Tournament #734961465, $0.23+$0.02 USD Hold'em No Limit - Level VII (100/200) - 2013/05/19 10:54:06 BRT [2013/05/19 9:54:06 ET]
Table '734961465 2' 9-max Seat #8 is the button
Seat 1: Farmboy4321 (3362 in chips) 
Seat 2: Bastardo Q9 (7535 in chips) 
Seat 4: llleopold (3548 in chips) 
Seat 5: dfcastro.net (6914 in chips) 
Seat 7: kesia545 (7554 in chips) 
Seat 8: Scarlett2710 (2355 in chips) 
Seat 9: roma_potarik (1900 in chips) 
Farmboy4321: posts the ante 25
Bastardo Q9: posts the ante 25
llleopold: posts the ante 25
dfcastro.net: posts the ante 25
kesia545: posts the ante 25
Scarlett2710: posts the ante 25
roma_potarik: posts the ante 25
roma_potarik: posts small blind 100
Farmboy4321: posts big blind 200
*** HOLE CARDS ***
Dealt to dfcastro.net [5d 7d]
Bastardo Q9: calls 200
llleopold: folds 
dfcastro.net: folds 
kesia545: calls 200
Scarlett2710: folds 
roma_potarik: folds 
Farmboy4321: checks 
*** FLOP *** [8h 7c 7s]
Farmboy4321: checks 
Bastardo Q9: bets 610
kesia545: folds 
Farmboy4321: folds 
Uncalled bet (610) returned to Bastardo Q9
Bastardo Q9 collected 875 from pot
Bastardo Q9: doesn't show hand 
*** SUMMARY ***
Total pot 875 | Rake 0 
Board [8h 7c 7s]
Seat 1: Farmboy4321 (big blind) folded on the Flop
Seat 2: Bastardo Q9 collected (875)
Seat 4: llleopold folded before Flop (didn't bet)
Seat 5: dfcastro.net folded before Flop (didn't bet)
Seat 7: kesia545 folded on the Flop
Seat 8: Scarlett2710 (button) folded before Flop (didn't bet)
Seat 9: roma_potarik (small blind) folded before Flop



PokerStars Hand #98797214269: Tournament #734961465, $0.23+$0.02 USD Hold'em No Limit - Level VII (100/200) - 2013/05/19 10:54:36 BRT [2013/05/19 9:54:36 ET]
Table '734961465 2' 9-max Seat #9 is the button
Seat 1: Farmboy4321 (3137 in chips) 
Seat 2: Bastardo Q9 (8185 in chips) 
Seat 4: llleopold (3523 in chips) 
Seat 5: dfcastro.net (6889 in chips) 
Seat 7: kesia545 (7329 in chips) 
Seat 8: Scarlett2710 (2330 in chips) 
Seat 9: roma_potarik (1775 in chips) 
Farmboy4321: posts the ante 25
Bastardo Q9: posts the ante 25
llleopold: posts the ante 25
dfcastro.net: posts the ante 25
kesia545: posts the ante 25
Scarlett2710: posts the ante 25
roma_potarik: posts the ante 25
Farmboy4321: posts small blind 100
Bastardo Q9: posts big blind 200
*** HOLE CARDS ***
Dealt to dfcastro.net [7s 5h]
llleopold: folds 
dfcastro.net: folds 
kesia545: folds 
Scarlett2710: folds 
roma_potarik: folds 
Farmboy4321: raises 226 to 426
Bastardo Q9: folds 
Uncalled bet (226) returned to Farmboy4321
Farmboy4321 collected 575 from pot
Farmboy4321: doesn't show hand 
*** SUMMARY ***
Total pot 575 | Rake 0 
Seat 1: Farmboy4321 (small blind) collected (575)
Seat 2: Bastardo Q9 (big blind) folded before Flop
Seat 4: llleopold folded before Flop (didn't bet)
Seat 5: dfcastro.net folded before Flop (didn't bet)
Seat 7: kesia545 folded before Flop (didn't bet)
Seat 8: Scarlett2710 folded before Flop (didn't bet)
Seat 9: roma_potarik (button) folded before Flop (didn't bet)



PokerStars Hand #98797229663: Tournament #734961465, $0.23+$0.02 USD Hold'em No Limit - Level VII (100/200) - 2013/05/19 10:54:59 BRT [2013/05/19 9:54:59 ET]
Table '734961465 2' 9-max Seat #1 is the button
Seat 1: Farmboy4321 (3487 in chips) 
Seat 2: Bastardo Q9 (7960 in chips) 
Seat 4: llleopold (3498 in chips) 
Seat 5: dfcastro.net (6864 in chips) 
Seat 7: kesia545 (7304 in chips) 
Seat 8: Scarlett2710 (2305 in chips) 
Seat 9: roma_potarik (1750 in chips) 
Farmboy4321: posts the ante 25
Bastardo Q9: posts the ante 25
llleopold: posts the ante 25
dfcastro.net: posts the ante 25
kesia545: posts the ante 25
Scarlett2710: posts the ante 25
roma_potarik: posts the ante 25
Bastardo Q9: posts small blind 100
llleopold: posts big blind 200
*** HOLE CARDS ***
Dealt to dfcastro.net [Qs 6h]
dfcastro.net: folds 
kesia545: calls 200
Scarlett2710: folds 
roma_potarik: folds 
Farmboy4321: folds 
Bastardo Q9: calls 100
llleopold: checks 
*** FLOP *** [6d 9s Tc]
Bastardo Q9: checks 
llleopold: checks 
kesia545: checks 
*** TURN *** [6d 9s Tc] [Jc]
Bastardo Q9: bets 400
llleopold: raises 771 to 1171
kesia545: folds 
Bastardo Q9: folds [Js]
Uncalled bet (771) returned to llleopold
llleopold collected 1575 from pot
llleopold: doesn't show hand 
*** SUMMARY ***
Total pot 1575 | Rake 0 
Board [6d 9s Tc Jc]
Seat 1: Farmboy4321 (button) folded before Flop (didn't bet)
Seat 2: Bastardo Q9 (small blind) folded on the Turn
Seat 4: llleopold (big blind) collected (1575)
Seat 5: dfcastro.net folded before Flop (didn't bet)
Seat 7: kesia545 folded on the Turn
Seat 8: Scarlett2710 folded before Flop (didn't bet)
Seat 9: roma_potarik folded before Flop (didn't bet)



PokerStars Hand #98797412981: Tournament #734961465, $0.23+$0.02 USD Hold'em No Limit - Level VII (100/200) - 2013/05/19 11:00:48 BRT [2013/05/19 10:00:48 ET]
Table '734961465 2' 9-max Seat #2 is the button
Seat 1: Farmboy4321 (3462 in chips) 
Seat 2: Bastardo Q9 (7335 in chips) 
Seat 4: llleopold (4448 in chips) 
Seat 5: dfcastro.net (6839 in chips) 
Seat 7: kesia545 (7079 in chips) 
Seat 8: Scarlett2710 (2280 in chips) 
Seat 9: roma_potarik (1725 in chips) 
Farmboy4321: posts the ante 25
Bastardo Q9: posts the ante 25
llleopold: posts the ante 25
dfcastro.net: posts the ante 25
kesia545: posts the ante 25
Scarlett2710: posts the ante 25
roma_potarik: posts the ante 25
llleopold: posts small blind 100
dfcastro.net: posts big blind 200
*** HOLE CARDS ***
Dealt to dfcastro.net [8h 2s]
kesia545: folds 
Scarlett2710: folds 
roma_potarik: folds 
Farmboy4321: folds 
Bastardo Q9: folds 
llleopold: folds 
Uncalled bet (100) returned to dfcastro.net
dfcastro.net collected 375 from pot
dfcastro.net: doesn't show hand 
*** SUMMARY ***
Total pot 375 | Rake 0 
Seat 1: Farmboy4321 folded before Flop (didn't bet)
Seat 2: Bastardo Q9 (button) folded before Flop (didn't bet)
Seat 4: llleopold (small blind) folded before Flop
Seat 5: dfcastro.net (big blind) collected (375)
Seat 7: kesia545 folded before Flop (didn't bet)
Seat 8: Scarlett2710 folded before Flop (didn't bet)
Seat 9: roma_potarik folded before Flop (didn't bet)



PokerStars Hand #98797430766: Tournament #734961465, $0.23+$0.02 USD Hold'em No Limit - Level VII (100/200) - 2013/05/19 11:01:17 BRT [2013/05/19 10:01:17 ET]
Table '734961465 2' 9-max Seat #4 is the button
Seat 1: Farmboy4321 (3437 in chips) 
Seat 2: Bastardo Q9 (7310 in chips) 
Seat 4: llleopold (4323 in chips) 
Seat 5: dfcastro.net (7089 in chips) 
Seat 7: kesia545 (7054 in chips) 
Seat 8: Scarlett2710 (2255 in chips) 
Seat 9: roma_potarik (1700 in chips) 
Farmboy4321: posts the ante 25
Bastardo Q9: posts the ante 25
llleopold: posts the ante 25
dfcastro.net: posts the ante 25
kesia545: posts the ante 25
Scarlett2710: posts the ante 25
roma_potarik: posts the ante 25
dfcastro.net: posts small blind 100
kesia545: posts big blind 200
*** HOLE CARDS ***
Dealt to dfcastro.net [Qh 8c]
Scarlett2710: folds 
roma_potarik: folds 
Farmboy4321: folds 
Bastardo Q9: folds 
llleopold: folds 
dfcastro.net: raises 240 to 440
kesia545: folds 
Uncalled bet (240) returned to dfcastro.net
dfcastro.net collected 575 from pot
dfcastro.net: doesn't show hand 
*** SUMMARY ***
Total pot 575 | Rake 0 
Seat 1: Farmboy4321 folded before Flop (didn't bet)
Seat 2: Bastardo Q9 folded before Flop (didn't bet)
Seat 4: llleopold (button) folded before Flop (didn't bet)
Seat 5: dfcastro.net (small blind) collected (575)
Seat 7: kesia545 (big blind) folded before Flop
Seat 8: Scarlett2710 folded before Flop (didn't bet)
Seat 9: roma_potarik folded before Flop (didn't bet)



PokerStars Hand #98797458883: Tournament #734961465, $0.23+$0.02 USD Hold'em No Limit - Level VII (100/200) - 2013/05/19 11:01:59 BRT [2013/05/19 10:01:59 ET]
Table '734961465 2' 9-max Seat #5 is the button
Seat 1: Farmboy4321 (3412 in chips) 
Seat 2: Bastardo Q9 (7285 in chips) 
Seat 4: llleopold (4298 in chips) 
Seat 5: dfcastro.net (7439 in chips) 
Seat 7: kesia545 (6829 in chips) 
Seat 8: Scarlett2710 (2230 in chips) 
Seat 9: roma_potarik (1675 in chips) 
Farmboy4321: posts the ante 25
Bastardo Q9: posts the ante 25
llleopold: posts the ante 25
dfcastro.net: posts the ante 25
kesia545: posts the ante 25
Scarlett2710: posts the ante 25
roma_potarik: posts the ante 25
kesia545: posts small blind 100
Scarlett2710: posts big blind 200
*** HOLE CARDS ***
Dealt to dfcastro.net [Td 8s]
roma_potarik: folds 
Farmboy4321: folds 
Bastardo Q9: folds 
llleopold: raises 213 to 413
dfcastro.net: folds 
kesia545: calls 313
Scarlett2710: folds 
*** FLOP *** [Ac 9d 3c]
kesia545: checks 
llleopold: bets 588
kesia545: folds 
Uncalled bet (588) returned to llleopold
llleopold collected 1201 from pot
llleopold: doesn't show hand 
*** SUMMARY ***
Total pot 1201 | Rake 0 
Board [Ac 9d 3c]
Seat 1: Farmboy4321 folded before Flop (didn't bet)
Seat 2: Bastardo Q9 folded before Flop (didn't bet)
Seat 4: llleopold collected (1201)
Seat 5: dfcastro.net (button) folded before Flop (didn't bet)
Seat 7: kesia545 (small blind) folded on the Flop
Seat 8: Scarlett2710 (big blind) folded before Flop
Seat 9: roma_potarik folded before Flop (didn't bet)



PokerStars Hand #98797483226: Tournament #734961465, $0.23+$0.02 USD Hold'em No Limit - Level VII (100/200) - 2013/05/19 11:02:35 BRT [2013/05/19 10:02:35 ET]
Table '734961465 2' 9-max Seat #7 is the button
Seat 1: Farmboy4321 (3387 in chips) 
Seat 2: Bastardo Q9 (7260 in chips) 
Seat 4: llleopold (5061 in chips) 
Seat 5: dfcastro.net (7414 in chips) 
Seat 7: kesia545 (6391 in chips) 
Seat 8: Scarlett2710 (2005 in chips) 
Seat 9: roma_potarik (1650 in chips) 
Farmboy4321: posts the ante 25
Bastardo Q9: posts the ante 25
llleopold: posts the ante 25
dfcastro.net: posts the ante 25
kesia545: posts the ante 25
Scarlett2710: posts the ante 25
roma_potarik: posts the ante 25
Scarlett2710: posts small blind 100
roma_potarik: posts big blind 200
*** HOLE CARDS ***
Dealt to dfcastro.net [6d Ac]
Farmboy4321: folds 
Bastardo Q9: calls 200
llleopold: folds 
dfcastro.net: folds 
kesia545: calls 200
Scarlett2710: folds 
roma_potarik: checks 
*** FLOP *** [Jh 8c Jd]
roma_potarik: checks 
Bastardo Q9: bets 333
kesia545: folds 
roma_potarik: folds 
Uncalled bet (333) returned to Bastardo Q9
Bastardo Q9 collected 875 from pot
Bastardo Q9: shows [Jc]
*** SUMMARY ***
Total pot 875 | Rake 0 
Board [Jh 8c Jd]
Seat 1: Farmboy4321 folded before Flop (didn't bet)
Seat 2: Bastardo Q9 collected (875)
Seat 4: llleopold folded before Flop (didn't bet)
Seat 5: dfcastro.net folded before Flop (didn't bet)
Seat 7: kesia545 (button) folded on the Flop
Seat 8: Scarlett2710 (small blind) folded before Flop
Seat 9: roma_potarik (big blind) folded on the Flop



PokerStars Hand #98797514159: Tournament #734961465, $0.23+$0.02 USD Hold'em No Limit - Level VII (100/200) - 2013/05/19 11:03:20 BRT [2013/05/19 10:03:20 ET]
Table '734961465 2' 9-max Seat #8 is the button
Seat 1: Farmboy4321 (3362 in chips) 
Seat 2: Bastardo Q9 (7910 in chips) 
Seat 4: llleopold (5036 in chips) 
Seat 5: dfcastro.net (7389 in chips) 
Seat 7: kesia545 (6166 in chips) 
Seat 8: Scarlett2710 (1880 in chips) 
Seat 9: roma_potarik (1425 in chips) 
Farmboy4321: posts the ante 25
Bastardo Q9: posts the ante 25
llleopold: posts the ante 25
dfcastro.net: posts the ante 25
kesia545: posts the ante 25
Scarlett2710: posts the ante 25
roma_potarik: posts the ante 25
roma_potarik: posts small blind 100
Farmboy4321: posts big blind 200
*** HOLE CARDS ***
Dealt to dfcastro.net [2c Td]
Bastardo Q9: folds 
llleopold: folds 
dfcastro.net: folds 
kesia545: folds 
Scarlett2710: folds 
roma_potarik: folds 
Uncalled bet (100) returned to Farmboy4321
Farmboy4321 collected 375 from pot
Farmboy4321: doesn't show hand 
*** SUMMARY ***
Total pot 375 | Rake 0 
Seat 1: Farmboy4321 (big blind) collected (375)
Seat 2: Bastardo Q9 folded before Flop (didn't bet)
Seat 4: llleopold folded before Flop (didn't bet)
Seat 5: dfcastro.net folded before Flop (didn't bet)
Seat 7: kesia545 folded before Flop (didn't bet)
Seat 8: Scarlett2710 (button) folded before Flop (didn't bet)
Seat 9: roma_potarik (small blind) folded before Flop



PokerStars Hand #98797522265: Tournament #734961465, $0.23+$0.02 USD Hold'em No Limit - Level VII (100/200) - 2013/05/19 11:03:32 BRT [2013/05/19 10:03:32 ET]
Table '734961465 2' 9-max Seat #9 is the button
Seat 1: Farmboy4321 (3612 in chips) 
Seat 2: Bastardo Q9 (7885 in chips) 
Seat 4: llleopold (5011 in chips) 
Seat 5: dfcastro.net (7364 in chips) 
Seat 7: kesia545 (6141 in chips) 
Seat 8: Scarlett2710 (1855 in chips) 
Seat 9: roma_potarik (1300 in chips) 
Farmboy4321: posts the ante 25
Bastardo Q9: posts the ante 25
llleopold: posts the ante 25
dfcastro.net: posts the ante 25
kesia545: posts the ante 25
Scarlett2710: posts the ante 25
roma_potarik: posts the ante 25
Farmboy4321: posts small blind 100
Bastardo Q9: posts big blind 200
*** HOLE CARDS ***
Dealt to dfcastro.net [7h Jh]
llleopold: folds 
dfcastro.net: folds 
kesia545: calls 200
Scarlett2710: folds 
roma_potarik: folds 
Farmboy4321: folds 
Bastardo Q9: checks 
*** FLOP *** [Qc 6c Qd]
Bastardo Q9: checks 
kesia545: checks 
*** TURN *** [Qc 6c Qd] [9c]
Bastardo Q9: checks 
kesia545: checks 
*** RIVER *** [Qc 6c Qd 9c] [3h]
Bastardo Q9: bets 200
kesia545: folds 
Uncalled bet (200) returned to Bastardo Q9
Bastardo Q9 collected 675 from pot
*** SUMMARY ***
Total pot 675 | Rake 0 
Board [Qc 6c Qd 9c 3h]
Seat 1: Farmboy4321 (small blind) folded before Flop
Seat 2: Bastardo Q9 (big blind) collected (675)
Seat 4: llleopold folded before Flop (didn't bet)
Seat 5: dfcastro.net folded before Flop (didn't bet)
Seat 7: kesia545 folded on the River
Seat 8: Scarlett2710 folded before Flop (didn't bet)
Seat 9: roma_potarik (button) folded before Flop (didn't bet)



PokerStars Hand #98797548363: Tournament #734961465, $0.23+$0.02 USD Hold'em No Limit - Level VII (100/200) - 2013/05/19 11:04:08 BRT [2013/05/19 10:04:08 ET]
Table '734961465 2' 9-max Seat #1 is the button
Seat 1: Farmboy4321 (3487 in chips) 
Seat 2: Bastardo Q9 (8335 in chips) 
Seat 4: llleopold (4986 in chips) 
Seat 5: dfcastro.net (7339 in chips) 
Seat 7: kesia545 (5916 in chips) 
Seat 8: Scarlett2710 (1830 in chips) 
Seat 9: roma_potarik (1275 in chips) 
Farmboy4321: posts the ante 25
Bastardo Q9: posts the ante 25
llleopold: posts the ante 25
dfcastro.net: posts the ante 25
kesia545: posts the ante 25
Scarlett2710: posts the ante 25
roma_potarik: posts the ante 25
Bastardo Q9: posts small blind 100
llleopold: posts big blind 200
*** HOLE CARDS ***
Dealt to dfcastro.net [2d Qh]
dfcastro.net: folds 
kesia545: folds 
Scarlett2710: folds 
roma_potarik: folds 
Farmboy4321: folds 
Bastardo Q9: calls 100
llleopold: checks 
*** FLOP *** [6d 7c 5s]
Bastardo Q9: checks 
llleopold: checks 
*** TURN *** [6d 7c 5s] [7s]
Bastardo Q9: bets 400
llleopold: calls 400
*** RIVER *** [6d 7c 5s 7s] [Ks]
Bastardo Q9: checks 
llleopold: bets 400
Bastardo Q9: folds 
Uncalled bet (400) returned to llleopold
llleopold collected 1375 from pot
llleopold: doesn't show hand 
*** SUMMARY ***
Total pot 1375 | Rake 0 
Board [6d 7c 5s 7s Ks]
Seat 1: Farmboy4321 (button) folded before Flop (didn't bet)
Seat 2: Bastardo Q9 (small blind) folded on the River
Seat 4: llleopold (big blind) collected (1375)
Seat 5: dfcastro.net folded before Flop (didn't bet)
Seat 7: kesia545 folded before Flop (didn't bet)
Seat 8: Scarlett2710 folded before Flop (didn't bet)
Seat 9: roma_potarik folded before Flop (didn't bet)



PokerStars Hand #98797584562: Tournament #734961465, $0.23+$0.02 USD Hold'em No Limit - Level VII (100/200) - 2013/05/19 11:04:59 BRT [2013/05/19 10:04:59 ET]
Table '734961465 2' 9-max Seat #2 is the button
Seat 1: Farmboy4321 (3462 in chips) 
Seat 2: Bastardo Q9 (7710 in chips) 
Seat 4: llleopold (5736 in chips) 
Seat 5: dfcastro.net (7314 in chips) 
Seat 7: kesia545 (5891 in chips) 
Seat 8: Scarlett2710 (1805 in chips) 
Seat 9: roma_potarik (1250 in chips) 
Farmboy4321: posts the ante 25
Bastardo Q9: posts the ante 25
llleopold: posts the ante 25
dfcastro.net: posts the ante 25
kesia545: posts the ante 25
Scarlett2710: posts the ante 25
roma_potarik: posts the ante 25
llleopold: posts small blind 100
dfcastro.net: posts big blind 200
*** HOLE CARDS ***
Dealt to dfcastro.net [8c Th]
kesia545: folds 
Scarlett2710: folds 
roma_potarik: folds 
Farmboy4321: folds 
Bastardo Q9: calls 200
llleopold: folds 
dfcastro.net: checks 
*** FLOP *** [6c 4s 5d]
dfcastro.net: checks 
Bastardo Q9: bets 600
dfcastro.net: calls 600
*** TURN *** [6c 4s 5d] [Ad]
dfcastro.net: checks 
Bastardo Q9: bets 1235
dfcastro.net: folds 
Uncalled bet (1235) returned to Bastardo Q9
Bastardo Q9 collected 1875 from pot
*** SUMMARY ***
Total pot 1875 | Rake 0 
Board [6c 4s 5d Ad]
Seat 1: Farmboy4321 folded before Flop (didn't bet)
Seat 2: Bastardo Q9 (button) collected (1875)
Seat 4: llleopold (small blind) folded before Flop
Seat 5: dfcastro.net (big blind) folded on the Turn
Seat 7: kesia545 folded before Flop (didn't bet)
Seat 8: Scarlett2710 folded before Flop (didn't bet)
Seat 9: roma_potarik folded before Flop (didn't bet)



PokerStars Hand #98797625986: Tournament #734961465, $0.23+$0.02 USD Hold'em No Limit - Level VII (100/200) - 2013/05/19 11:05:57 BRT [2013/05/19 10:05:57 ET]
Table '734961465 2' 9-max Seat #4 is the button
Seat 1: Farmboy4321 (3437 in chips) 
Seat 2: Bastardo Q9 (8760 in chips) 
Seat 4: llleopold (5611 in chips) 
Seat 5: dfcastro.net (6489 in chips) 
Seat 7: kesia545 (5866 in chips) 
Seat 8: Scarlett2710 (1780 in chips) 
Seat 9: roma_potarik (1225 in chips) 
Farmboy4321: posts the ante 25
Bastardo Q9: posts the ante 25
llleopold: posts the ante 25
dfcastro.net: posts the ante 25
kesia545: posts the ante 25
Scarlett2710: posts the ante 25
roma_potarik: posts the ante 25
dfcastro.net: posts small blind 100
kesia545: posts big blind 200
*** HOLE CARDS ***
Dealt to dfcastro.net [3c 9s]
Scarlett2710: raises 1555 to 1755 and is all-in
roma_potarik: folds 
Farmboy4321: folds 
Bastardo Q9: folds 
llleopold: folds 
dfcastro.net: folds 
kesia545: calls 1555
*** FLOP *** [2h 3s 6c]
*** TURN *** [2h 3s 6c] [6s]
*** RIVER *** [2h 3s 6c 6s] [As]
*** SHOW DOWN ***
kesia545: shows [8d Ks] (a pair of Sixes)
Scarlett2710: shows [Ad 9d] (two pair, Aces and Sixes)
Scarlett2710 collected 3785 from pot
*** SUMMARY ***
Total pot 3785 | Rake 0 
Board [2h 3s 6c 6s As]
Seat 1: Farmboy4321 folded before Flop (didn't bet)
Seat 2: Bastardo Q9 folded before Flop (didn't bet)
Seat 4: llleopold (button) folded before Flop (didn't bet)
Seat 5: dfcastro.net (small blind) folded before Flop
Seat 7: kesia545 (big blind) showed [8d Ks] and lost with a pair of Sixes
Seat 8: Scarlett2710 showed [Ad 9d] and won (3785) with two pair, Aces and Sixes
Seat 9: roma_potarik folded before Flop (didn't bet)



PokerStars Hand #98797650313: Tournament #734961465, $0.23+$0.02 USD Hold'em No Limit - Level VII (100/200) - 2013/05/19 11:06:31 BRT [2013/05/19 10:06:31 ET]
Table '734961465 2' 9-max Seat #5 is the button
Seat 1: Farmboy4321 (3412 in chips) 
Seat 2: Bastardo Q9 (8735 in chips) 
Seat 4: llleopold (5586 in chips) 
Seat 5: dfcastro.net (6364 in chips) 
Seat 7: kesia545 (4086 in chips) 
Seat 8: Scarlett2710 (3785 in chips) 
Seat 9: roma_potarik (1200 in chips) 
Farmboy4321: posts the ante 25
Bastardo Q9: posts the ante 25
llleopold: posts the ante 25
dfcastro.net: posts the ante 25
kesia545: posts the ante 25
Scarlett2710: posts the ante 25
roma_potarik: posts the ante 25
kesia545: posts small blind 100
Scarlett2710: posts big blind 200
*** HOLE CARDS ***
Dealt to dfcastro.net [As Qd]
roma_potarik: folds 
Farmboy4321: folds 
Bastardo Q9: folds 
llleopold: folds 
dfcastro.net: raises 240 to 440
kesia545: folds 
Scarlett2710: folds 
Uncalled bet (240) returned to dfcastro.net
dfcastro.net collected 675 from pot
dfcastro.net: doesn't show hand 
*** SUMMARY ***
Total pot 675 | Rake 0 
Seat 1: Farmboy4321 folded before Flop (didn't bet)
Seat 2: Bastardo Q9 folded before Flop (didn't bet)
Seat 4: llleopold folded before Flop (didn't bet)
Seat 5: dfcastro.net (button) collected (675)
Seat 7: kesia545 (small blind) folded before Flop
Seat 8: Scarlett2710 (big blind) folded before Flop
Seat 9: roma_potarik folded before Flop (didn't bet)



PokerStars Hand #98797674867: Tournament #734961465, $0.23+$0.02 USD Hold'em No Limit - Level VII (100/200) - 2013/05/19 11:07:05 BRT [2013/05/19 10:07:05 ET]
Table '734961465 2' 9-max Seat #7 is the button
Seat 1: Farmboy4321 (3387 in chips) 
Seat 2: Bastardo Q9 (8710 in chips) 
Seat 4: llleopold (5561 in chips) 
Seat 5: dfcastro.net (6814 in chips) 
Seat 7: kesia545 (3961 in chips) 
Seat 8: Scarlett2710 (3560 in chips) 
Seat 9: roma_potarik (1175 in chips) 
Farmboy4321: posts the ante 25
Bastardo Q9: posts the ante 25
llleopold: posts the ante 25
dfcastro.net: posts the ante 25
kesia545: posts the ante 25
Scarlett2710: posts the ante 25
roma_potarik: posts the ante 25
Scarlett2710: posts small blind 100
roma_potarik: posts big blind 200
*** HOLE CARDS ***
Dealt to dfcastro.net [2s Ah]
Farmboy4321: folds 
Bastardo Q9: folds 
llleopold: folds 
dfcastro.net: folds 
kesia545: folds 
Scarlett2710: folds 
Uncalled bet (100) returned to roma_potarik
roma_potarik collected 375 from pot
roma_potarik: doesn't show hand 
*** SUMMARY ***
Total pot 375 | Rake 0 
Seat 1: Farmboy4321 folded before Flop (didn't bet)
Seat 2: Bastardo Q9 folded before Flop (didn't bet)
Seat 4: llleopold folded before Flop (didn't bet)
Seat 5: dfcastro.net folded before Flop (didn't bet)
Seat 7: kesia545 (button) folded before Flop (didn't bet)
Seat 8: Scarlett2710 (small blind) folded before Flop
Seat 9: roma_potarik (big blind) collected (375)



PokerStars Hand #98797687884: Tournament #734961465, $0.23+$0.02 USD Hold'em No Limit - Level VII (100/200) - 2013/05/19 11:07:24 BRT [2013/05/19 10:07:24 ET]
Table '734961465 2' 9-max Seat #8 is the button
Seat 1: Farmboy4321 (3362 in chips) 
Seat 2: Bastardo Q9 (8685 in chips) 
Seat 4: llleopold (5536 in chips) 
Seat 5: dfcastro.net (6789 in chips) 
Seat 7: kesia545 (3936 in chips) 
Seat 8: Scarlett2710 (3435 in chips) 
Seat 9: roma_potarik (1425 in chips) 
Farmboy4321: posts the ante 25
Bastardo Q9: posts the ante 25
llleopold: posts the ante 25
dfcastro.net: posts the ante 25
kesia545: posts the ante 25
Scarlett2710: posts the ante 25
roma_potarik: posts the ante 25
roma_potarik: posts small blind 100
Farmboy4321: posts big blind 200
*** HOLE CARDS ***
Dealt to dfcastro.net [Qs Ts]
Bastardo Q9: folds 
llleopold: folds 
dfcastro.net: raises 240 to 440
kesia545: folds 
Scarlett2710: folds 
roma_potarik: raises 960 to 1400 and is all-in
Farmboy4321: folds 
dfcastro.net: calls 960
*** FLOP *** [Kd 7h Jc]
*** TURN *** [Kd 7h Jc] [Kc]
*** RIVER *** [Kd 7h Jc Kc] [3d]
*** SHOW DOWN ***
roma_potarik: shows [8d Ad] (a pair of Kings)
dfcastro.net: shows [Qs Ts] (a pair of Kings - lower kicker)
roma_potarik collected 3175 from pot
*** SUMMARY ***
Total pot 3175 | Rake 0 
Board [Kd 7h Jc Kc 3d]
Seat 1: Farmboy4321 (big blind) folded before Flop
Seat 2: Bastardo Q9 folded before Flop (didn't bet)
Seat 4: llleopold folded before Flop (didn't bet)
Seat 5: dfcastro.net showed [Qs Ts] and lost with a pair of Kings
Seat 7: kesia545 folded before Flop (didn't bet)
Seat 8: Scarlett2710 (button) folded before Flop (didn't bet)
Seat 9: roma_potarik (small blind) showed [8d Ad] and won (3175) with a pair of Kings



PokerStars Hand #98797714566: Tournament #734961465, $0.23+$0.02 USD Hold'em No Limit - Level VIII (150/300) - 2013/05/19 11:08:01 BRT [2013/05/19 10:08:01 ET]
Table '734961465 2' 9-max Seat #9 is the button
Seat 1: Farmboy4321 (3137 in chips) 
Seat 2: Bastardo Q9 (8660 in chips) 
Seat 4: llleopold (5511 in chips) 
Seat 5: dfcastro.net (5364 in chips) 
Seat 7: kesia545 (3911 in chips) 
Seat 8: Scarlett2710 (3410 in chips) 
Seat 9: roma_potarik (3175 in chips) 
Farmboy4321: posts the ante 25
Bastardo Q9: posts the ante 25
llleopold: posts the ante 25
dfcastro.net: posts the ante 25
kesia545: posts the ante 25
Scarlett2710: posts the ante 25
roma_potarik: posts the ante 25
Farmboy4321: posts small blind 150
Bastardo Q9: posts big blind 300
*** HOLE CARDS ***
Dealt to dfcastro.net [8d 7d]
llleopold: folds 
dfcastro.net: folds 
kesia545: folds 
Scarlett2710: folds 
roma_potarik: folds 
Farmboy4321: folds 
Uncalled bet (150) returned to Bastardo Q9
Bastardo Q9 collected 475 from pot
*** SUMMARY ***
Total pot 475 | Rake 0 
Seat 1: Farmboy4321 (small blind) folded before Flop
Seat 2: Bastardo Q9 (big blind) collected (475)
Seat 4: llleopold folded before Flop (didn't bet)
Seat 5: dfcastro.net folded before Flop (didn't bet)
Seat 7: kesia545 folded before Flop (didn't bet)
Seat 8: Scarlett2710 folded before Flop (didn't bet)
Seat 9: roma_potarik (button) folded before Flop (didn't bet)



PokerStars Hand #98797726131: Tournament #734961465, $0.23+$0.02 USD Hold'em No Limit - Level VIII (150/300) - 2013/05/19 11:08:18 BRT [2013/05/19 10:08:18 ET]
Table '734961465 2' 9-max Seat #1 is the button
Seat 1: Farmboy4321 (2962 in chips) 
Seat 2: Bastardo Q9 (8960 in chips) 
Seat 4: llleopold (5486 in chips) 
Seat 5: dfcastro.net (5339 in chips) 
Seat 7: kesia545 (3886 in chips) 
Seat 8: Scarlett2710 (3385 in chips) 
Seat 9: roma_potarik (3150 in chips) 
Farmboy4321: posts the ante 25
Bastardo Q9: posts the ante 25
llleopold: posts the ante 25
dfcastro.net: posts the ante 25
kesia545: posts the ante 25
Scarlett2710: posts the ante 25
roma_potarik: posts the ante 25
Bastardo Q9: posts small blind 150
llleopold: posts big blind 300
*** HOLE CARDS ***
Dealt to dfcastro.net [8c 3c]
dfcastro.net: folds 
kesia545: folds 
Scarlett2710: folds 
roma_potarik: folds 
Farmboy4321: folds 
Bastardo Q9: calls 150
llleopold: checks 
*** FLOP *** [Qh 6h 6d]
Bastardo Q9: checks 
llleopold: checks 
*** TURN *** [Qh 6h 6d] [Qd]
Bastardo Q9: checks 
llleopold: checks 
*** RIVER *** [Qh 6h 6d Qd] [9s]
Bastardo Q9: checks 
llleopold: checks 
*** SHOW DOWN ***
Bastardo Q9: shows [5h 3s] (two pair, Queens and Sixes)
llleopold: shows [Jh 7s] (two pair, Queens and Sixes - Jack kicker)
llleopold collected 775 from pot
*** SUMMARY ***
Total pot 775 | Rake 0 
Board [Qh 6h 6d Qd 9s]
Seat 1: Farmboy4321 (button) folded before Flop (didn't bet)
Seat 2: Bastardo Q9 (small blind) showed [5h 3s] and lost with two pair, Queens and Sixes
Seat 4: llleopold (big blind) showed [Jh 7s] and won (775) with two pair, Queens and Sixes
Seat 5: dfcastro.net folded before Flop (didn't bet)
Seat 7: kesia545 folded before Flop (didn't bet)
Seat 8: Scarlett2710 folded before Flop (didn't bet)
Seat 9: roma_potarik folded before Flop (didn't bet)



PokerStars Hand #98797771394: Tournament #734961465, $0.23+$0.02 USD Hold'em No Limit - Level VIII (150/300) - 2013/05/19 11:09:21 BRT [2013/05/19 10:09:21 ET]
Table '734961465 2' 9-max Seat #2 is the button
Seat 1: Farmboy4321 (2937 in chips) 
Seat 2: Bastardo Q9 (8635 in chips) 
Seat 4: llleopold (5936 in chips) 
Seat 5: dfcastro.net (5314 in chips) 
Seat 7: kesia545 (3861 in chips) 
Seat 8: Scarlett2710 (3360 in chips) 
Seat 9: roma_potarik (3125 in chips) 
Farmboy4321: posts the ante 25
Bastardo Q9: posts the ante 25
llleopold: posts the ante 25
dfcastro.net: posts the ante 25
kesia545: posts the ante 25
Scarlett2710: posts the ante 25
roma_potarik: posts the ante 25
llleopold: posts small blind 150
dfcastro.net: posts big blind 300
*** HOLE CARDS ***
Dealt to dfcastro.net [3s 2s]
kesia545: folds 
Scarlett2710: folds 
roma_potarik: folds 
Farmboy4321: folds 
Bastardo Q9: raises 410 to 710
llleopold: folds 
dfcastro.net: folds 
Uncalled bet (410) returned to Bastardo Q9
Bastardo Q9 collected 925 from pot
*** SUMMARY ***
Total pot 925 | Rake 0 
Seat 1: Farmboy4321 folded before Flop (didn't bet)
Seat 2: Bastardo Q9 (button) collected (925)
Seat 4: llleopold (small blind) folded before Flop
Seat 5: dfcastro.net (big blind) folded before Flop
Seat 7: kesia545 folded before Flop (didn't bet)
Seat 8: Scarlett2710 folded before Flop (didn't bet)
Seat 9: roma_potarik folded before Flop (didn't bet)



PokerStars Hand #98797793829: Tournament #734961465, $0.23+$0.02 USD Hold'em No Limit - Level VIII (150/300) - 2013/05/19 11:09:53 BRT [2013/05/19 10:09:53 ET]
Table '734961465 2' 9-max Seat #4 is the button
Seat 1: Farmboy4321 (2912 in chips) 
Seat 2: Bastardo Q9 (9235 in chips) 
Seat 4: llleopold (5761 in chips) 
Seat 5: dfcastro.net (4989 in chips) 
Seat 7: kesia545 (3836 in chips) 
Seat 8: Scarlett2710 (3335 in chips) 
Seat 9: roma_potarik (3100 in chips) 
Farmboy4321: posts the ante 25
Bastardo Q9: posts the ante 25
llleopold: posts the ante 25
dfcastro.net: posts the ante 25
kesia545: posts the ante 25
Scarlett2710: posts the ante 25
roma_potarik: posts the ante 25
dfcastro.net: posts small blind 150
kesia545: posts big blind 300
*** HOLE CARDS ***
Dealt to dfcastro.net [5h Ts]
Scarlett2710: folds 
roma_potarik: folds 
Farmboy4321: folds 
Bastardo Q9: folds 
llleopold: folds 
dfcastro.net: folds 
Uncalled bet (150) returned to kesia545
kesia545 collected 475 from pot
kesia545: doesn't show hand 
*** SUMMARY ***
Total pot 475 | Rake 0 
Seat 1: Farmboy4321 folded before Flop (didn't bet)
Seat 2: Bastardo Q9 folded before Flop (didn't bet)
Seat 4: llleopold (button) folded before Flop (didn't bet)
Seat 5: dfcastro.net (small blind) folded before Flop
Seat 7: kesia545 (big blind) collected (475)
Seat 8: Scarlett2710 folded before Flop (didn't bet)
Seat 9: roma_potarik folded before Flop (didn't bet)



PokerStars Hand #98797818365: Tournament #734961465, $0.23+$0.02 USD Hold'em No Limit - Level VIII (150/300) - 2013/05/19 11:10:28 BRT [2013/05/19 10:10:28 ET]
Table '734961465 2' 9-max Seat #5 is the button
Seat 1: Farmboy4321 (2887 in chips) 
Seat 2: Bastardo Q9 (9210 in chips) 
Seat 4: llleopold (5736 in chips) 
Seat 5: dfcastro.net (4814 in chips) 
Seat 7: kesia545 (4136 in chips) 
Seat 8: Scarlett2710 (3310 in chips) 
Seat 9: roma_potarik (3075 in chips) 
Farmboy4321: posts the ante 25
Bastardo Q9: posts the ante 25
llleopold: posts the ante 25
dfcastro.net: posts the ante 25
kesia545: posts the ante 25
Scarlett2710: posts the ante 25
roma_potarik: posts the ante 25
kesia545: posts small blind 150
Scarlett2710: posts big blind 300
*** HOLE CARDS ***
Dealt to dfcastro.net [Kh 5h]
roma_potarik: folds 
Farmboy4321: folds 
Bastardo Q9: raises 485 to 785
llleopold: folds 
dfcastro.net: folds 
kesia545: folds 
Scarlett2710: folds 
Uncalled bet (485) returned to Bastardo Q9
Bastardo Q9 collected 925 from pot
Bastardo Q9: shows [Ah Kd] (high card Ace)
*** SUMMARY ***
Total pot 925 | Rake 0 
Seat 1: Farmboy4321 folded before Flop (didn't bet)
Seat 2: Bastardo Q9 collected (925)
Seat 4: llleopold folded before Flop (didn't bet)
Seat 5: dfcastro.net (button) folded before Flop (didn't bet)
Seat 7: kesia545 (small blind) folded before Flop
Seat 8: Scarlett2710 (big blind) folded before Flop
Seat 9: roma_potarik folded before Flop (didn't bet)



PokerStars Hand #98797837044: Tournament #734961465, $0.23+$0.02 USD Hold'em No Limit - Level VIII (150/300) - 2013/05/19 11:10:54 BRT [2013/05/19 10:10:54 ET]
Table '734961465 2' 9-max Seat #7 is the button
Seat 1: Farmboy4321 (2862 in chips) 
Seat 2: Bastardo Q9 (9810 in chips) 
Seat 4: llleopold (5711 in chips) 
Seat 5: dfcastro.net (4789 in chips) 
Seat 7: kesia545 (3961 in chips) 
Seat 8: Scarlett2710 (2985 in chips) 
Seat 9: roma_potarik (3050 in chips) 
Farmboy4321: posts the ante 25
Bastardo Q9: posts the ante 25
llleopold: posts the ante 25
dfcastro.net: posts the ante 25
kesia545: posts the ante 25
Scarlett2710: posts the ante 25
roma_potarik: posts the ante 25
Scarlett2710: posts small blind 150
roma_potarik: posts big blind 300
*** HOLE CARDS ***
Dealt to dfcastro.net [Td 8d]
Farmboy4321: folds 
Bastardo Q9: folds 
llleopold: folds 
dfcastro.net: folds 
kesia545: calls 300
Scarlett2710: folds 
roma_potarik: checks 
*** FLOP *** [9d 9h Th]
roma_potarik: checks 
kesia545: checks 
*** TURN *** [9d 9h Th] [As]
roma_potarik: checks 
kesia545: checks 
*** RIVER *** [9d 9h Th As] [Tc]
roma_potarik: checks 
kesia545: checks 
*** SHOW DOWN ***
roma_potarik: shows [7d 2h] (two pair, Tens and Nines)
kesia545: shows [7s 5s] (two pair, Tens and Nines)
roma_potarik collected 463 from pot
kesia545 collected 462 from pot
*** SUMMARY ***
Total pot 925 | Rake 0 
Board [9d 9h Th As Tc]
Seat 1: Farmboy4321 folded before Flop (didn't bet)
Seat 2: Bastardo Q9 folded before Flop (didn't bet)
Seat 4: llleopold folded before Flop (didn't bet)
Seat 5: dfcastro.net folded before Flop (didn't bet)
Seat 7: kesia545 (button) showed [7s 5s] and won (462) with two pair, Tens and Nines
Seat 8: Scarlett2710 (small blind) folded before Flop
Seat 9: roma_potarik (big blind) showed [7d 2h] and won (463) with two pair, Tens and Nines



PokerStars Hand #98797855910: Tournament #734961465, $0.23+$0.02 USD Hold'em No Limit - Level VIII (150/300) - 2013/05/19 11:11:21 BRT [2013/05/19 10:11:21 ET]
Table '734961465 2' 9-max Seat #8 is the button
Seat 1: Farmboy4321 (2837 in chips) 
Seat 2: Bastardo Q9 (9785 in chips) 
Seat 4: llleopold (5686 in chips) 
Seat 5: dfcastro.net (4764 in chips) 
Seat 7: kesia545 (4098 in chips) 
Seat 8: Scarlett2710 (2810 in chips) 
Seat 9: roma_potarik (3188 in chips) 
Farmboy4321: posts the ante 25
Bastardo Q9: posts the ante 25
llleopold: posts the ante 25
dfcastro.net: posts the ante 25
kesia545: posts the ante 25
Scarlett2710: posts the ante 25
roma_potarik: posts the ante 25
roma_potarik: posts small blind 150
Farmboy4321: posts big blind 300
*** HOLE CARDS ***
Dealt to dfcastro.net [Ad 2s]
Bastardo Q9: raises 460 to 760
llleopold: folds 
dfcastro.net: folds 
kesia545: folds 
Scarlett2710: folds 
roma_potarik: folds 
Farmboy4321: folds 
Uncalled bet (460) returned to Bastardo Q9
Bastardo Q9 collected 925 from pot
Bastardo Q9: doesn't show hand 
*** SUMMARY ***
Total pot 925 | Rake 0 
Seat 1: Farmboy4321 (big blind) folded before Flop
Seat 2: Bastardo Q9 collected (925)
Seat 4: llleopold folded before Flop (didn't bet)
Seat 5: dfcastro.net folded before Flop (didn't bet)
Seat 7: kesia545 folded before Flop (didn't bet)
Seat 8: Scarlett2710 (button) folded before Flop (didn't bet)
Seat 9: roma_potarik (small blind) folded before Flop



PokerStars Hand #98797875263: Tournament #734961465, $0.23+$0.02 USD Hold'em No Limit - Level VIII (150/300) - 2013/05/19 11:11:48 BRT [2013/05/19 10:11:48 ET]
Table '734961465 2' 9-max Seat #9 is the button
Seat 1: Farmboy4321 (2512 in chips) 
Seat 2: Bastardo Q9 (10385 in chips) 
Seat 4: llleopold (5661 in chips) 
Seat 5: dfcastro.net (4739 in chips) 
Seat 7: kesia545 (4073 in chips) 
Seat 8: Scarlett2710 (2785 in chips) 
Seat 9: roma_potarik (3013 in chips) 
Farmboy4321: posts the ante 25
Bastardo Q9: posts the ante 25
llleopold: posts the ante 25
dfcastro.net: posts the ante 25
kesia545: posts the ante 25
Scarlett2710: posts the ante 25
roma_potarik: posts the ante 25
Farmboy4321: posts small blind 150
Bastardo Q9: posts big blind 300
*** HOLE CARDS ***
Dealt to dfcastro.net [Th 4c]
llleopold: folds 
dfcastro.net: folds 
kesia545: calls 300
Scarlett2710: folds 
roma_potarik: folds 
Farmboy4321: folds 
Bastardo Q9: checks 
*** FLOP *** [Ks Ac 9s]
Bastardo Q9: checks 
kesia545: checks 
*** TURN *** [Ks Ac 9s] [Ad]
Bastardo Q9: bets 600
kesia545: calls 600
*** RIVER *** [Ks Ac 9s Ad] [Kh]
Bastardo Q9: checks 
kesia545: checks 
*** SHOW DOWN ***
Bastardo Q9: shows [Tc 3c] (two pair, Aces and Kings)
kesia545: shows [Qc Ts] (two pair, Aces and Kings - Queen kicker)
kesia545 collected 2125 from pot
*** SUMMARY ***
Total pot 2125 | Rake 0 
Board [Ks Ac 9s Ad Kh]
Seat 1: Farmboy4321 (small blind) folded before Flop
Seat 2: Bastardo Q9 (big blind) showed [Tc 3c] and lost with two pair, Aces and Kings
Seat 4: llleopold folded before Flop (didn't bet)
Seat 5: dfcastro.net folded before Flop (didn't bet)
Seat 7: kesia545 showed [Qc Ts] and won (2125) with two pair, Aces and Kings
Seat 8: Scarlett2710 folded before Flop (didn't bet)
Seat 9: roma_potarik (button) folded before Flop (didn't bet)



PokerStars Hand #98797930566: Tournament #734961465, $0.23+$0.02 USD Hold'em No Limit - Level VIII (150/300) - 2013/05/19 11:13:06 BRT [2013/05/19 10:13:06 ET]
Table '734961465 2' 9-max Seat #1 is the button
Seat 1: Farmboy4321 (2337 in chips) 
Seat 2: Bastardo Q9 (9460 in chips) 
Seat 4: llleopold (5636 in chips) 
Seat 5: dfcastro.net (4714 in chips) 
Seat 7: kesia545 (5273 in chips) 
Seat 8: Scarlett2710 (2760 in chips) 
Seat 9: roma_potarik (2988 in chips) 
Farmboy4321: posts the ante 25
Bastardo Q9: posts the ante 25
llleopold: posts the ante 25
dfcastro.net: posts the ante 25
kesia545: posts the ante 25
Scarlett2710: posts the ante 25
roma_potarik: posts the ante 25
Bastardo Q9: posts small blind 150
llleopold: posts big blind 300
*** HOLE CARDS ***
Dealt to dfcastro.net [Ts Qc]
dfcastro.net: folds 
kesia545: folds 
Scarlett2710: folds 
roma_potarik: raises 2663 to 2963 and is all-in
Farmboy4321: folds 
Bastardo Q9: raises 6472 to 9435 and is all-in
llleopold: folds 
Uncalled bet (6472) returned to Bastardo Q9
*** FLOP *** [4c 5s Kd]
*** TURN *** [4c 5s Kd] [3c]
*** RIVER *** [4c 5s Kd 3c] [6c]
*** SHOW DOWN ***
Bastardo Q9: shows [Ac As] (a pair of Aces)
roma_potarik: shows [Th Ad] (high card Ace)
Bastardo Q9 collected 6401 from pot
roma_potarik finished the tournament in 13th place
*** SUMMARY ***
Total pot 6401 | Rake 0 
Board [4c 5s Kd 3c 6c]
Seat 1: Farmboy4321 (button) folded before Flop (didn't bet)
Seat 2: Bastardo Q9 (small blind) showed [Ac As] and won (6401) with a pair of Aces
Seat 4: llleopold (big blind) folded before Flop
Seat 5: dfcastro.net folded before Flop (didn't bet)
Seat 7: kesia545 folded before Flop (didn't bet)
Seat 8: Scarlett2710 folded before Flop (didn't bet)
Seat 9: roma_potarik showed [Th Ad] and lost with high card Ace



PokerStars Hand #98797953896: Tournament #734961465, $0.23+$0.02 USD Hold'em No Limit - Level VIII (150/300) - 2013/05/19 11:13:39 BRT [2013/05/19 10:13:39 ET]
Table '734961465 2' 9-max Seat #2 is the button
Seat 1: Farmboy4321 (2312 in chips) 
Seat 2: Bastardo Q9 (12873 in chips) 
Seat 4: llleopold (5311 in chips) 
Seat 5: dfcastro.net (4689 in chips) 
Seat 7: kesia545 (5248 in chips) 
Seat 8: Scarlett2710 (2735 in chips) 
Farmboy4321: posts the ante 25
Bastardo Q9: posts the ante 25
llleopold: posts the ante 25
dfcastro.net: posts the ante 25
kesia545: posts the ante 25
Scarlett2710: posts the ante 25
llleopold: posts small blind 150
dfcastro.net: posts big blind 300
*** HOLE CARDS ***
Dealt to dfcastro.net [9h 5h]
kesia545: folds 
Scarlett2710: folds 
Farmboy4321: raises 1987 to 2287 and is all-in
Bastardo Q9: folds 
llleopold: folds 
dfcastro.net: folds 
Uncalled bet (1987) returned to Farmboy4321
Farmboy4321 collected 900 from pot
Farmboy4321: doesn't show hand 
*** SUMMARY ***
Total pot 900 | Rake 0 
Seat 1: Farmboy4321 collected (900)
Seat 2: Bastardo Q9 (button) folded before Flop (didn't bet)
Seat 4: llleopold (small blind) folded before Flop
Seat 5: dfcastro.net (big blind) folded before Flop
Seat 7: kesia545 folded before Flop (didn't bet)
Seat 8: Scarlett2710 folded before Flop (didn't bet)



PokerStars Hand #98797975478: Tournament #734961465, $0.23+$0.02 USD Hold'em No Limit - Level VIII (150/300) - 2013/05/19 11:14:09 BRT [2013/05/19 10:14:09 ET]
Table '734961465 2' 9-max Seat #4 is the button
Seat 1: Farmboy4321 (2887 in chips) 
Seat 2: Bastardo Q9 (12848 in chips) 
Seat 4: llleopold (5136 in chips) 
Seat 5: dfcastro.net (4364 in chips) 
Seat 7: kesia545 (5223 in chips) 
Seat 8: Scarlett2710 (2710 in chips) 
Farmboy4321: posts the ante 25
Bastardo Q9: posts the ante 25
llleopold: posts the ante 25
dfcastro.net: posts the ante 25
kesia545: posts the ante 25
Scarlett2710: posts the ante 25
dfcastro.net: posts small blind 150
kesia545: posts big blind 300
*** HOLE CARDS ***
Dealt to dfcastro.net [Ks 3c]
Scarlett2710: raises 2385 to 2685 and is all-in
Farmboy4321: folds 
Bastardo Q9: folds 
llleopold: folds 
dfcastro.net: folds 
kesia545: folds 
Uncalled bet (2385) returned to Scarlett2710
Scarlett2710 collected 900 from pot
Scarlett2710: doesn't show hand 
*** SUMMARY ***
Total pot 900 | Rake 0 
Seat 1: Farmboy4321 folded before Flop (didn't bet)
Seat 2: Bastardo Q9 folded before Flop (didn't bet)
Seat 4: llleopold (button) folded before Flop (didn't bet)
Seat 5: dfcastro.net (small blind) folded before Flop
Seat 7: kesia545 (big blind) folded before Flop
Seat 8: Scarlett2710 collected (900)



PokerStars Hand #98797987927: Tournament #734961465, $0.23+$0.02 USD Hold'em No Limit - Level VIII (150/300) - 2013/05/19 11:14:27 BRT [2013/05/19 10:14:27 ET]
Table '734961465 2' 9-max Seat #5 is the button
Seat 1: Farmboy4321 (2862 in chips) 
Seat 2: Bastardo Q9 (12823 in chips) 
Seat 4: llleopold (5111 in chips) 
Seat 5: dfcastro.net (4189 in chips) 
Seat 7: kesia545 (4898 in chips) 
Seat 8: Scarlett2710 (3285 in chips) 
Farmboy4321: posts the ante 25
Bastardo Q9: posts the ante 25
llleopold: posts the ante 25
dfcastro.net: posts the ante 25
kesia545: posts the ante 25
Scarlett2710: posts the ante 25
kesia545: posts small blind 150
Scarlett2710: posts big blind 300
*** HOLE CARDS ***
Dealt to dfcastro.net [Js 3s]
Farmboy4321: folds 
Bastardo Q9: folds 
llleopold: folds 
dfcastro.net: folds 
kesia545: folds 
Uncalled bet (150) returned to Scarlett2710
Scarlett2710 collected 450 from pot
Scarlett2710: doesn't show hand 
*** SUMMARY ***
Total pot 450 | Rake 0 
Seat 1: Farmboy4321 folded before Flop (didn't bet)
Seat 2: Bastardo Q9 folded before Flop (didn't bet)
Seat 4: llleopold folded before Flop (didn't bet)
Seat 5: dfcastro.net (button) folded before Flop (didn't bet)
Seat 7: kesia545 (small blind) folded before Flop
Seat 8: Scarlett2710 (big blind) collected (450)



PokerStars Hand #98798031475: Tournament #734961465, $0.23+$0.02 USD Hold'em No Limit - Level VIII (150/300) - 2013/05/19 11:15:28 BRT [2013/05/19 10:15:28 ET]
Table '734961465 2' 9-max Seat #7 is the button
Seat 1: Farmboy4321 (2837 in chips) 
Seat 2: Bastardo Q9 (12798 in chips) 
Seat 4: llleopold (5086 in chips) 
Seat 5: dfcastro.net (4164 in chips) 
Seat 7: kesia545 (4723 in chips) 
Seat 8: Scarlett2710 (3560 in chips) 
Farmboy4321: posts the ante 25
Bastardo Q9: posts the ante 25
llleopold: posts the ante 25
dfcastro.net: posts the ante 25
kesia545: posts the ante 25
Scarlett2710: posts the ante 25
Scarlett2710: posts small blind 150
Farmboy4321: posts big blind 300
*** HOLE CARDS ***
Dealt to dfcastro.net [Ac 5d]
Bastardo Q9: raises 473 to 773
llleopold: folds 
dfcastro.net: folds 
kesia545: calls 773
Scarlett2710: folds 
Farmboy4321: folds 
*** FLOP *** [Jh 9c 2s]
Bastardo Q9: bets 1000
kesia545: calls 1000
*** TURN *** [Jh 9c 2s] [Qs]
Bastardo Q9: checks 
kesia545: bets 1200
Bastardo Q9: folds 
Uncalled bet (1200) returned to kesia545
kesia545 collected 4146 from pot
kesia545: doesn't show hand 
*** SUMMARY ***
Total pot 4146 | Rake 0 
Board [Jh 9c 2s Qs]
Seat 1: Farmboy4321 (big blind) folded before Flop
Seat 2: Bastardo Q9 folded on the Turn
Seat 4: llleopold folded before Flop (didn't bet)
Seat 5: dfcastro.net folded before Flop (didn't bet)
Seat 7: kesia545 (button) collected (4146)
Seat 8: Scarlett2710 (small blind) folded before Flop



PokerStars Hand #98798058864: Tournament #734961465, $0.23+$0.02 USD Hold'em No Limit - Level VIII (150/300) - 2013/05/19 11:16:06 BRT [2013/05/19 10:16:06 ET]
Table '734961465 2' 9-max Seat #8 is the button
Seat 1: Farmboy4321 (2512 in chips) 
Seat 2: Bastardo Q9 (11000 in chips) 
Seat 4: llleopold (5061 in chips) 
Seat 5: dfcastro.net (4139 in chips) 
Seat 7: kesia545 (7071 in chips) 
Seat 8: Scarlett2710 (3385 in chips) 
Farmboy4321: posts the ante 25
Bastardo Q9: posts the ante 25
llleopold: posts the ante 25
dfcastro.net: posts the ante 25
kesia545: posts the ante 25
Scarlett2710: posts the ante 25
Farmboy4321: posts small blind 150
Bastardo Q9: posts big blind 300
*** HOLE CARDS ***
Dealt to dfcastro.net [Ks 8h]
llleopold: folds 
dfcastro.net: folds 
kesia545: calls 300
Scarlett2710: folds 
Farmboy4321: raises 2187 to 2487 and is all-in
Bastardo Q9: folds 
kesia545: calls 2187
*** FLOP *** [3s Ac Jh]
*** TURN *** [3s Ac Jh] [5c]
*** RIVER *** [3s Ac Jh 5c] [Qc]
*** SHOW DOWN ***
Farmboy4321: shows [6s 6c] (a pair of Sixes)
kesia545: shows [5h 5s] (three of a kind, Fives)
kesia545 collected 5424 from pot
Farmboy4321 finished the tournament in 12th place
*** SUMMARY ***
Total pot 5424 | Rake 0 
Board [3s Ac Jh 5c Qc]
Seat 1: Farmboy4321 (small blind) showed [6s 6c] and lost with a pair of Sixes
Seat 2: Bastardo Q9 (big blind) folded before Flop
Seat 4: llleopold folded before Flop (didn't bet)
Seat 5: dfcastro.net folded before Flop (didn't bet)
Seat 7: kesia545 showed [5h 5s] and won (5424) with three of a kind, Fives
Seat 8: Scarlett2710 (button) folded before Flop (didn't bet)



PokerStars Hand #98798082064: Tournament #734961465, $0.23+$0.02 USD Hold'em No Limit - Level VIII (150/300) - 2013/05/19 11:16:38 BRT [2013/05/19 10:16:38 ET]
Table '734961465 2' 9-max Seat #2 is the button
Seat 2: Bastardo Q9 (10675 in chips) 
Seat 4: llleopold (5036 in chips) 
Seat 5: dfcastro.net (4114 in chips) 
Seat 7: kesia545 (9983 in chips) 
Seat 8: Scarlett2710 (3360 in chips) 
Bastardo Q9: posts the ante 25
llleopold: posts the ante 25
dfcastro.net: posts the ante 25
kesia545: posts the ante 25
Scarlett2710: posts the ante 25
llleopold: posts small blind 150
dfcastro.net: posts big blind 300
*** HOLE CARDS ***
Dealt to dfcastro.net [Ah Jh]
kesia545: folds 
Scarlett2710: folds 
Bastardo Q9: folds 
llleopold: raises 300 to 600
dfcastro.net: raises 3489 to 4089 and is all-in
llleopold: folds 
Uncalled bet (3489) returned to dfcastro.net
dfcastro.net collected 1325 from pot
dfcastro.net: doesn't show hand 
*** SUMMARY ***
Total pot 1325 | Rake 0 
Seat 2: Bastardo Q9 (button) folded before Flop (didn't bet)
Seat 4: llleopold (small blind) folded before Flop
Seat 5: dfcastro.net (big blind) collected (1325)
Seat 7: kesia545 folded before Flop (didn't bet)
Seat 8: Scarlett2710 folded before Flop (didn't bet)



PokerStars Hand #98798110414: Tournament #734961465, $0.23+$0.02 USD Hold'em No Limit - Level VIII (150/300) - 2013/05/19 11:17:18 BRT [2013/05/19 10:17:18 ET]
Table '734961465 2' 9-max Seat #4 is the button
Seat 2: Bastardo Q9 (10650 in chips) 
Seat 4: llleopold (4411 in chips) 
Seat 5: dfcastro.net (4814 in chips) 
Seat 7: kesia545 (9958 in chips) 
Seat 8: Scarlett2710 (3335 in chips) 
Bastardo Q9: posts the ante 25
llleopold: posts the ante 25
dfcastro.net: posts the ante 25
kesia545: posts the ante 25
Scarlett2710: posts the ante 25
dfcastro.net: posts small blind 150
kesia545: posts big blind 300
*** HOLE CARDS ***
Dealt to dfcastro.net [Ks 5c]
Scarlett2710: folds 
Bastardo Q9: folds 
llleopold: folds 
dfcastro.net: folds 
Uncalled bet (150) returned to kesia545
kesia545 collected 425 from pot
*** SUMMARY ***
Total pot 425 | Rake 0 
Seat 2: Bastardo Q9 folded before Flop (didn't bet)
Seat 4: llleopold (button) folded before Flop (didn't bet)
Seat 5: dfcastro.net (small blind) folded before Flop
Seat 7: kesia545 (big blind) collected (425)
Seat 8: Scarlett2710 folded before Flop (didn't bet)



PokerStars Hand #98798121723: Tournament #734961465, $0.23+$0.02 USD Hold'em No Limit - Level VIII (150/300) - 2013/05/19 11:17:34 BRT [2013/05/19 10:17:34 ET]
Table '734961465 2' 9-max Seat #5 is the button
Seat 2: Bastardo Q9 (10625 in chips) 
Seat 4: llleopold (4386 in chips) 
Seat 5: dfcastro.net (4639 in chips) 
Seat 7: kesia545 (10208 in chips) 
Seat 8: Scarlett2710 (3310 in chips) 
Bastardo Q9: posts the ante 25
llleopold: posts the ante 25
dfcastro.net: posts the ante 25
kesia545: posts the ante 25
Scarlett2710: posts the ante 25
kesia545: posts small blind 150
Scarlett2710: posts big blind 300
*** HOLE CARDS ***
Dealt to dfcastro.net [Qh Ts]
Bastardo Q9: folds 
llleopold: raises 321 to 621
dfcastro.net: folds 
kesia545: calls 471
Scarlett2710: folds 
*** FLOP *** [Ks 5c 7d]
kesia545: checks 
llleopold: checks 
*** TURN *** [Ks 5c 7d] [Th]
kesia545: checks 
llleopold: checks 
*** RIVER *** [Ks 5c 7d Th] [Kh]
kesia545: checks 
llleopold: bets 1133
kesia545: folds 
Uncalled bet (1133) returned to llleopold
llleopold collected 1667 from pot
llleopold: doesn't show hand 
*** SUMMARY ***
Total pot 1667 | Rake 0 
Board [Ks 5c 7d Th Kh]
Seat 2: Bastardo Q9 folded before Flop (didn't bet)
Seat 4: llleopold collected (1667)
Seat 5: dfcastro.net (button) folded before Flop (didn't bet)
Seat 7: kesia545 (small blind) folded on the River
Seat 8: Scarlett2710 (big blind) folded before Flop



PokerStars Hand #98798161972: Tournament #734961465, $0.23+$0.02 USD Hold'em No Limit - Level IX (200/400) - 2013/05/19 11:18:30 BRT [2013/05/19 10:18:30 ET]
Table '734961465 2' 9-max Seat #7 is the button
Seat 2: Bastardo Q9 (10600 in chips) 
Seat 4: llleopold (5407 in chips) 
Seat 5: dfcastro.net (4614 in chips) 
Seat 7: kesia545 (9562 in chips) 
Seat 8: Scarlett2710 (2985 in chips) 
Bastardo Q9: posts the ante 25
llleopold: posts the ante 25
dfcastro.net: posts the ante 25
kesia545: posts the ante 25
Scarlett2710: posts the ante 25
Scarlett2710: posts small blind 200
Bastardo Q9: posts big blind 400
*** HOLE CARDS ***
Dealt to dfcastro.net [8s Th]
llleopold: folds 
dfcastro.net: folds 
kesia545: calls 400
Scarlett2710: calls 200
Bastardo Q9: checks 
*** FLOP *** [6h 9s Qd]
Scarlett2710: bets 800
Bastardo Q9: folds 
kesia545: folds 
Uncalled bet (800) returned to Scarlett2710
Scarlett2710 collected 1325 from pot
Scarlett2710: doesn't show hand 
*** SUMMARY ***
Total pot 1325 | Rake 0 
Board [6h 9s Qd]
Seat 2: Bastardo Q9 (big blind) folded on the Flop
Seat 4: llleopold folded before Flop (didn't bet)
Seat 5: dfcastro.net folded before Flop (didn't bet)
Seat 7: kesia545 (button) folded on the Flop
Seat 8: Scarlett2710 (small blind) collected (1325)



PokerStars Hand #98798177291: Tournament #734961465, $0.23+$0.02 USD Hold'em No Limit - Level IX (200/400) - 2013/05/19 11:18:52 BRT [2013/05/19 10:18:52 ET]
Table '734961465 2' 9-max Seat #8 is the button
Seat 2: Bastardo Q9 (10175 in chips) 
Seat 4: llleopold (5382 in chips) 
Seat 5: dfcastro.net (4589 in chips) 
Seat 7: kesia545 (9137 in chips) 
Seat 8: Scarlett2710 (3885 in chips) 
Bastardo Q9: posts the ante 25
llleopold: posts the ante 25
dfcastro.net: posts the ante 25
kesia545: posts the ante 25
Scarlett2710: posts the ante 25
Bastardo Q9: posts small blind 200
llleopold: posts big blind 400
*** HOLE CARDS ***
Dealt to dfcastro.net [6c Ad]
dfcastro.net: folds 
kesia545: folds 
Scarlett2710: folds 
Bastardo Q9: calls 200
llleopold: checks 
*** FLOP *** [Td 7h Qd]
Bastardo Q9: bets 800
llleopold: folds 
Uncalled bet (800) returned to Bastardo Q9
Bastardo Q9 collected 925 from pot
Bastardo Q9: doesn't show hand 
*** SUMMARY ***
Total pot 925 | Rake 0 
Board [Td 7h Qd]
Seat 2: Bastardo Q9 (small blind) collected (925)
Seat 4: llleopold (big blind) folded on the Flop
Seat 5: dfcastro.net folded before Flop (didn't bet)
Seat 7: kesia545 folded before Flop (didn't bet)
Seat 8: Scarlett2710 (button) folded before Flop (didn't bet)



PokerStars Hand #98798196532: Tournament #734961465, $0.23+$0.02 USD Hold'em No Limit - Level IX (200/400) - 2013/05/19 11:19:18 BRT [2013/05/19 10:19:18 ET]
Table '734961465 2' 9-max Seat #2 is the button
Seat 2: Bastardo Q9 (10675 in chips) 
Seat 4: llleopold (4957 in chips) 
Seat 5: dfcastro.net (4564 in chips) 
Seat 7: kesia545 (9112 in chips) 
Seat 8: Scarlett2710 (3860 in chips) 
Bastardo Q9: posts the ante 25
llleopold: posts the ante 25
dfcastro.net: posts the ante 25
kesia545: posts the ante 25
Scarlett2710: posts the ante 25
llleopold: posts small blind 200
dfcastro.net: posts big blind 400
*** HOLE CARDS ***
Dealt to dfcastro.net [Jh 6c]
kesia545: calls 400
Scarlett2710: folds 
Bastardo Q9: folds 
llleopold: folds 
dfcastro.net: checks 
*** FLOP *** [9c 3s 9h]
dfcastro.net: checks 
kesia545: checks 
*** TURN *** [9c 3s 9h] [Jc]
dfcastro.net: checks 
kesia545: checks 
*** RIVER *** [9c 3s 9h Jc] [8h]
dfcastro.net: checks 
kesia545: checks 
*** SHOW DOWN ***
dfcastro.net: shows [Jh 6c] (two pair, Jacks and Nines)
kesia545: mucks hand 
dfcastro.net collected 1125 from pot
*** SUMMARY ***
Total pot 1125 | Rake 0 
Board [9c 3s 9h Jc 8h]
Seat 2: Bastardo Q9 (button) folded before Flop (didn't bet)
Seat 4: llleopold (small blind) folded before Flop
Seat 5: dfcastro.net (big blind) showed [Jh 6c] and won (1125) with two pair, Jacks and Nines
Seat 7: kesia545 mucked [Qc 5c]
Seat 8: Scarlett2710 folded before Flop (didn't bet)



PokerStars Hand #98798228721: Tournament #734961465, $0.23+$0.02 USD Hold'em No Limit - Level IX (200/400) - 2013/05/19 11:20:03 BRT [2013/05/19 10:20:03 ET]
Table '734961465 2' 9-max Seat #4 is the button
Seat 2: Bastardo Q9 (10650 in chips) 
Seat 4: llleopold (4732 in chips) 
Seat 5: dfcastro.net (5264 in chips) 
Seat 7: kesia545 (8687 in chips) 
Seat 8: Scarlett2710 (3835 in chips) 
Bastardo Q9: posts the ante 25
llleopold: posts the ante 25
dfcastro.net: posts the ante 25
kesia545: posts the ante 25
Scarlett2710: posts the ante 25
dfcastro.net: posts small blind 200
kesia545: posts big blind 400
*** HOLE CARDS ***
Dealt to dfcastro.net [9d 3s]
Scarlett2710: folds 
Bastardo Q9: folds 
llleopold: folds 
dfcastro.net: folds 
Uncalled bet (200) returned to kesia545
kesia545 collected 525 from pot
*** SUMMARY ***
Total pot 525 | Rake 0 
Seat 2: Bastardo Q9 folded before Flop (didn't bet)
Seat 4: llleopold (button) folded before Flop (didn't bet)
Seat 5: dfcastro.net (small blind) folded before Flop
Seat 7: kesia545 (big blind) collected (525)
Seat 8: Scarlett2710 folded before Flop (didn't bet)



PokerStars Hand #98798239507: Tournament #734961465, $0.23+$0.02 USD Hold'em No Limit - Level IX (200/400) - 2013/05/19 11:20:19 BRT [2013/05/19 10:20:19 ET]
Table '734961465 2' 9-max Seat #5 is the button
Seat 2: Bastardo Q9 (10625 in chips) 
Seat 4: llleopold (4707 in chips) 
Seat 5: dfcastro.net (5039 in chips) 
Seat 7: kesia545 (8987 in chips) 
Seat 8: Scarlett2710 (3810 in chips) 
Bastardo Q9: posts the ante 25
llleopold: posts the ante 25
dfcastro.net: posts the ante 25
kesia545: posts the ante 25
Scarlett2710: posts the ante 25
kesia545: posts small blind 200
Scarlett2710: posts big blind 400
*** HOLE CARDS ***
Dealt to dfcastro.net [Ks 6h]
Bastardo Q9: folds 
llleopold: folds 
dfcastro.net: folds 
kesia545: calls 200
Scarlett2710: checks 
*** FLOP *** [8c 3s 3h]
kesia545: bets 400
Scarlett2710: folds 
Uncalled bet (400) returned to kesia545
kesia545 collected 925 from pot
kesia545: doesn't show hand 
*** SUMMARY ***
Total pot 925 | Rake 0 
Board [8c 3s 3h]
Seat 2: Bastardo Q9 folded before Flop (didn't bet)
Seat 4: llleopold folded before Flop (didn't bet)
Seat 5: dfcastro.net (button) folded before Flop (didn't bet)
Seat 7: kesia545 (small blind) collected (925)
Seat 8: Scarlett2710 (big blind) folded on the Flop



PokerStars Hand #98798256302: Tournament #734961465, $0.23+$0.02 USD Hold'em No Limit - Level IX (200/400) - 2013/05/19 11:20:42 BRT [2013/05/19 10:20:42 ET]
Table '734961465 2' 9-max Seat #7 is the button
Seat 2: Bastardo Q9 (10600 in chips) 
Seat 4: llleopold (4682 in chips) 
Seat 5: dfcastro.net (5014 in chips) 
Seat 7: kesia545 (9487 in chips) 
Seat 8: Scarlett2710 (3385 in chips) 
Bastardo Q9: posts the ante 25
llleopold: posts the ante 25
dfcastro.net: posts the ante 25
kesia545: posts the ante 25
Scarlett2710: posts the ante 25
Scarlett2710: posts small blind 200
Bastardo Q9: posts big blind 400
*** HOLE CARDS ***
Dealt to dfcastro.net [Kh 8h]
llleopold: folds 
dfcastro.net: folds 
kesia545: calls 400
Scarlett2710: folds 
Bastardo Q9: checks 
*** FLOP *** [8s Tc Ad]
Bastardo Q9: checks 
kesia545: checks 
*** TURN *** [8s Tc Ad] [7d]
Bastardo Q9: bets 400
kesia545: calls 400
*** RIVER *** [8s Tc Ad 7d] [5h]
Bastardo Q9: bets 1200
kesia545: folds 
Uncalled bet (1200) returned to Bastardo Q9
Bastardo Q9 collected 1925 from pot
*** SUMMARY ***
Total pot 1925 | Rake 0 
Board [8s Tc Ad 7d 5h]
Seat 2: Bastardo Q9 (big blind) collected (1925)
Seat 4: llleopold folded before Flop (didn't bet)
Seat 5: dfcastro.net folded before Flop (didn't bet)
Seat 7: kesia545 (button) folded on the River
Seat 8: Scarlett2710 (small blind) folded before Flop



PokerStars Hand #98798281183: Tournament #734961465, $0.23+$0.02 USD Hold'em No Limit - Level IX (200/400) - 2013/05/19 11:21:17 BRT [2013/05/19 10:21:17 ET]
Table '734961465 2' 9-max Seat #8 is the button
Seat 2: Bastardo Q9 (11700 in chips) 
Seat 4: llleopold (4657 in chips) 
Seat 5: dfcastro.net (4989 in chips) 
Seat 7: kesia545 (8662 in chips) 
Seat 8: Scarlett2710 (3160 in chips) 
Bastardo Q9: posts the ante 25
llleopold: posts the ante 25
dfcastro.net: posts the ante 25
kesia545: posts the ante 25
Scarlett2710: posts the ante 25
Bastardo Q9: posts small blind 200
llleopold: posts big blind 400
*** HOLE CARDS ***
Dealt to dfcastro.net [3d Js]
dfcastro.net: folds 
kesia545: folds 
Scarlett2710: raises 2735 to 3135 and is all-in
Bastardo Q9: folds 
llleopold: folds 
Uncalled bet (2735) returned to Scarlett2710
Scarlett2710 collected 1125 from pot
Scarlett2710: doesn't show hand 
*** SUMMARY ***
Total pot 1125 | Rake 0 
Seat 2: Bastardo Q9 (small blind) folded before Flop
Seat 4: llleopold (big blind) folded before Flop
Seat 5: dfcastro.net folded before Flop (didn't bet)
Seat 7: kesia545 folded before Flop (didn't bet)
Seat 8: Scarlett2710 (button) collected (1125)



PokerStars Hand #98798295955: Tournament #734961465, $0.23+$0.02 USD Hold'em No Limit - Level IX (200/400) - 2013/05/19 11:21:38 BRT [2013/05/19 10:21:38 ET]
Table '734961465 2' 9-max Seat #2 is the button
Seat 2: Bastardo Q9 (11475 in chips) 
Seat 4: llleopold (4232 in chips) 
Seat 5: dfcastro.net (4964 in chips) 
Seat 7: kesia545 (8637 in chips) 
Seat 8: Scarlett2710 (3860 in chips) 
Bastardo Q9: posts the ante 25
llleopold: posts the ante 25
dfcastro.net: posts the ante 25
kesia545: posts the ante 25
Scarlett2710: posts the ante 25
llleopold: posts small blind 200
dfcastro.net: posts big blind 400
*** HOLE CARDS ***
Dealt to dfcastro.net [As 7s]
kesia545: calls 400
Scarlett2710: folds 
Bastardo Q9: raises 2400 to 2800
llleopold: folds 
dfcastro.net: folds 
kesia545: calls 2400
*** FLOP *** [Qc 9s Ks]
kesia545: checks 
Bastardo Q9: bets 8650 and is all-in
kesia545: folds 
Uncalled bet (8650) returned to Bastardo Q9
Bastardo Q9 collected 6325 from pot
Bastardo Q9: shows [Kc Ac] (a pair of Kings)
*** SUMMARY ***
Total pot 6325 | Rake 0 
Board [Qc 9s Ks]
Seat 2: Bastardo Q9 (button) collected (6325)
Seat 4: llleopold (small blind) folded before Flop
Seat 5: dfcastro.net (big blind) folded before Flop
Seat 7: kesia545 folded on the Flop
Seat 8: Scarlett2710 folded before Flop (didn't bet)



PokerStars Hand #98798319060: Tournament #734961465, $0.23+$0.02 USD Hold'em No Limit - Level IX (200/400) - 2013/05/19 11:22:10 BRT [2013/05/19 10:22:10 ET]
Table '734961465 2' 9-max Seat #4 is the button
Seat 2: Bastardo Q9 (14975 in chips) 
Seat 4: llleopold (4007 in chips) 
Seat 5: dfcastro.net (4539 in chips) 
Seat 7: kesia545 (5812 in chips) 
Seat 8: Scarlett2710 (3835 in chips) 
Bastardo Q9: posts the ante 25
llleopold: posts the ante 25
dfcastro.net: posts the ante 25
kesia545: posts the ante 25
Scarlett2710: posts the ante 25
dfcastro.net: posts small blind 200
kesia545: posts big blind 400
*** HOLE CARDS ***
Dealt to dfcastro.net [7d Qs]
Scarlett2710: folds 
Bastardo Q9: folds 
llleopold: folds 
dfcastro.net: folds 
Uncalled bet (200) returned to kesia545
kesia545 collected 525 from pot
kesia545: doesn't show hand 
*** SUMMARY ***
Total pot 525 | Rake 0 
Seat 2: Bastardo Q9 folded before Flop (didn't bet)
Seat 4: llleopold (button) folded before Flop (didn't bet)
Seat 5: dfcastro.net (small blind) folded before Flop
Seat 7: kesia545 (big blind) collected (525)
Seat 8: Scarlett2710 folded before Flop (didn't bet)



PokerStars Hand #98798338367: Tournament #734961465, $0.23+$0.02 USD Hold'em No Limit - Level IX (200/400) - 2013/05/19 11:22:37 BRT [2013/05/19 10:22:37 ET]
Table '734961465 2' 9-max Seat #5 is the button
Seat 2: Bastardo Q9 (14950 in chips) 
Seat 4: llleopold (3982 in chips) 
Seat 5: dfcastro.net (4314 in chips) 
Seat 7: kesia545 (6112 in chips) 
Seat 8: Scarlett2710 (3810 in chips) 
Bastardo Q9: posts the ante 25
llleopold: posts the ante 25
dfcastro.net: posts the ante 25
kesia545: posts the ante 25
Scarlett2710: posts the ante 25
kesia545: posts small blind 200
Scarlett2710: posts big blind 400
*** HOLE CARDS ***
Dealt to dfcastro.net [9c 9s]
Bastardo Q9: folds 
llleopold: folds 
dfcastro.net: raises 480 to 880
kesia545: folds 
Scarlett2710: raises 2905 to 3785 and is all-in
dfcastro.net: calls 2905
*** FLOP *** [3h Kh 5d]
*** TURN *** [3h Kh 5d] [7d]
*** RIVER *** [3h Kh 5d 7d] [4h]
*** SHOW DOWN ***
Scarlett2710: shows [Ts Ah] (high card Ace)
dfcastro.net: shows [9c 9s] (a pair of Nines)
dfcastro.net collected 7895 from pot
Scarlett2710 finished the tournament in 11th place
*** SUMMARY ***
Total pot 7895 | Rake 0 
Board [3h Kh 5d 7d 4h]
Seat 2: Bastardo Q9 folded before Flop (didn't bet)
Seat 4: llleopold folded before Flop (didn't bet)
Seat 5: dfcastro.net (button) showed [9c 9s] and won (7895) with a pair of Nines
Seat 7: kesia545 (small blind) folded before Flop
Seat 8: Scarlett2710 (big blind) showed [Ts Ah] and lost with high card Ace



PokerStars Hand #98798357020: Tournament #734961465, $0.23+$0.02 USD Hold'em No Limit - Level IX (200/400) - 2013/05/19 11:23:04 BRT [2013/05/19 10:23:04 ET]
Table '734961465 2' 9-max Seat #7 is the button
Seat 2: Bastardo Q9 (14925 in chips) 
Seat 4: llleopold (3957 in chips) 
Seat 5: dfcastro.net (8399 in chips) 
Seat 7: kesia545 (5887 in chips) 
Bastardo Q9: posts the ante 25
llleopold: posts the ante 25
dfcastro.net: posts the ante 25
kesia545: posts the ante 25
Bastardo Q9: posts small blind 200
llleopold: posts big blind 400
*** HOLE CARDS ***
Dealt to dfcastro.net [Ts 3d]
dfcastro.net: folds 
kesia545: folds 
Bastardo Q9: raises 600 to 1000
llleopold: raises 2932 to 3932 and is all-in
Bastardo Q9: folds 
Uncalled bet (2932) returned to llleopold
llleopold collected 2100 from pot
llleopold: doesn't show hand 
*** SUMMARY ***
Total pot 2100 | Rake 0 
Seat 2: Bastardo Q9 (small blind) folded before Flop
Seat 4: llleopold (big blind) collected (2100)
Seat 5: dfcastro.net folded before Flop (didn't bet)
Seat 7: kesia545 (button) folded before Flop (didn't bet)



PokerStars Hand #98798374546: Tournament #734961465, $0.23+$0.02 USD Hold'em No Limit - Level IX (200/400) - 2013/05/19 11:23:28 BRT [2013/05/19 10:23:28 ET]
Table '734961465 2' 9-max Seat #2 is the button
Seat 1: worf1k (5430 in chips) 
Seat 2: Bastardo Q9 (13900 in chips) 
Seat 4: llleopold (5032 in chips) 
Seat 5: dfcastro.net (8374 in chips) 
Seat 7: kesia545 (5862 in chips) 
worf1k: posts the ante 25
Bastardo Q9: posts the ante 25
llleopold: posts the ante 25
dfcastro.net: posts the ante 25
kesia545: posts the ante 25
llleopold: posts small blind 200
dfcastro.net: posts big blind 400
*** HOLE CARDS ***
Dealt to dfcastro.net [9h 2h]
kesia545: folds 
worf1k: folds 
Bastardo Q9: calls 400
llleopold: folds 
dfcastro.net: checks 
*** FLOP *** [7c 6d 9s]
dfcastro.net: checks 
Bastardo Q9: bets 800
dfcastro.net: folds 
Uncalled bet (800) returned to Bastardo Q9
Bastardo Q9 collected 1125 from pot
Bastardo Q9: doesn't show hand 
*** SUMMARY ***
Total pot 1125 | Rake 0 
Board [7c 6d 9s]
Seat 1: worf1k folded before Flop (didn't bet)
Seat 2: Bastardo Q9 (button) collected (1125)
Seat 4: llleopold (small blind) folded before Flop
Seat 5: dfcastro.net (big blind) folded on the Flop
Seat 7: kesia545 folded before Flop (didn't bet)



PokerStars Hand #98798394832: Tournament #734961465, $0.23+$0.02 USD Hold'em No Limit - Level IX (200/400) - 2013/05/19 11:23:57 BRT [2013/05/19 10:23:57 ET]
Table '734961465 2' 9-max Seat #4 is the button
Seat 1: worf1k (5405 in chips) 
Seat 2: Bastardo Q9 (14600 in chips) 
Seat 4: llleopold (4807 in chips) 
Seat 5: dfcastro.net (7949 in chips) 
Seat 7: kesia545 (5837 in chips) 
worf1k: posts the ante 25
Bastardo Q9: posts the ante 25
llleopold: posts the ante 25
dfcastro.net: posts the ante 25
kesia545: posts the ante 25
dfcastro.net: posts small blind 200
kesia545: posts big blind 400
*** HOLE CARDS ***
Dealt to dfcastro.net [9s As]
worf1k: folds 
Bastardo Q9: folds 
llleopold: folds 
dfcastro.net: raises 480 to 880
kesia545: folds 
Uncalled bet (480) returned to dfcastro.net
dfcastro.net collected 925 from pot
dfcastro.net: doesn't show hand 
*** SUMMARY ***
Total pot 925 | Rake 0 
Seat 1: worf1k folded before Flop (didn't bet)
Seat 2: Bastardo Q9 folded before Flop (didn't bet)
Seat 4: llleopold (button) folded before Flop (didn't bet)
Seat 5: dfcastro.net (small blind) collected (925)
Seat 7: kesia545 (big blind) folded before Flop



PokerStars Hand #98798405195: Tournament #734961465, $0.23+$0.02 USD Hold'em No Limit - Level IX (200/400) - 2013/05/19 11:24:11 BRT [2013/05/19 10:24:11 ET]
Table '734961465 2' 9-max Seat #5 is the button
Seat 1: worf1k (5380 in chips) 
Seat 2: Bastardo Q9 (14575 in chips) 
Seat 4: llleopold (4782 in chips) 
Seat 5: dfcastro.net (8449 in chips) 
Seat 7: kesia545 (5412 in chips) 
worf1k: posts the ante 25
Bastardo Q9: posts the ante 25
llleopold: posts the ante 25
dfcastro.net: posts the ante 25
kesia545: posts the ante 25
kesia545: posts small blind 200
worf1k: posts big blind 400
*** HOLE CARDS ***
Dealt to dfcastro.net [Qh Qs]
Bastardo Q9: folds 
llleopold: folds 
dfcastro.net: raises 480 to 880
kesia545: folds 
worf1k: folds 
Uncalled bet (480) returned to dfcastro.net
dfcastro.net collected 1125 from pot
dfcastro.net: doesn't show hand 
*** SUMMARY ***
Total pot 1125 | Rake 0 
Seat 1: worf1k (big blind) folded before Flop
Seat 2: Bastardo Q9 folded before Flop (didn't bet)
Seat 4: llleopold folded before Flop (didn't bet)
Seat 5: dfcastro.net (button) collected (1125)
Seat 7: kesia545 (small blind) folded before Flop



PokerStars Hand #98798418622: Tournament #734961465, $0.23+$0.02 USD Hold'em No Limit - Level IX (200/400) - 2013/05/19 11:24:30 BRT [2013/05/19 10:24:30 ET]
Table '734961465 2' 9-max Seat #7 is the button
Seat 1: worf1k (4955 in chips) 
Seat 2: Bastardo Q9 (14550 in chips) 
Seat 4: llleopold (4757 in chips) 
Seat 5: dfcastro.net (9149 in chips) 
Seat 7: kesia545 (5187 in chips) 
worf1k: posts the ante 25
Bastardo Q9: posts the ante 25
llleopold: posts the ante 25
dfcastro.net: posts the ante 25
kesia545: posts the ante 25
worf1k: posts small blind 200
Bastardo Q9: posts big blind 400
*** HOLE CARDS ***
Dealt to dfcastro.net [Qs 7c]
llleopold: folds 
dfcastro.net: folds 
kesia545: folds 
worf1k: folds 
Uncalled bet (200) returned to Bastardo Q9
Bastardo Q9 collected 525 from pot
*** SUMMARY ***
Total pot 525 | Rake 0 
Seat 1: worf1k (small blind) folded before Flop
Seat 2: Bastardo Q9 (big blind) collected (525)
Seat 4: llleopold folded before Flop (didn't bet)
Seat 5: dfcastro.net folded before Flop (didn't bet)
Seat 7: kesia545 (button) folded before Flop (didn't bet)



PokerStars Hand #98798434521: Tournament #734961465, $0.23+$0.02 USD Hold'em No Limit - Level IX (200/400) - 2013/05/19 11:24:53 BRT [2013/05/19 10:24:53 ET]
Table '734961465 2' 9-max Seat #1 is the button
Seat 1: worf1k (4730 in chips) 
Seat 2: Bastardo Q9 (14850 in chips) 
Seat 3: 1DMITRYSPb1 (5255 in chips) 
Seat 4: llleopold (4732 in chips) 
Seat 5: dfcastro.net (9124 in chips) 
Seat 6: 91_EL_DIABLO (15334 in chips) 
Seat 7: kesia545 (5162 in chips) 
Seat 8: dr.Prokhor (6040 in chips) 
Seat 9: ximenes.cr (2273 in chips) 
worf1k: posts the ante 25
Bastardo Q9: posts the ante 25
1DMITRYSPb1: posts the ante 25
llleopold: posts the ante 25
dfcastro.net: posts the ante 25
91_EL_DIABLO: posts the ante 25
kesia545: posts the ante 25
dr.Prokhor: posts the ante 25
ximenes.cr: posts the ante 25
Bastardo Q9: posts small blind 200
1DMITRYSPb1: posts big blind 400
*** HOLE CARDS ***
Dealt to dfcastro.net [3d Ad]
llleopold: folds 
dfcastro.net: folds 
91_EL_DIABLO: calls 400
kesia545: folds 
dr.Prokhor: folds 
ximenes.cr: folds 
worf1k: folds 
Bastardo Q9: calls 200
1DMITRYSPb1: checks 
*** FLOP *** [9d 5s 2h]
Bastardo Q9: checks 
1DMITRYSPb1: checks 
91_EL_DIABLO: bets 400
Bastardo Q9: calls 400
1DMITRYSPb1: folds 
*** TURN *** [9d 5s 2h] [Td]
Bastardo Q9: checks 
91_EL_DIABLO: bets 400
Bastardo Q9: raises 1200 to 1600
91_EL_DIABLO: calls 1200
*** RIVER *** [9d 5s 2h Td] [Qh]
Bastardo Q9: checks 
91_EL_DIABLO: bets 3200
Bastardo Q9: calls 3200
*** SHOW DOWN ***
91_EL_DIABLO: shows [8h 8s] (a pair of Eights)
Bastardo Q9: shows [5d 5h] (three of a kind, Fives)
Bastardo Q9 collected 11825 from pot
*** SUMMARY ***
Total pot 11825 | Rake 0 
Board [9d 5s 2h Td Qh]
Seat 1: worf1k (button) folded before Flop (didn't bet)
Seat 2: Bastardo Q9 (small blind) showed [5d 5h] and won (11825) with three of a kind, Fives
Seat 3: 1DMITRYSPb1 (big blind) folded on the Flop
Seat 4: llleopold folded before Flop (didn't bet)
Seat 5: dfcastro.net folded before Flop (didn't bet)
Seat 6: 91_EL_DIABLO showed [8h 8s] and lost with a pair of Eights
Seat 7: kesia545 folded before Flop (didn't bet)
Seat 8: dr.Prokhor folded before Flop (didn't bet)
Seat 9: ximenes.cr folded before Flop (didn't bet)



PokerStars Hand #98798479503: Tournament #734961465, $0.23+$0.02 USD Hold'em No Limit - Level IX (200/400) - 2013/05/19 11:25:55 BRT [2013/05/19 10:25:55 ET]
Table '734961465 2' 9-max Seat #2 is the button
Seat 1: worf1k (4705 in chips) 
Seat 2: Bastardo Q9 (21050 in chips) 
Seat 3: 1DMITRYSPb1 (4830 in chips) 
Seat 4: llleopold (4707 in chips) 
Seat 5: dfcastro.net (9099 in chips) 
Seat 6: 91_EL_DIABLO (9709 in chips) 
Seat 7: kesia545 (5137 in chips) 
Seat 8: dr.Prokhor (6015 in chips) 
Seat 9: ximenes.cr (2248 in chips) 
worf1k: posts the ante 25
Bastardo Q9: posts the ante 25
1DMITRYSPb1: posts the ante 25
llleopold: posts the ante 25
dfcastro.net: posts the ante 25
91_EL_DIABLO: posts the ante 25
kesia545: posts the ante 25
dr.Prokhor: posts the ante 25
ximenes.cr: posts the ante 25
1DMITRYSPb1: posts small blind 200
llleopold: posts big blind 400
*** HOLE CARDS ***
Dealt to dfcastro.net [5d 7d]
dfcastro.net: folds 
91_EL_DIABLO said, "*******ooo"
91_EL_DIABLO: folds 
kesia545: folds 
dr.Prokhor: folds 
ximenes.cr: folds 
worf1k: folds 
Bastardo Q9: folds 
1DMITRYSPb1: folds 
Uncalled bet (200) returned to llleopold
llleopold collected 625 from pot
llleopold: doesn't show hand 
*** SUMMARY ***
Total pot 625 | Rake 0 
Seat 1: worf1k folded before Flop (didn't bet)
Seat 2: Bastardo Q9 (button) folded before Flop (didn't bet)
Seat 3: 1DMITRYSPb1 (small blind) folded before Flop
Seat 4: llleopold (big blind) collected (625)
Seat 5: dfcastro.net folded before Flop (didn't bet)
Seat 6: 91_EL_DIABLO folded before Flop (didn't bet)
Seat 7: kesia545 folded before Flop (didn't bet)
Seat 8: dr.Prokhor folded before Flop (didn't bet)
Seat 9: ximenes.cr folded before Flop (didn't bet)



PokerStars Hand #98798497607: Tournament #734961465, $0.23+$0.02 USD Hold'em No Limit - Level IX (200/400) - 2013/05/19 11:26:21 BRT [2013/05/19 10:26:21 ET]
Table '734961465 2' 9-max Seat #3 is the button
Seat 1: worf1k (4680 in chips) 
Seat 2: Bastardo Q9 (21025 in chips) 
Seat 3: 1DMITRYSPb1 (4605 in chips) 
Seat 4: llleopold (5107 in chips) 
Seat 5: dfcastro.net (9074 in chips) 
Seat 6: 91_EL_DIABLO (9684 in chips) 
Seat 7: kesia545 (5112 in chips) 
Seat 8: dr.Prokhor (5990 in chips) 
Seat 9: ximenes.cr (2223 in chips) 
worf1k: posts the ante 25
Bastardo Q9: posts the ante 25
1DMITRYSPb1: posts the ante 25
llleopold: posts the ante 25
dfcastro.net: posts the ante 25
91_EL_DIABLO: posts the ante 25
kesia545: posts the ante 25
dr.Prokhor: posts the ante 25
ximenes.cr: posts the ante 25
llleopold: posts small blind 200
dfcastro.net: posts big blind 400
*** HOLE CARDS ***
Dealt to dfcastro.net [5h Tc]
91_EL_DIABLO: folds 
kesia545: folds 
dr.Prokhor: raises 600 to 1000
ximenes.cr: folds 
worf1k: folds 
Bastardo Q9: raises 20000 to 21000 and is all-in
1DMITRYSPb1: folds 
llleopold: folds 
dfcastro.net: folds 
dr.Prokhor: calls 4965 and is all-in
Uncalled bet (15035) returned to Bastardo Q9
*** FLOP *** [8d Jc 6c]
*** TURN *** [8d Jc 6c] [2s]
*** RIVER *** [8d Jc 6c 2s] [3h]
*** SHOW DOWN ***
dr.Prokhor: shows [Td Ts] (a pair of Tens)
Bastardo Q9: shows [Qs As] (high card Ace)
dr.Prokhor collected 12755 from pot
*** SUMMARY ***
Total pot 12755 | Rake 0 
Board [8d Jc 6c 2s 3h]
Seat 1: worf1k folded before Flop (didn't bet)
Seat 2: Bastardo Q9 showed [Qs As] and lost with high card Ace
Seat 3: 1DMITRYSPb1 (button) folded before Flop (didn't bet)
Seat 4: llleopold (small blind) folded before Flop
Seat 5: dfcastro.net (big blind) folded before Flop
Seat 6: 91_EL_DIABLO folded before Flop (didn't bet)
Seat 7: kesia545 folded before Flop (didn't bet)
Seat 8: dr.Prokhor showed [Td Ts] and won (12755) with a pair of Tens
Seat 9: ximenes.cr folded before Flop (didn't bet)



PokerStars Hand #98798532870: Tournament #734961465, $0.23+$0.02 USD Hold'em No Limit - Level IX (200/400) - 2013/05/19 11:27:09 BRT [2013/05/19 10:27:09 ET]
Table '734961465 2' 9-max Seat #4 is the button
Seat 1: worf1k (4655 in chips) 
Seat 2: Bastardo Q9 (15035 in chips) 
Seat 3: 1DMITRYSPb1 (4580 in chips) 
Seat 4: llleopold (4882 in chips) 
Seat 5: dfcastro.net (8649 in chips) 
Seat 6: 91_EL_DIABLO (9659 in chips) 
Seat 7: kesia545 (5087 in chips) 
Seat 8: dr.Prokhor (12755 in chips) 
Seat 9: ximenes.cr (2198 in chips) 
worf1k: posts the ante 25
Bastardo Q9: posts the ante 25
1DMITRYSPb1: posts the ante 25
llleopold: posts the ante 25
dfcastro.net: posts the ante 25
91_EL_DIABLO: posts the ante 25
kesia545: posts the ante 25
dr.Prokhor: posts the ante 25
ximenes.cr: posts the ante 25
dfcastro.net: posts small blind 200
91_EL_DIABLO: posts big blind 400
*** HOLE CARDS ***
Dealt to dfcastro.net [2s Qs]
kesia545: folds 
dr.Prokhor: folds 
ximenes.cr: folds 
worf1k: folds 
Bastardo Q9: folds 
1DMITRYSPb1: raises 400 to 800
llleopold: folds 
dfcastro.net: folds 
91_EL_DIABLO: calls 400
*** FLOP *** [7h 7c Ad]
91_EL_DIABLO: checks 
1DMITRYSPb1: bets 800
91_EL_DIABLO: calls 800
*** TURN *** [7h 7c Ad] [3d]
91_EL_DIABLO: checks 
1DMITRYSPb1: bets 800
91_EL_DIABLO: raises 2400 to 3200
1DMITRYSPb1: calls 2155 and is all-in
Uncalled bet (245) returned to 91_EL_DIABLO
*** RIVER *** [7h 7c Ad 3d] [Qh]
*** SHOW DOWN ***
91_EL_DIABLO: shows [6s Ac] (two pair, Aces and Sevens)
1DMITRYSPb1: shows [As Js] (two pair, Aces and Sevens)
91_EL_DIABLO collected 4768 from pot
1DMITRYSPb1 collected 4767 from pot
*** SUMMARY ***
Total pot 9535 | Rake 0 
Board [7h 7c Ad 3d Qh]
Seat 1: worf1k folded before Flop (didn't bet)
Seat 2: Bastardo Q9 folded before Flop (didn't bet)
Seat 3: 1DMITRYSPb1 showed [As Js] and won (4767) with two pair, Aces and Sevens
Seat 4: llleopold (button) folded before Flop (didn't bet)
Seat 5: dfcastro.net (small blind) folded before Flop
Seat 6: 91_EL_DIABLO (big blind) showed [6s Ac] and won (4768) with two pair, Aces and Sevens
Seat 7: kesia545 folded before Flop (didn't bet)
Seat 8: dr.Prokhor folded before Flop (didn't bet)
Seat 9: ximenes.cr folded before Flop (didn't bet)



PokerStars Hand #98798588299: Tournament #734961465, $0.23+$0.02 USD Hold'em No Limit - Level X (300/600) - 2013/05/19 11:28:26 BRT [2013/05/19 10:28:26 ET]
Table '734961465 2' 9-max Seat #5 is the button
Seat 1: worf1k (4630 in chips) 
Seat 2: Bastardo Q9 (15010 in chips) 
Seat 3: 1DMITRYSPb1 (4767 in chips) 
Seat 4: llleopold (4857 in chips) 
Seat 5: dfcastro.net (8424 in chips) 
Seat 6: 91_EL_DIABLO (9847 in chips) 
Seat 7: kesia545 (5062 in chips) 
Seat 8: dr.Prokhor (12730 in chips) 
Seat 9: ximenes.cr (2173 in chips) 
worf1k: posts the ante 50
Bastardo Q9: posts the ante 50
1DMITRYSPb1: posts the ante 50
llleopold: posts the ante 50
dfcastro.net: posts the ante 50
91_EL_DIABLO: posts the ante 50
kesia545: posts the ante 50
dr.Prokhor: posts the ante 50
ximenes.cr: posts the ante 50
91_EL_DIABLO: posts small blind 300
kesia545: posts big blind 600
*** HOLE CARDS ***
Dealt to dfcastro.net [7d 6s]
dr.Prokhor: folds 
ximenes.cr: folds 
worf1k: raises 3980 to 4580 and is all-in
Bastardo Q9: folds 
1DMITRYSPb1: folds 
llleopold: folds 
dfcastro.net: folds 
91_EL_DIABLO: folds 
kesia545: folds 
Uncalled bet (3980) returned to worf1k
worf1k collected 1950 from pot
*** SUMMARY ***
Total pot 1950 | Rake 0 
Seat 1: worf1k collected (1950)
Seat 2: Bastardo Q9 folded before Flop (didn't bet)
Seat 3: 1DMITRYSPb1 folded before Flop (didn't bet)
Seat 4: llleopold folded before Flop (didn't bet)
Seat 5: dfcastro.net (button) folded before Flop (didn't bet)
Seat 6: 91_EL_DIABLO (small blind) folded before Flop
Seat 7: kesia545 (big blind) folded before Flop
Seat 8: dr.Prokhor folded before Flop (didn't bet)
Seat 9: ximenes.cr folded before Flop (didn't bet)



PokerStars Hand #98798618039: Tournament #734961465, $0.23+$0.02 USD Hold'em No Limit - Level X (300/600) - 2013/05/19 11:29:08 BRT [2013/05/19 10:29:08 ET]
Table '734961465 2' 9-max Seat #6 is the button
Seat 1: worf1k (5930 in chips) 
Seat 2: Bastardo Q9 (14960 in chips) 
Seat 3: 1DMITRYSPb1 (4717 in chips) 
Seat 4: llleopold (4807 in chips) 
Seat 5: dfcastro.net (8374 in chips) 
Seat 6: 91_EL_DIABLO (9497 in chips) 
Seat 7: kesia545 (4412 in chips) 
Seat 8: dr.Prokhor (12680 in chips) 
Seat 9: ximenes.cr (2123 in chips) 
worf1k: posts the ante 50
Bastardo Q9: posts the ante 50
1DMITRYSPb1: posts the ante 50
llleopold: posts the ante 50
dfcastro.net: posts the ante 50
91_EL_DIABLO: posts the ante 50
kesia545: posts the ante 50
dr.Prokhor: posts the ante 50
ximenes.cr: posts the ante 50
kesia545: posts small blind 300
dr.Prokhor: posts big blind 600
*** HOLE CARDS ***
Dealt to dfcastro.net [Jh 6c]
ximenes.cr: folds 
worf1k: folds 
Bastardo Q9: raises 1110 to 1710
1DMITRYSPb1: folds 
llleopold: folds 
dfcastro.net: folds 
91_EL_DIABLO: calls 1710
kesia545: calls 1410
dr.Prokhor: folds 
*** FLOP *** [5d 9h 7h]
kesia545: checks 
Bastardo Q9: bets 2200
91_EL_DIABLO: raises 5537 to 7737 and is all-in
kesia545: calls 2652 and is all-in
Bastardo Q9: folds 
Uncalled bet (5085) returned to 91_EL_DIABLO
*** TURN *** [5d 9h 7h] [8s]
*** RIVER *** [5d 9h 7h 8s] [Ah]
*** SHOW DOWN ***
kesia545: shows [5h 3h] (a flush, Ace high)
91_EL_DIABLO: shows [Kh 9s] (a pair of Nines)
kesia545 collected 13684 from pot
*** SUMMARY ***
Total pot 13684 | Rake 0 
Board [5d 9h 7h 8s Ah]
Seat 1: worf1k folded before Flop (didn't bet)
Seat 2: Bastardo Q9 folded on the Flop
Seat 3: 1DMITRYSPb1 folded before Flop (didn't bet)
Seat 4: llleopold folded before Flop (didn't bet)
Seat 5: dfcastro.net folded before Flop (didn't bet)
Seat 6: 91_EL_DIABLO (button) showed [Kh 9s] and lost with a pair of Nines
Seat 7: kesia545 (small blind) showed [5h 3h] and won (13684) with a flush, Ace high
Seat 8: dr.Prokhor (big blind) folded before Flop
Seat 9: ximenes.cr folded before Flop (didn't bet)



PokerStars Hand #98798669877: Tournament #734961465, $0.23+$0.02 USD Hold'em No Limit - Level X (300/600) - 2013/05/19 11:30:20 BRT [2013/05/19 10:30:20 ET]
Table '734961465 2' 9-max Seat #7 is the button
Seat 1: worf1k (5880 in chips) 
Seat 2: Bastardo Q9 (11000 in chips) 
Seat 3: 1DMITRYSPb1 (4667 in chips) 
Seat 4: llleopold (4757 in chips) 
Seat 5: dfcastro.net (8324 in chips) 
Seat 6: 91_EL_DIABLO (5085 in chips) 
Seat 7: kesia545 (13684 in chips) 
Seat 8: dr.Prokhor (12030 in chips) 
Seat 9: ximenes.cr (2073 in chips) 
worf1k: posts the ante 50
Bastardo Q9: posts the ante 50
1DMITRYSPb1: posts the ante 50
llleopold: posts the ante 50
dfcastro.net: posts the ante 50
91_EL_DIABLO: posts the ante 50
kesia545: posts the ante 50
dr.Prokhor: posts the ante 50
ximenes.cr: posts the ante 50
dr.Prokhor: posts small blind 300
ximenes.cr: posts big blind 600
*** HOLE CARDS ***
Dealt to dfcastro.net [9c Qh]
worf1k: folds 
Bastardo Q9: folds 
1DMITRYSPb1: folds 
llleopold: folds 
dfcastro.net: folds 
91_EL_DIABLO: folds 
kesia545: folds 
dr.Prokhor: folds 
Uncalled bet (300) returned to ximenes.cr
ximenes.cr collected 1050 from pot
ximenes.cr: doesn't show hand 
*** SUMMARY ***
Total pot 1050 | Rake 0 
Seat 1: worf1k folded before Flop (didn't bet)
Seat 2: Bastardo Q9 folded before Flop (didn't bet)
Seat 3: 1DMITRYSPb1 folded before Flop (didn't bet)
Seat 4: llleopold folded before Flop (didn't bet)
Seat 5: dfcastro.net folded before Flop (didn't bet)
Seat 6: 91_EL_DIABLO folded before Flop (didn't bet)
Seat 7: kesia545 (button) folded before Flop (didn't bet)
Seat 8: dr.Prokhor (small blind) folded before Flop
Seat 9: ximenes.cr (big blind) collected (1050)



PokerStars Hand #98798694194: Tournament #734961465, $0.23+$0.02 USD Hold'em No Limit - Level X (300/600) - 2013/05/19 11:30:54 BRT [2013/05/19 10:30:54 ET]
Table '734961465 2' 9-max Seat #8 is the button
Seat 1: worf1k (5830 in chips) 
Seat 2: Bastardo Q9 (10950 in chips) 
Seat 3: 1DMITRYSPb1 (4617 in chips) 
Seat 4: llleopold (4707 in chips) 
Seat 5: dfcastro.net (8274 in chips) 
Seat 6: 91_EL_DIABLO (5035 in chips) 
Seat 7: kesia545 (13634 in chips) 
Seat 8: dr.Prokhor (11680 in chips) 
Seat 9: ximenes.cr (2773 in chips) 
worf1k: posts the ante 50
Bastardo Q9: posts the ante 50
1DMITRYSPb1: posts the ante 50
llleopold: posts the ante 50
dfcastro.net: posts the ante 50
91_EL_DIABLO: posts the ante 50
kesia545: posts the ante 50
dr.Prokhor: posts the ante 50
ximenes.cr: posts the ante 50
ximenes.cr: posts small blind 300
worf1k: posts big blind 600
*** HOLE CARDS ***
Dealt to dfcastro.net [4h 5c]
Bastardo Q9: folds 
1DMITRYSPb1: folds 
llleopold: folds 
dfcastro.net: folds 
91_EL_DIABLO: folds 
kesia545: calls 600
dr.Prokhor: folds 
ximenes.cr: folds 
worf1k: checks 
*** FLOP *** [Jh Th 5h]
worf1k: checks 
kesia545: checks 
*** TURN *** [Jh Th 5h] [Ac]
worf1k: checks 
kesia545: checks 
*** RIVER *** [Jh Th 5h Ac] [5d]
worf1k: checks 
kesia545: checks 
*** SHOW DOWN ***
worf1k: shows [9c 3c] (a pair of Fives)
kesia545: shows [Jc 9d] (two pair, Jacks and Fives)
kesia545 collected 1950 from pot
*** SUMMARY ***
Total pot 1950 | Rake 0 
Board [Jh Th 5h Ac 5d]
Seat 1: worf1k (big blind) showed [9c 3c] and lost with a pair of Fives
Seat 2: Bastardo Q9 folded before Flop (didn't bet)
Seat 3: 1DMITRYSPb1 folded before Flop (didn't bet)
Seat 4: llleopold folded before Flop (didn't bet)
Seat 5: dfcastro.net folded before Flop (didn't bet)
Seat 6: 91_EL_DIABLO folded before Flop (didn't bet)
Seat 7: kesia545 showed [Jc 9d] and won (1950) with two pair, Jacks and Fives
Seat 8: dr.Prokhor (button) folded before Flop (didn't bet)
Seat 9: ximenes.cr (small blind) folded before Flop



PokerStars Hand #98798723269: Tournament #734961465, $0.23+$0.02 USD Hold'em No Limit - Level X (300/600) - 2013/05/19 11:31:34 BRT [2013/05/19 10:31:34 ET]
Table '734961465 2' 9-max Seat #9 is the button
Seat 1: worf1k (5180 in chips) 
Seat 2: Bastardo Q9 (10900 in chips) 
Seat 3: 1DMITRYSPb1 (4567 in chips) 
Seat 4: llleopold (4657 in chips) 
Seat 5: dfcastro.net (8224 in chips) 
Seat 6: 91_EL_DIABLO (4985 in chips) 
Seat 7: kesia545 (14934 in chips) 
Seat 8: dr.Prokhor (11630 in chips) 
Seat 9: ximenes.cr (2423 in chips) 
worf1k: posts the ante 50
Bastardo Q9: posts the ante 50
1DMITRYSPb1: posts the ante 50
llleopold: posts the ante 50
dfcastro.net: posts the ante 50
91_EL_DIABLO: posts the ante 50
kesia545: posts the ante 50
dr.Prokhor: posts the ante 50
ximenes.cr: posts the ante 50
worf1k: posts small blind 300
Bastardo Q9: posts big blind 600
*** HOLE CARDS ***
Dealt to dfcastro.net [7c As]
1DMITRYSPb1: folds 
llleopold: folds 
dfcastro.net: raises 720 to 1320
91_EL_DIABLO: folds 
kesia545: folds 
dr.Prokhor: folds 
ximenes.cr: folds 
worf1k: folds 
Bastardo Q9: folds 
Uncalled bet (720) returned to dfcastro.net
dfcastro.net collected 1950 from pot
dfcastro.net: doesn't show hand 
*** SUMMARY ***
Total pot 1950 | Rake 0 
Seat 1: worf1k (small blind) folded before Flop
Seat 2: Bastardo Q9 (big blind) folded before Flop
Seat 3: 1DMITRYSPb1 folded before Flop (didn't bet)
Seat 4: llleopold folded before Flop (didn't bet)
Seat 5: dfcastro.net collected (1950)
Seat 6: 91_EL_DIABLO folded before Flop (didn't bet)
Seat 7: kesia545 folded before Flop (didn't bet)
Seat 8: dr.Prokhor folded before Flop (didn't bet)
Seat 9: ximenes.cr (button) folded before Flop (didn't bet)



PokerStars Hand #98798757061: Tournament #734961465, $0.23+$0.02 USD Hold'em No Limit - Level X (300/600) - 2013/05/19 11:32:20 BRT [2013/05/19 10:32:20 ET]
Table '734961465 2' 9-max Seat #1 is the button
Seat 1: worf1k (4830 in chips) 
Seat 2: Bastardo Q9 (10250 in chips) 
Seat 3: 1DMITRYSPb1 (4517 in chips) 
Seat 4: llleopold (4607 in chips) 
Seat 5: dfcastro.net (9524 in chips) 
Seat 6: 91_EL_DIABLO (4935 in chips) 
Seat 7: kesia545 (14884 in chips) 
Seat 8: dr.Prokhor (11580 in chips) 
Seat 9: ximenes.cr (2373 in chips) 
worf1k: posts the ante 50
Bastardo Q9: posts the ante 50
1DMITRYSPb1: posts the ante 50
llleopold: posts the ante 50
dfcastro.net: posts the ante 50
91_EL_DIABLO: posts the ante 50
kesia545: posts the ante 50
dr.Prokhor: posts the ante 50
ximenes.cr: posts the ante 50
Bastardo Q9: posts small blind 300
1DMITRYSPb1: posts big blind 600
*** HOLE CARDS ***
Dealt to dfcastro.net [5d Kh]
llleopold: folds 
dfcastro.net: folds 
91_EL_DIABLO: folds 
kesia545: calls 600
dr.Prokhor: folds 
ximenes.cr: folds 
worf1k: folds 
Bastardo Q9: calls 300
1DMITRYSPb1: checks 
*** FLOP *** [Kd Qd As]
Bastardo Q9: checks 
1DMITRYSPb1: checks 
kesia545: checks 
*** TURN *** [Kd Qd As] [8h]
Bastardo Q9: bets 1200
1DMITRYSPb1: folds 
kesia545: calls 1200
*** RIVER *** [Kd Qd As 8h] [2c]
Bastardo Q9: checks 
kesia545: bets 1200
Bastardo Q9: folds 
Uncalled bet (1200) returned to kesia545
kesia545 collected 4650 from pot
kesia545: doesn't show hand 
*** SUMMARY ***
Total pot 4650 | Rake 0 
Board [Kd Qd As 8h 2c]
Seat 1: worf1k (button) folded before Flop (didn't bet)
Seat 2: Bastardo Q9 (small blind) folded on the River
Seat 3: 1DMITRYSPb1 (big blind) folded on the Turn
Seat 4: llleopold folded before Flop (didn't bet)
Seat 5: dfcastro.net folded before Flop (didn't bet)
Seat 6: 91_EL_DIABLO folded before Flop (didn't bet)
Seat 7: kesia545 collected (4650)
Seat 8: dr.Prokhor folded before Flop (didn't bet)
Seat 9: ximenes.cr folded before Flop (didn't bet)



PokerStars Hand #98798816719: Tournament #734961465, $0.23+$0.02 USD Hold'em No Limit - Level X (300/600) - 2013/05/19 11:33:42 BRT [2013/05/19 10:33:42 ET]
Table '734961465 2' 9-max Seat #2 is the button
Seat 1: worf1k (4780 in chips) 
Seat 2: Bastardo Q9 (8400 in chips) 
Seat 3: 1DMITRYSPb1 (3867 in chips) 
Seat 4: llleopold (4557 in chips) 
Seat 5: dfcastro.net (9474 in chips) 
Seat 6: 91_EL_DIABLO (4885 in chips) 
Seat 7: kesia545 (17684 in chips) 
Seat 8: dr.Prokhor (11530 in chips) 
Seat 9: ximenes.cr (2323 in chips) 
worf1k: posts the ante 50
Bastardo Q9: posts the ante 50
1DMITRYSPb1: posts the ante 50
llleopold: posts the ante 50
dfcastro.net: posts the ante 50
91_EL_DIABLO: posts the ante 50
kesia545: posts the ante 50
dr.Prokhor: posts the ante 50
ximenes.cr: posts the ante 50
1DMITRYSPb1: posts small blind 300
llleopold: posts big blind 600
*** HOLE CARDS ***
Dealt to dfcastro.net [2d 4h]
dfcastro.net: folds 
91_EL_DIABLO: folds 
kesia545: calls 600
dr.Prokhor: folds 
ximenes.cr: folds 
worf1k: folds 
Bastardo Q9: folds 
1DMITRYSPb1: folds 
llleopold: checks 
*** FLOP *** [As 9h Kc]
llleopold: checks 
kesia545: checks 
*** TURN *** [As 9h Kc] [Ah]
llleopold: checks 
kesia545: checks 
*** RIVER *** [As 9h Kc Ah] [4s]
llleopold: checks 
kesia545: checks 
*** SHOW DOWN ***
llleopold: shows [Qd 9c] (two pair, Aces and Nines)
kesia545: mucks hand 
llleopold collected 1950 from pot
*** SUMMARY ***
Total pot 1950 | Rake 0 
Board [As 9h Kc Ah 4s]
Seat 1: worf1k folded before Flop (didn't bet)
Seat 2: Bastardo Q9 (button) folded before Flop (didn't bet)
Seat 3: 1DMITRYSPb1 (small blind) folded before Flop
Seat 4: llleopold (big blind) showed [Qd 9c] and won (1950) with two pair, Aces and Nines
Seat 5: dfcastro.net folded before Flop (didn't bet)
Seat 6: 91_EL_DIABLO folded before Flop (didn't bet)
Seat 7: kesia545 mucked [Qs 5s]
Seat 8: dr.Prokhor folded before Flop (didn't bet)
Seat 9: ximenes.cr folded before Flop (didn't bet)



PokerStars Hand #98798864381: Tournament #734961465, $0.23+$0.02 USD Hold'em No Limit - Level X (300/600) - 2013/05/19 11:34:47 BRT [2013/05/19 10:34:47 ET]
Table '734961465 2' 9-max Seat #3 is the button
Seat 1: worf1k (4730 in chips) 
Seat 2: Bastardo Q9 (8350 in chips) 
Seat 3: 1DMITRYSPb1 (3517 in chips) 
Seat 4: llleopold (5857 in chips) 
Seat 5: dfcastro.net (9424 in chips) 
Seat 6: 91_EL_DIABLO (4835 in chips) 
Seat 7: kesia545 (17034 in chips) 
Seat 8: dr.Prokhor (11480 in chips) 
Seat 9: ximenes.cr (2273 in chips) 
worf1k: posts the ante 50
Bastardo Q9: posts the ante 50
1DMITRYSPb1: posts the ante 50
llleopold: posts the ante 50
dfcastro.net: posts the ante 50
91_EL_DIABLO: posts the ante 50
kesia545: posts the ante 50
dr.Prokhor: posts the ante 50
ximenes.cr: posts the ante 50
llleopold: posts small blind 300
dfcastro.net: posts big blind 600
*** HOLE CARDS ***
Dealt to dfcastro.net [3c 9c]
91_EL_DIABLO: folds 
kesia545: folds 
dr.Prokhor: folds 
ximenes.cr: folds 
worf1k: folds 
Bastardo Q9: folds 
1DMITRYSPb1: folds 
llleopold: raises 5207 to 5807 and is all-in
dfcastro.net: folds 
Uncalled bet (5207) returned to llleopold
llleopold collected 1650 from pot
llleopold: doesn't show hand 
*** SUMMARY ***
Total pot 1650 | Rake 0 
Seat 1: worf1k folded before Flop (didn't bet)
Seat 2: Bastardo Q9 folded before Flop (didn't bet)
Seat 3: 1DMITRYSPb1 (button) folded before Flop (didn't bet)
Seat 4: llleopold (small blind) collected (1650)
Seat 5: dfcastro.net (big blind) folded before Flop
Seat 6: 91_EL_DIABLO folded before Flop (didn't bet)
Seat 7: kesia545 folded before Flop (didn't bet)
Seat 8: dr.Prokhor folded before Flop (didn't bet)
Seat 9: ximenes.cr folded before Flop (didn't bet)



PokerStars Hand #98798888207: Tournament #734961465, $0.23+$0.02 USD Hold'em No Limit - Level X (300/600) - 2013/05/19 11:35:19 BRT [2013/05/19 10:35:19 ET]
Table '734961465 2' 9-max Seat #4 is the button
Seat 1: worf1k (4680 in chips) 
Seat 2: Bastardo Q9 (8300 in chips) 
Seat 3: 1DMITRYSPb1 (3467 in chips) 
Seat 4: llleopold (6857 in chips) 
Seat 5: dfcastro.net (8774 in chips) 
Seat 6: 91_EL_DIABLO (4785 in chips) 
Seat 7: kesia545 (16984 in chips) 
Seat 8: dr.Prokhor (11430 in chips) 
Seat 9: ximenes.cr (2223 in chips) 
worf1k: posts the ante 50
Bastardo Q9: posts the ante 50
1DMITRYSPb1: posts the ante 50
llleopold: posts the ante 50
dfcastro.net: posts the ante 50
91_EL_DIABLO: posts the ante 50
kesia545: posts the ante 50
dr.Prokhor: posts the ante 50
ximenes.cr: posts the ante 50
dfcastro.net: posts small blind 300
91_EL_DIABLO: posts big blind 600
*** HOLE CARDS ***
Dealt to dfcastro.net [Kd Qc]
kesia545: folds 
dr.Prokhor: folds 
ximenes.cr: folds 
worf1k: folds 
Bastardo Q9: folds 
1DMITRYSPb1: folds 
llleopold: raises 642 to 1242
dfcastro.net: folds 
91_EL_DIABLO: folds 
Uncalled bet (642) returned to llleopold
llleopold collected 1950 from pot
llleopold: doesn't show hand 
*** SUMMARY ***
Total pot 1950 | Rake 0 
Seat 1: worf1k folded before Flop (didn't bet)
Seat 2: Bastardo Q9 folded before Flop (didn't bet)
Seat 3: 1DMITRYSPb1 folded before Flop (didn't bet)
Seat 4: llleopold (button) collected (1950)
Seat 5: dfcastro.net (small blind) folded before Flop
Seat 6: 91_EL_DIABLO (big blind) folded before Flop
Seat 7: kesia545 folded before Flop (didn't bet)
Seat 8: dr.Prokhor folded before Flop (didn't bet)
Seat 9: ximenes.cr folded before Flop (didn't bet)



PokerStars Hand #98798916620: Tournament #734961465, $0.23+$0.02 USD Hold'em No Limit - Level X (300/600) - 2013/05/19 11:35:58 BRT [2013/05/19 10:35:58 ET]
Table '734961465 2' 9-max Seat #5 is the button
Seat 1: worf1k (4630 in chips) 
Seat 2: Bastardo Q9 (8250 in chips) 
Seat 3: 1DMITRYSPb1 (3417 in chips) 
Seat 4: llleopold (8157 in chips) 
Seat 5: dfcastro.net (8424 in chips) 
Seat 6: 91_EL_DIABLO (4135 in chips) 
Seat 7: kesia545 (16934 in chips) 
Seat 8: dr.Prokhor (11380 in chips) 
Seat 9: ximenes.cr (2173 in chips) 
worf1k: posts the ante 50
Bastardo Q9: posts the ante 50
1DMITRYSPb1: posts the ante 50
llleopold: posts the ante 50
dfcastro.net: posts the ante 50
91_EL_DIABLO: posts the ante 50
kesia545: posts the ante 50
dr.Prokhor: posts the ante 50
ximenes.cr: posts the ante 50
91_EL_DIABLO: posts small blind 300
kesia545: posts big blind 600
*** HOLE CARDS ***
Dealt to dfcastro.net [Ks 8h]
dr.Prokhor: folds 
ximenes.cr: folds 
worf1k: folds 
Bastardo Q9: folds 
1DMITRYSPb1: folds 
llleopold: folds 
dfcastro.net: folds 
91_EL_DIABLO: folds 
Uncalled bet (300) returned to kesia545
kesia545 collected 1050 from pot
kesia545: doesn't show hand 
*** SUMMARY ***
Total pot 1050 | Rake 0 
Seat 1: worf1k folded before Flop (didn't bet)
Seat 2: Bastardo Q9 folded before Flop (didn't bet)
Seat 3: 1DMITRYSPb1 folded before Flop (didn't bet)
Seat 4: llleopold folded before Flop (didn't bet)
Seat 5: dfcastro.net (button) folded before Flop (didn't bet)
Seat 6: 91_EL_DIABLO (small blind) folded before Flop
Seat 7: kesia545 (big blind) collected (1050)
Seat 8: dr.Prokhor folded before Flop (didn't bet)
Seat 9: ximenes.cr folded before Flop (didn't bet)



PokerStars Hand #98798943448: Tournament #734961465, $0.23+$0.02 USD Hold'em No Limit - Level X (300/600) - 2013/05/19 11:36:35 BRT [2013/05/19 10:36:35 ET]
Table '734961465 2' 9-max Seat #6 is the button
Seat 1: worf1k (4580 in chips) 
Seat 2: Bastardo Q9 (8200 in chips) 
Seat 3: 1DMITRYSPb1 (3367 in chips) 
Seat 4: llleopold (8107 in chips) 
Seat 5: dfcastro.net (8374 in chips) 
Seat 6: 91_EL_DIABLO (3785 in chips) 
Seat 7: kesia545 (17634 in chips) 
Seat 8: dr.Prokhor (11330 in chips) 
Seat 9: ximenes.cr (2123 in chips) 
worf1k: posts the ante 50
Bastardo Q9: posts the ante 50
1DMITRYSPb1: posts the ante 50
llleopold: posts the ante 50
dfcastro.net: posts the ante 50
91_EL_DIABLO: posts the ante 50
kesia545: posts the ante 50
dr.Prokhor: posts the ante 50
ximenes.cr: posts the ante 50
kesia545: posts small blind 300
dr.Prokhor: posts big blind 600
*** HOLE CARDS ***
Dealt to dfcastro.net [Kd 6d]
ximenes.cr: folds 
worf1k: folds 
Bastardo Q9: folds 
1DMITRYSPb1: folds 
llleopold: folds 
dfcastro.net: folds 
91_EL_DIABLO: calls 600
kesia545: folds 
dr.Prokhor: checks 
*** FLOP *** [Kc Qc 5d]
dr.Prokhor: checks 
91_EL_DIABLO: checks 
*** TURN *** [Kc Qc 5d] [5s]
dr.Prokhor: checks 
91_EL_DIABLO: bets 600
dr.Prokhor: folds 
Uncalled bet (600) returned to 91_EL_DIABLO
91_EL_DIABLO collected 1950 from pot
91_EL_DIABLO: doesn't show hand 
*** SUMMARY ***
Total pot 1950 | Rake 0 
Board [Kc Qc 5d 5s]
Seat 1: worf1k folded before Flop (didn't bet)
Seat 2: Bastardo Q9 folded before Flop (didn't bet)
Seat 3: 1DMITRYSPb1 folded before Flop (didn't bet)
Seat 4: llleopold folded before Flop (didn't bet)
Seat 5: dfcastro.net folded before Flop (didn't bet)
Seat 6: 91_EL_DIABLO (button) collected (1950)
Seat 7: kesia545 (small blind) folded before Flop
Seat 8: dr.Prokhor (big blind) folded on the Turn
Seat 9: ximenes.cr folded before Flop (didn't bet)



PokerStars Hand #98798986230: Tournament #734961465, $0.23+$0.02 USD Hold'em No Limit - Level X (300/600) - 2013/05/19 11:37:34 BRT [2013/05/19 10:37:34 ET]
Table '734961465 2' 9-max Seat #7 is the button
Seat 1: worf1k (4530 in chips) 
Seat 2: Bastardo Q9 (8150 in chips) 
Seat 3: 1DMITRYSPb1 (3317 in chips) 
Seat 4: llleopold (8057 in chips) 
Seat 5: dfcastro.net (8324 in chips) 
Seat 6: 91_EL_DIABLO (5085 in chips) 
Seat 7: kesia545 (17284 in chips) 
Seat 8: dr.Prokhor (10680 in chips) 
Seat 9: ximenes.cr (2073 in chips) 
worf1k: posts the ante 50
Bastardo Q9: posts the ante 50
1DMITRYSPb1: posts the ante 50
llleopold: posts the ante 50
dfcastro.net: posts the ante 50
91_EL_DIABLO: posts the ante 50
kesia545: posts the ante 50
dr.Prokhor: posts the ante 50
ximenes.cr: posts the ante 50
dr.Prokhor: posts small blind 300
ximenes.cr: posts big blind 600
*** HOLE CARDS ***
Dealt to dfcastro.net [Th 2d]
worf1k: folds 
Bastardo Q9: folds 
1DMITRYSPb1: folds 
llleopold: folds 
dfcastro.net: folds 
91_EL_DIABLO: folds 
kesia545: folds 
dr.Prokhor: folds 
Uncalled bet (300) returned to ximenes.cr
ximenes.cr collected 1050 from pot
ximenes.cr: doesn't show hand 
*** SUMMARY ***
Total pot 1050 | Rake 0 
Seat 1: worf1k folded before Flop (didn't bet)
Seat 2: Bastardo Q9 folded before Flop (didn't bet)
Seat 3: 1DMITRYSPb1 folded before Flop (didn't bet)
Seat 4: llleopold folded before Flop (didn't bet)
Seat 5: dfcastro.net folded before Flop (didn't bet)
Seat 6: 91_EL_DIABLO folded before Flop (didn't bet)
Seat 7: kesia545 (button) folded before Flop (didn't bet)
Seat 8: dr.Prokhor (small blind) folded before Flop
Seat 9: ximenes.cr (big blind) collected (1050)



PokerStars Hand #98799008489: Tournament #734961465, $0.23+$0.02 USD Hold'em No Limit - Level XI (400/800) - 2013/05/19 11:38:05 BRT [2013/05/19 10:38:05 ET]
Table '734961465 2' 9-max Seat #8 is the button
Seat 1: worf1k (4480 in chips) 
Seat 2: Bastardo Q9 (8100 in chips) 
Seat 3: 1DMITRYSPb1 (3267 in chips) 
Seat 4: llleopold (8007 in chips) 
Seat 5: dfcastro.net (8274 in chips) 
Seat 6: 91_EL_DIABLO (5035 in chips) 
Seat 7: kesia545 (17234 in chips) 
Seat 8: dr.Prokhor (10330 in chips) 
Seat 9: ximenes.cr (2773 in chips) 
worf1k: posts the ante 50
Bastardo Q9: posts the ante 50
1DMITRYSPb1: posts the ante 50
llleopold: posts the ante 50
dfcastro.net: posts the ante 50
91_EL_DIABLO: posts the ante 50
kesia545: posts the ante 50
dr.Prokhor: posts the ante 50
ximenes.cr: posts the ante 50
ximenes.cr: posts small blind 400
worf1k: posts big blind 800
*** HOLE CARDS ***
Dealt to dfcastro.net [7d 8d]
Bastardo Q9: folds 
1DMITRYSPb1: folds 
llleopold: folds 
dfcastro.net: folds 
91_EL_DIABLO: raises 800 to 1600
kesia545: folds 
dr.Prokhor: folds 
ximenes.cr: folds 
worf1k: folds 
Uncalled bet (800) returned to 91_EL_DIABLO
91_EL_DIABLO collected 2450 from pot
91_EL_DIABLO: doesn't show hand 
*** SUMMARY ***
Total pot 2450 | Rake 0 
Seat 1: worf1k (big blind) folded before Flop
Seat 2: Bastardo Q9 folded before Flop (didn't bet)
Seat 3: 1DMITRYSPb1 folded before Flop (didn't bet)
Seat 4: llleopold folded before Flop (didn't bet)
Seat 5: dfcastro.net folded before Flop (didn't bet)
Seat 6: 91_EL_DIABLO collected (2450)
Seat 7: kesia545 folded before Flop (didn't bet)
Seat 8: dr.Prokhor (button) folded before Flop (didn't bet)
Seat 9: ximenes.cr (small blind) folded before Flop



PokerStars Hand #98799025292: Tournament #734961465, $0.23+$0.02 USD Hold'em No Limit - Level XI (400/800) - 2013/05/19 11:38:28 BRT [2013/05/19 10:38:28 ET]
Table '734961465 2' 9-max Seat #9 is the button
Seat 1: worf1k (3630 in chips) 
Seat 2: Bastardo Q9 (8050 in chips) 
Seat 3: 1DMITRYSPb1 (3217 in chips) 
Seat 4: llleopold (7957 in chips) 
Seat 5: dfcastro.net (8224 in chips) 
Seat 6: 91_EL_DIABLO (6635 in chips) 
Seat 7: kesia545 (17184 in chips) 
Seat 8: dr.Prokhor (10280 in chips) 
Seat 9: ximenes.cr (2323 in chips) 
worf1k: posts the ante 50
Bastardo Q9: posts the ante 50
1DMITRYSPb1: posts the ante 50
llleopold: posts the ante 50
dfcastro.net: posts the ante 50
91_EL_DIABLO: posts the ante 50
kesia545: posts the ante 50
dr.Prokhor: posts the ante 50
ximenes.cr: posts the ante 50
worf1k: posts small blind 400
Bastardo Q9: posts big blind 800
*** HOLE CARDS ***
Dealt to dfcastro.net [Qc Qh]
1DMITRYSPb1: folds 
llleopold: folds 
dfcastro.net: raises 960 to 1760
91_EL_DIABLO: folds 
kesia545: folds 
dr.Prokhor: folds 
ximenes.cr: folds 
worf1k: folds 
Bastardo Q9: folds 
Uncalled bet (960) returned to dfcastro.net
dfcastro.net collected 2450 from pot
dfcastro.net: doesn't show hand 
*** SUMMARY ***
Total pot 2450 | Rake 0 
Seat 1: worf1k (small blind) folded before Flop
Seat 2: Bastardo Q9 (big blind) folded before Flop
Seat 3: 1DMITRYSPb1 folded before Flop (didn't bet)
Seat 4: llleopold folded before Flop (didn't bet)
Seat 5: dfcastro.net collected (2450)
Seat 6: 91_EL_DIABLO folded before Flop (didn't bet)
Seat 7: kesia545 folded before Flop (didn't bet)
Seat 8: dr.Prokhor folded before Flop (didn't bet)
Seat 9: ximenes.cr (button) folded before Flop (didn't bet)



PokerStars Hand #98799048997: Tournament #734961465, $0.23+$0.02 USD Hold'em No Limit - Level XI (400/800) - 2013/05/19 11:39:01 BRT [2013/05/19 10:39:01 ET]
Table '734961465 2' 9-max Seat #1 is the button
Seat 1: worf1k (3180 in chips) 
Seat 2: Bastardo Q9 (7200 in chips) 
Seat 3: 1DMITRYSPb1 (3167 in chips) 
Seat 4: llleopold (7907 in chips) 
Seat 5: dfcastro.net (9824 in chips) 
Seat 6: 91_EL_DIABLO (6585 in chips) 
Seat 7: kesia545 (17134 in chips) 
Seat 8: dr.Prokhor (10230 in chips) 
Seat 9: ximenes.cr (2273 in chips) 
worf1k: posts the ante 50
Bastardo Q9: posts the ante 50
1DMITRYSPb1: posts the ante 50
llleopold: posts the ante 50
dfcastro.net: posts the ante 50
91_EL_DIABLO: posts the ante 50
kesia545: posts the ante 50
dr.Prokhor: posts the ante 50
ximenes.cr: posts the ante 50
Bastardo Q9: posts small blind 400
1DMITRYSPb1: posts big blind 800
*** HOLE CARDS ***
Dealt to dfcastro.net [Tc Qd]
llleopold: folds 
dfcastro.net: folds 
91_EL_DIABLO: raises 5735 to 6535 and is all-in
kesia545: folds 
dr.Prokhor: folds 
ximenes.cr: calls 2223 and is all-in
worf1k: folds 
Bastardo Q9: folds 
1DMITRYSPb1: folds 
Uncalled bet (4312) returned to 91_EL_DIABLO
*** FLOP *** [Kh 7h Ac]
*** TURN *** [Kh 7h Ac] [3h]
*** RIVER *** [Kh 7h Ac 3h] [4d]
*** SHOW DOWN ***
91_EL_DIABLO: shows [As 9d] (a pair of Aces)
ximenes.cr: shows [Ad Qc] (a pair of Aces - King+Queen kicker)
ximenes.cr collected 6096 from pot
*** SUMMARY ***
Total pot 6096 | Rake 0 
Board [Kh 7h Ac 3h 4d]
Seat 1: worf1k (button) folded before Flop (didn't bet)
Seat 2: Bastardo Q9 (small blind) folded before Flop
Seat 3: 1DMITRYSPb1 (big blind) folded before Flop
Seat 4: llleopold folded before Flop (didn't bet)
Seat 5: dfcastro.net folded before Flop (didn't bet)
Seat 6: 91_EL_DIABLO showed [As 9d] and lost with a pair of Aces
Seat 7: kesia545 folded before Flop (didn't bet)
Seat 8: dr.Prokhor folded before Flop (didn't bet)
Seat 9: ximenes.cr showed [Ad Qc] and won (6096) with a pair of Aces



PokerStars Hand #98799069386: Tournament #734961465, $0.23+$0.02 USD Hold'em No Limit - Level XI (400/800) - 2013/05/19 11:39:29 BRT [2013/05/19 10:39:29 ET]
Table '734961465 2' 9-max Seat #2 is the button
Seat 1: worf1k (3130 in chips) 
Seat 2: Bastardo Q9 (6750 in chips) 
Seat 3: 1DMITRYSPb1 (2317 in chips) 
Seat 4: llleopold (7857 in chips) 
Seat 5: dfcastro.net (9774 in chips) 
Seat 6: 91_EL_DIABLO (4312 in chips) 
Seat 7: kesia545 (17084 in chips) 
Seat 8: dr.Prokhor (10180 in chips) 
Seat 9: ximenes.cr (6096 in chips) 
worf1k: posts the ante 50
Bastardo Q9: posts the ante 50
1DMITRYSPb1: posts the ante 50
llleopold: posts the ante 50
dfcastro.net: posts the ante 50
91_EL_DIABLO: posts the ante 50
kesia545: posts the ante 50
dr.Prokhor: posts the ante 50
ximenes.cr: posts the ante 50
1DMITRYSPb1: posts small blind 400
llleopold: posts big blind 800
*** HOLE CARDS ***
Dealt to dfcastro.net [Tc 7c]
dfcastro.net: folds 
91_EL_DIABLO said, "ole allin/"
91_EL_DIABLO: raises 3462 to 4262 and is all-in
kesia545: calls 4262
dr.Prokhor: folds 
ximenes.cr: folds 
worf1k: folds 
Bastardo Q9: folds 
1DMITRYSPb1: folds 
llleopold: folds 
*** FLOP *** [2s Kc Qh]
*** TURN *** [2s Kc Qh] [Ts]
*** RIVER *** [2s Kc Qh Ts] [2c]
*** SHOW DOWN ***
91_EL_DIABLO: shows [As 4h] (a pair of Deuces)
kesia545: shows [6c 6s] (two pair, Sixes and Deuces)
kesia545 collected 10174 from pot
91_EL_DIABLO finished the tournament in 9th place
*** SUMMARY ***
Total pot 10174 | Rake 0 
Board [2s Kc Qh Ts 2c]
Seat 1: worf1k folded before Flop (didn't bet)
Seat 2: Bastardo Q9 (button) folded before Flop (didn't bet)
Seat 3: 1DMITRYSPb1 (small blind) folded before Flop
Seat 4: llleopold (big blind) folded before Flop
Seat 5: dfcastro.net folded before Flop (didn't bet)
Seat 6: 91_EL_DIABLO showed [As 4h] and lost with a pair of Deuces
Seat 7: kesia545 showed [6c 6s] and won (10174) with two pair, Sixes and Deuces
Seat 8: dr.Prokhor folded before Flop (didn't bet)
Seat 9: ximenes.cr folded before Flop (didn't bet)



PokerStars Hand #98799108177: Tournament #734961465, $0.23+$0.02 USD Hold'em No Limit - Level XI (400/800) - 2013/05/19 11:40:23 BRT [2013/05/19 10:40:23 ET]
Table '734961465 2' 9-max Seat #3 is the button
Seat 1: worf1k (3080 in chips) 
Seat 2: Bastardo Q9 (6700 in chips) 
Seat 3: 1DMITRYSPb1 (1867 in chips) 
Seat 4: llleopold (7007 in chips) 
Seat 5: dfcastro.net (9724 in chips) 
Seat 7: kesia545 (22946 in chips) 
Seat 8: dr.Prokhor (10130 in chips) 
Seat 9: ximenes.cr (6046 in chips) 
worf1k: posts the ante 50
Bastardo Q9: posts the ante 50
1DMITRYSPb1: posts the ante 50
llleopold: posts the ante 50
dfcastro.net: posts the ante 50
kesia545: posts the ante 50
dr.Prokhor: posts the ante 50
ximenes.cr: posts the ante 50
llleopold: posts small blind 400
dfcastro.net: posts big blind 800
*** HOLE CARDS ***
Dealt to dfcastro.net [Ts 4d]
kesia545: calls 800
Bastardo Q9 said, "ole bb xD"
dr.Prokhor: folds 
ximenes.cr: folds 
worf1k: folds 
Bastardo Q9: calls 800
1DMITRYSPb1: folds 
llleopold: calls 400
dfcastro.net: checks 
*** FLOP *** [Kc 8c 4c]
llleopold: checks 
dfcastro.net: checks 
kesia545: checks 
Bastardo Q9: checks 
*** TURN *** [Kc 8c 4c] [8d]
llleopold: checks 
dfcastro.net: checks 
kesia545: checks 
Bastardo Q9: checks 
*** RIVER *** [Kc 8c 4c 8d] [2c]
llleopold: checks 
dfcastro.net: checks 
kesia545: checks 
Bastardo Q9: checks 
*** SHOW DOWN ***
llleopold: shows [6c 6s] (a flush, King high)
dfcastro.net: mucks hand 
kesia545: mucks hand 
Bastardo Q9: mucks hand 
llleopold collected 3600 from pot
*** SUMMARY ***
Total pot 3600 | Rake 0 
Board [Kc 8c 4c 8d 2c]
Seat 1: worf1k folded before Flop (didn't bet)
Seat 2: Bastardo Q9 mucked [Qs Jh]
Seat 3: 1DMITRYSPb1 (button) folded before Flop (didn't bet)
Seat 4: llleopold (small blind) showed [6c 6s] and won (3600) with a flush, King high
Seat 5: dfcastro.net (big blind) mucked [Ts 4d]
Seat 7: kesia545 mucked [6d 7d]
Seat 8: dr.Prokhor folded before Flop (didn't bet)
Seat 9: ximenes.cr folded before Flop (didn't bet)



PokerStars Hand #98799149953: Tournament #734961465, $0.23+$0.02 USD Hold'em No Limit - Level XI (400/800) - 2013/05/19 11:41:21 BRT [2013/05/19 10:41:21 ET]
Table '734961465 2' 9-max Seat #4 is the button
Seat 1: worf1k (3030 in chips) 
Seat 2: Bastardo Q9 (5850 in chips) 
Seat 3: 1DMITRYSPb1 (1817 in chips) 
Seat 4: llleopold (9757 in chips) 
Seat 5: dfcastro.net (8874 in chips) 
Seat 7: kesia545 (22096 in chips) 
Seat 8: dr.Prokhor (10080 in chips) 
Seat 9: ximenes.cr (5996 in chips) 
worf1k: posts the ante 50
Bastardo Q9: posts the ante 50
1DMITRYSPb1: posts the ante 50
llleopold: posts the ante 50
dfcastro.net: posts the ante 50
kesia545: posts the ante 50
dr.Prokhor: posts the ante 50
ximenes.cr: posts the ante 50
dfcastro.net: posts small blind 400
kesia545: posts big blind 800
*** HOLE CARDS ***
Dealt to dfcastro.net [Ah 4h]
dr.Prokhor: folds 
ximenes.cr: calls 800
worf1k: folds 
Bastardo Q9: folds 
1DMITRYSPb1: raises 967 to 1767 and is all-in
llleopold: folds 
dfcastro.net: folds 
kesia545: folds 
ximenes.cr: calls 967
*** FLOP *** [Kd 4c Kc]
*** TURN *** [Kd 4c Kc] [3h]
*** RIVER *** [Kd 4c Kc 3h] [7s]
*** SHOW DOWN ***
ximenes.cr: shows [8d 8h] (two pair, Kings and Eights)
1DMITRYSPb1: shows [Jc Jh] (two pair, Kings and Jacks)
1DMITRYSPb1 collected 5134 from pot
*** SUMMARY ***
Total pot 5134 | Rake 0 
Board [Kd 4c Kc 3h 7s]
Seat 1: worf1k folded before Flop (didn't bet)
Seat 2: Bastardo Q9 folded before Flop (didn't bet)
Seat 3: 1DMITRYSPb1 showed [Jc Jh] and won (5134) with two pair, Kings and Jacks
Seat 4: llleopold (button) folded before Flop (didn't bet)
Seat 5: dfcastro.net (small blind) folded before Flop
Seat 7: kesia545 (big blind) folded before Flop
Seat 8: dr.Prokhor folded before Flop (didn't bet)
Seat 9: ximenes.cr showed [8d 8h] and lost with two pair, Kings and Eights



PokerStars Hand #98799174699: Tournament #734961465, $0.23+$0.02 USD Hold'em No Limit - Level XI (400/800) - 2013/05/19 11:41:55 BRT [2013/05/19 10:41:55 ET]
Table '734961465 2' 9-max Seat #5 is the button
Seat 1: worf1k (2980 in chips) 
Seat 2: Bastardo Q9 (5800 in chips) 
Seat 3: 1DMITRYSPb1 (5134 in chips) 
Seat 4: llleopold (9707 in chips) 
Seat 5: dfcastro.net (8424 in chips) 
Seat 7: kesia545 (21246 in chips) 
Seat 8: dr.Prokhor (10030 in chips) 
Seat 9: ximenes.cr (4179 in chips) 
worf1k: posts the ante 50
Bastardo Q9: posts the ante 50
1DMITRYSPb1: posts the ante 50
llleopold: posts the ante 50
dfcastro.net: posts the ante 50
kesia545: posts the ante 50
dr.Prokhor: posts the ante 50
ximenes.cr: posts the ante 50
kesia545: posts small blind 400
dr.Prokhor: posts big blind 800
*** HOLE CARDS ***
Dealt to dfcastro.net [Js 8c]
ximenes.cr: folds 
worf1k: raises 2130 to 2930 and is all-in
Bastardo Q9: folds 
1DMITRYSPb1: folds 
llleopold: folds 
dfcastro.net: folds 
kesia545: folds 
dr.Prokhor: folds 
Uncalled bet (2130) returned to worf1k
worf1k collected 2400 from pot
*** SUMMARY ***
Total pot 2400 | Rake 0 
Seat 1: worf1k collected (2400)
Seat 2: Bastardo Q9 folded before Flop (didn't bet)
Seat 3: 1DMITRYSPb1 folded before Flop (didn't bet)
Seat 4: llleopold folded before Flop (didn't bet)
Seat 5: dfcastro.net (button) folded before Flop (didn't bet)
Seat 7: kesia545 (small blind) folded before Flop
Seat 8: dr.Prokhor (big blind) folded before Flop
Seat 9: ximenes.cr folded before Flop (didn't bet)



PokerStars Hand #98799205183: Tournament #734961465, $0.23+$0.02 USD Hold'em No Limit - Level XI (400/800) - 2013/05/19 11:42:37 BRT [2013/05/19 10:42:37 ET]
Table '734961465 2' 9-max Seat #7 is the button
Seat 1: worf1k (4530 in chips) 
Seat 2: Bastardo Q9 (5750 in chips) 
Seat 3: 1DMITRYSPb1 (5084 in chips) 
Seat 4: llleopold (9657 in chips) 
Seat 5: dfcastro.net (8374 in chips) 
Seat 7: kesia545 (20796 in chips) 
Seat 8: dr.Prokhor (9180 in chips) 
Seat 9: ximenes.cr (4129 in chips) 
worf1k: posts the ante 50
Bastardo Q9: posts the ante 50
1DMITRYSPb1: posts the ante 50
llleopold: posts the ante 50
dfcastro.net: posts the ante 50
kesia545: posts the ante 50
dr.Prokhor: posts the ante 50
ximenes.cr: posts the ante 50
dr.Prokhor: posts small blind 400
ximenes.cr: posts big blind 800
*** HOLE CARDS ***
Dealt to dfcastro.net [Ks 6d]
worf1k: folds 
Bastardo Q9: folds 
1DMITRYSPb1: folds 
llleopold: folds 
dfcastro.net: folds 
kesia545: calls 800
dr.Prokhor: folds 
ximenes.cr is disconnected 
ximenes.cr is connected 
ximenes.cr: checks 
*** FLOP *** [Ts Qh Ac]
ximenes.cr: checks 
kesia545: checks 
*** TURN *** [Ts Qh Ac] [As]
ximenes.cr: checks 
kesia545: checks 
*** RIVER *** [Ts Qh Ac As] [7d]
ximenes.cr: checks 
kesia545: checks 
*** SHOW DOWN ***
ximenes.cr: shows [5s Jc] (a pair of Aces)
kesia545: shows [9c Kc] (a pair of Aces - King kicker)
kesia545 collected 2400 from pot
*** SUMMARY ***
Total pot 2400 | Rake 0 
Board [Ts Qh Ac As 7d]
Seat 1: worf1k folded before Flop (didn't bet)
Seat 2: Bastardo Q9 folded before Flop (didn't bet)
Seat 3: 1DMITRYSPb1 folded before Flop (didn't bet)
Seat 4: llleopold folded before Flop (didn't bet)
Seat 5: dfcastro.net folded before Flop (didn't bet)
Seat 7: kesia545 (button) showed [9c Kc] and won (2400) with a pair of Aces
Seat 8: dr.Prokhor (small blind) folded before Flop
Seat 9: ximenes.cr (big blind) showed [5s Jc] and lost with a pair of Aces



PokerStars Hand #98799256567: Tournament #734961465, $0.23+$0.02 USD Hold'em No Limit - Level XI (400/800) - 2013/05/19 11:43:48 BRT [2013/05/19 10:43:48 ET]
Table '734961465 2' 9-max Seat #8 is the button
Seat 1: worf1k (4480 in chips) 
Seat 2: Bastardo Q9 (5700 in chips) 
Seat 3: 1DMITRYSPb1 (5034 in chips) 
Seat 4: llleopold (9607 in chips) 
Seat 5: dfcastro.net (8324 in chips) 
Seat 7: kesia545 (22346 in chips) 
Seat 8: dr.Prokhor (8730 in chips) 
Seat 9: ximenes.cr (3279 in chips) 
worf1k: posts the ante 50
Bastardo Q9: posts the ante 50
1DMITRYSPb1: posts the ante 50
llleopold: posts the ante 50
dfcastro.net: posts the ante 50
kesia545: posts the ante 50
dr.Prokhor: posts the ante 50
ximenes.cr: posts the ante 50
ximenes.cr: posts small blind 400
worf1k: posts big blind 800
*** HOLE CARDS ***
Dealt to dfcastro.net [Ks 7s]
Bastardo Q9: folds 
1DMITRYSPb1: folds 
llleopold: folds 
dfcastro.net: folds 
kesia545: folds 
dr.Prokhor: folds 
ximenes.cr: folds 
Uncalled bet (400) returned to worf1k
worf1k collected 1200 from pot
*** SUMMARY ***
Total pot 1200 | Rake 0 
Seat 1: worf1k (big blind) collected (1200)
Seat 2: Bastardo Q9 folded before Flop (didn't bet)
Seat 3: 1DMITRYSPb1 folded before Flop (didn't bet)
Seat 4: llleopold folded before Flop (didn't bet)
Seat 5: dfcastro.net folded before Flop (didn't bet)
Seat 7: kesia545 folded before Flop (didn't bet)
Seat 8: dr.Prokhor (button) folded before Flop (didn't bet)
Seat 9: ximenes.cr (small blind) folded before Flop



PokerStars Hand #98799274947: Tournament #734961465, $0.23+$0.02 USD Hold'em No Limit - Level XI (400/800) - 2013/05/19 11:44:13 BRT [2013/05/19 10:44:13 ET]
Table '734961465 2' 9-max Seat #9 is the button
Seat 1: worf1k (5230 in chips) 
Seat 2: Bastardo Q9 (5650 in chips) 
Seat 3: 1DMITRYSPb1 (4984 in chips) 
Seat 4: llleopold (9557 in chips) 
Seat 5: dfcastro.net (8274 in chips) 
Seat 7: kesia545 (22296 in chips) 
Seat 8: dr.Prokhor (8680 in chips) 
Seat 9: ximenes.cr (2829 in chips) 
worf1k: posts the ante 50
Bastardo Q9: posts the ante 50
1DMITRYSPb1: posts the ante 50
llleopold: posts the ante 50
dfcastro.net: posts the ante 50
kesia545: posts the ante 50
dr.Prokhor: posts the ante 50
ximenes.cr: posts the ante 50
worf1k: posts small blind 400
Bastardo Q9: posts big blind 800
*** HOLE CARDS ***
Dealt to dfcastro.net [Tc Jh]
1DMITRYSPb1: folds 
llleopold: folds 
dfcastro.net: folds 
kesia545: folds 
dr.Prokhor: folds 
ximenes.cr is connected 
ximenes.cr: folds 
worf1k: raises 4380 to 5180 and is all-in
Bastardo Q9: folds 
Uncalled bet (4380) returned to worf1k
worf1k collected 2000 from pot
*** SUMMARY ***
Total pot 2000 | Rake 0 
Seat 1: worf1k (small blind) collected (2000)
Seat 2: Bastardo Q9 (big blind) folded before Flop
Seat 3: 1DMITRYSPb1 folded before Flop (didn't bet)
Seat 4: llleopold folded before Flop (didn't bet)
Seat 5: dfcastro.net folded before Flop (didn't bet)
Seat 7: kesia545 folded before Flop (didn't bet)
Seat 8: dr.Prokhor folded before Flop (didn't bet)
Seat 9: ximenes.cr (button) folded before Flop (didn't bet)



PokerStars Hand #98799290982: Tournament #734961465, $0.23+$0.02 USD Hold'em No Limit - Level XI (400/800) - 2013/05/19 11:44:35 BRT [2013/05/19 10:44:35 ET]
Table '734961465 2' 9-max Seat #1 is the button
Seat 1: worf1k (6380 in chips) 
Seat 2: Bastardo Q9 (4800 in chips) 
Seat 3: 1DMITRYSPb1 (4934 in chips) 
Seat 4: llleopold (9507 in chips) 
Seat 5: dfcastro.net (8224 in chips) 
Seat 7: kesia545 (22246 in chips) 
Seat 8: dr.Prokhor (8630 in chips) 
Seat 9: ximenes.cr (2779 in chips) 
worf1k: posts the ante 50
Bastardo Q9: posts the ante 50
1DMITRYSPb1: posts the ante 50
llleopold: posts the ante 50
dfcastro.net: posts the ante 50
kesia545: posts the ante 50
dr.Prokhor: posts the ante 50
ximenes.cr: posts the ante 50
Bastardo Q9: posts small blind 400
1DMITRYSPb1: posts big blind 800
*** HOLE CARDS ***
Dealt to dfcastro.net [5c 2s]
llleopold: folds 
dfcastro.net: folds 
kesia545: calls 800
dr.Prokhor: folds 
ximenes.cr: folds 
worf1k: folds 
Bastardo Q9: calls 400
1DMITRYSPb1: checks 
*** FLOP *** [8d Td Qd]
Bastardo Q9: checks 
1DMITRYSPb1: checks 
kesia545: checks 
*** TURN *** [8d Td Qd] [5d]
Bastardo Q9: checks 
1DMITRYSPb1: checks 
kesia545: checks 
*** RIVER *** [8d Td Qd 5d] [3d]
Bastardo Q9: checks 
1DMITRYSPb1: checks 
kesia545: checks 
*** SHOW DOWN ***
Bastardo Q9: shows [8s Ks] (a flush, Queen high)
1DMITRYSPb1: shows [7c 2c] (a flush, Queen high)
kesia545: shows [3s 3c] (a flush, Queen high)
Bastardo Q9 collected 934 from pot
1DMITRYSPb1 collected 933 from pot
kesia545 collected 933 from pot
*** SUMMARY ***
Total pot 2800 | Rake 0 
Board [8d Td Qd 5d 3d]
Seat 1: worf1k (button) folded before Flop (didn't bet)
Seat 2: Bastardo Q9 (small blind) showed [8s Ks] and won (934) with a flush, Queen high
Seat 3: 1DMITRYSPb1 (big blind) showed [7c 2c] and won (933) with a flush, Queen high
Seat 4: llleopold folded before Flop (didn't bet)
Seat 5: dfcastro.net folded before Flop (didn't bet)
Seat 7: kesia545 showed [3s 3c] and won (933) with a flush, Queen high
Seat 8: dr.Prokhor folded before Flop (didn't bet)
Seat 9: ximenes.cr folded before Flop (didn't bet)



PokerStars Hand #98799322467: Tournament #734961465, $0.23+$0.02 USD Hold'em No Limit - Level XI (400/800) - 2013/05/19 11:45:18 BRT [2013/05/19 10:45:18 ET]
Table '734961465 2' 9-max Seat #2 is the button
Seat 1: worf1k (6330 in chips) 
Seat 2: Bastardo Q9 (4884 in chips) 
Seat 3: 1DMITRYSPb1 (5017 in chips) 
Seat 4: llleopold (9457 in chips) 
Seat 5: dfcastro.net (8174 in chips) 
Seat 7: kesia545 (22329 in chips) 
Seat 8: dr.Prokhor (8580 in chips) 
Seat 9: ximenes.cr (2729 in chips) 
worf1k: posts the ante 50
Bastardo Q9: posts the ante 50
1DMITRYSPb1: posts the ante 50
llleopold: posts the ante 50
dfcastro.net: posts the ante 50
kesia545: posts the ante 50
dr.Prokhor: posts the ante 50
ximenes.cr: posts the ante 50
1DMITRYSPb1: posts small blind 400
llleopold: posts big blind 800
*** HOLE CARDS ***
Dealt to dfcastro.net [2h Ah]
dfcastro.net: folds 
kesia545: folds 
dr.Prokhor: folds 
ximenes.cr: folds 
worf1k: folds 
Bastardo Q9: folds 
1DMITRYSPb1: raises 4167 to 4967 and is all-in
llleopold: folds 
Uncalled bet (4167) returned to 1DMITRYSPb1
1DMITRYSPb1 collected 2000 from pot
1DMITRYSPb1: doesn't show hand 
*** SUMMARY ***
Total pot 2000 | Rake 0 
Seat 1: worf1k folded before Flop (didn't bet)
Seat 2: Bastardo Q9 (button) folded before Flop (didn't bet)
Seat 3: 1DMITRYSPb1 (small blind) collected (2000)
Seat 4: llleopold (big blind) folded before Flop
Seat 5: dfcastro.net folded before Flop (didn't bet)
Seat 7: kesia545 folded before Flop (didn't bet)
Seat 8: dr.Prokhor folded before Flop (didn't bet)
Seat 9: ximenes.cr folded before Flop (didn't bet)



PokerStars Hand #98799343649: Tournament #734961465, $0.23+$0.02 USD Hold'em No Limit - Level XI (400/800) - 2013/05/19 11:45:47 BRT [2013/05/19 10:45:47 ET]
Table '734961465 2' 9-max Seat #3 is the button
Seat 1: worf1k (6280 in chips) 
Seat 2: Bastardo Q9 (4834 in chips) 
Seat 3: 1DMITRYSPb1 (6167 in chips) 
Seat 4: llleopold (8607 in chips) 
Seat 5: dfcastro.net (8124 in chips) 
Seat 7: kesia545 (22279 in chips) 
Seat 8: dr.Prokhor (8530 in chips) 
Seat 9: ximenes.cr (2679 in chips) 
worf1k: posts the ante 50
Bastardo Q9: posts the ante 50
1DMITRYSPb1: posts the ante 50
llleopold: posts the ante 50
dfcastro.net: posts the ante 50
kesia545: posts the ante 50
dr.Prokhor: posts the ante 50
ximenes.cr: posts the ante 50
llleopold: posts small blind 400
dfcastro.net: posts big blind 800
*** HOLE CARDS ***
Dealt to dfcastro.net [Jd 2c]
kesia545: folds 
dr.Prokhor: folds 
ximenes.cr: folds 
worf1k: raises 5430 to 6230 and is all-in
Bastardo Q9: folds 
1DMITRYSPb1: folds 
llleopold: folds 
dfcastro.net: folds 
Uncalled bet (5430) returned to worf1k
worf1k collected 2400 from pot
*** SUMMARY ***
Total pot 2400 | Rake 0 
Seat 1: worf1k collected (2400)
Seat 2: Bastardo Q9 folded before Flop (didn't bet)
Seat 3: 1DMITRYSPb1 (button) folded before Flop (didn't bet)
Seat 4: llleopold (small blind) folded before Flop
Seat 5: dfcastro.net (big blind) folded before Flop
Seat 7: kesia545 folded before Flop (didn't bet)
Seat 8: dr.Prokhor folded before Flop (didn't bet)
Seat 9: ximenes.cr folded before Flop (didn't bet)



PokerStars Hand #98799360224: Tournament #734961465, $0.23+$0.02 USD Hold'em No Limit - Level XI (400/800) - 2013/05/19 11:46:10 BRT [2013/05/19 10:46:10 ET]
Table '734961465 2' 9-max Seat #4 is the button
Seat 1: worf1k (7830 in chips) 
Seat 2: Bastardo Q9 (4784 in chips) 
Seat 3: 1DMITRYSPb1 (6117 in chips) 
Seat 4: llleopold (8157 in chips) 
Seat 5: dfcastro.net (7274 in chips) 
Seat 7: kesia545 (22229 in chips) 
Seat 8: dr.Prokhor (8480 in chips) 
Seat 9: ximenes.cr (2629 in chips) 
worf1k: posts the ante 50
Bastardo Q9: posts the ante 50
1DMITRYSPb1: posts the ante 50
llleopold: posts the ante 50
dfcastro.net: posts the ante 50
kesia545: posts the ante 50
dr.Prokhor: posts the ante 50
ximenes.cr: posts the ante 50
dfcastro.net: posts small blind 400
kesia545: posts big blind 800
*** HOLE CARDS ***
Dealt to dfcastro.net [4h Td]
dr.Prokhor: folds 
ximenes.cr: folds 
worf1k: folds 
Bastardo Q9: folds 
1DMITRYSPb1: folds 
llleopold: folds 
dfcastro.net: folds 
Uncalled bet (400) returned to kesia545
kesia545 collected 1200 from pot
kesia545: doesn't show hand 
*** SUMMARY ***
Total pot 1200 | Rake 0 
Seat 1: worf1k folded before Flop (didn't bet)
Seat 2: Bastardo Q9 folded before Flop (didn't bet)
Seat 3: 1DMITRYSPb1 folded before Flop (didn't bet)
Seat 4: llleopold (button) folded before Flop (didn't bet)
Seat 5: dfcastro.net (small blind) folded before Flop
Seat 7: kesia545 (big blind) collected (1200)
Seat 8: dr.Prokhor folded before Flop (didn't bet)
Seat 9: ximenes.cr folded before Flop (didn't bet)



PokerStars Hand #98799375716: Tournament #734961465, $0.23+$0.02 USD Hold'em No Limit - Level XI (400/800) - 2013/05/19 11:46:31 BRT [2013/05/19 10:46:31 ET]
Table '734961465 2' 9-max Seat #5 is the button
Seat 1: worf1k (7780 in chips) 
Seat 2: Bastardo Q9 (4734 in chips) 
Seat 3: 1DMITRYSPb1 (6067 in chips) 
Seat 4: llleopold (8107 in chips) 
Seat 5: dfcastro.net (6824 in chips) 
Seat 7: kesia545 (22979 in chips) 
Seat 8: dr.Prokhor (8430 in chips) 
Seat 9: ximenes.cr (2579 in chips) 
worf1k: posts the ante 50
Bastardo Q9: posts the ante 50
1DMITRYSPb1: posts the ante 50
llleopold: posts the ante 50
dfcastro.net: posts the ante 50
kesia545: posts the ante 50
dr.Prokhor: posts the ante 50
ximenes.cr: posts the ante 50
kesia545: posts small blind 400
dr.Prokhor: posts big blind 800
*** HOLE CARDS ***
Dealt to dfcastro.net [6s 5s]
ximenes.cr: folds 
worf1k: folds 
Bastardo Q9: folds 
1DMITRYSPb1: folds 
llleopold: folds 
dfcastro.net: folds 
kesia545: folds 
Uncalled bet (400) returned to dr.Prokhor
dr.Prokhor collected 1200 from pot
*** SUMMARY ***
Total pot 1200 | Rake 0 
Seat 1: worf1k folded before Flop (didn't bet)
Seat 2: Bastardo Q9 folded before Flop (didn't bet)
Seat 3: 1DMITRYSPb1 folded before Flop (didn't bet)
Seat 4: llleopold folded before Flop (didn't bet)
Seat 5: dfcastro.net (button) folded before Flop (didn't bet)
Seat 7: kesia545 (small blind) folded before Flop
Seat 8: dr.Prokhor (big blind) collected (1200)
Seat 9: ximenes.cr folded before Flop (didn't bet)



PokerStars Hand #98799387885: Tournament #734961465, $0.23+$0.02 USD Hold'em No Limit - Level XI (400/800) - 2013/05/19 11:46:48 BRT [2013/05/19 10:46:48 ET]
Table '734961465 2' 9-max Seat #7 is the button
Seat 1: worf1k (7730 in chips) 
Seat 2: Bastardo Q9 (4684 in chips) 
Seat 3: 1DMITRYSPb1 (6017 in chips) 
Seat 4: llleopold (8057 in chips) 
Seat 5: dfcastro.net (6774 in chips) 
Seat 7: kesia545 (22529 in chips) 
Seat 8: dr.Prokhor (9180 in chips) 
Seat 9: ximenes.cr (2529 in chips) 
worf1k: posts the ante 50
Bastardo Q9: posts the ante 50
1DMITRYSPb1: posts the ante 50
llleopold: posts the ante 50
dfcastro.net: posts the ante 50
kesia545: posts the ante 50
dr.Prokhor: posts the ante 50
ximenes.cr: posts the ante 50
dr.Prokhor: posts small blind 400
ximenes.cr: posts big blind 800
*** HOLE CARDS ***
Dealt to dfcastro.net [Tc 3d]
worf1k: folds 
Bastardo Q9: folds 
1DMITRYSPb1: folds 
llleopold: folds 
dfcastro.net: folds 
kesia545: folds 
dr.Prokhor: folds 
Uncalled bet (400) returned to ximenes.cr
ximenes.cr collected 1200 from pot
ximenes.cr: doesn't show hand 
*** SUMMARY ***
Total pot 1200 | Rake 0 
Seat 1: worf1k folded before Flop (didn't bet)
Seat 2: Bastardo Q9 folded before Flop (didn't bet)
Seat 3: 1DMITRYSPb1 folded before Flop (didn't bet)
Seat 4: llleopold folded before Flop (didn't bet)
Seat 5: dfcastro.net folded before Flop (didn't bet)
Seat 7: kesia545 (button) folded before Flop (didn't bet)
Seat 8: dr.Prokhor (small blind) folded before Flop
Seat 9: ximenes.cr (big blind) collected (1200)



PokerStars Hand #98799403234: Tournament #734961465, $0.23+$0.02 USD Hold'em No Limit - Level XI (400/800) - 2013/05/19 11:47:09 BRT [2013/05/19 10:47:09 ET]
Table '734961465 2' 9-max Seat #8 is the button
Seat 1: worf1k (7680 in chips) 
Seat 2: Bastardo Q9 (4634 in chips) 
Seat 3: 1DMITRYSPb1 (5967 in chips) 
Seat 4: llleopold (8007 in chips) 
Seat 5: dfcastro.net (6724 in chips) 
Seat 7: kesia545 (22479 in chips) 
Seat 8: dr.Prokhor (8730 in chips) 
Seat 9: ximenes.cr (3279 in chips) 
worf1k: posts the ante 50
Bastardo Q9: posts the ante 50
1DMITRYSPb1: posts the ante 50
llleopold: posts the ante 50
dfcastro.net: posts the ante 50
kesia545: posts the ante 50
dr.Prokhor: posts the ante 50
ximenes.cr: posts the ante 50
ximenes.cr: posts small blind 400
worf1k: posts big blind 800
*** HOLE CARDS ***
Dealt to dfcastro.net [2h Jc]
Bastardo Q9: raises 3784 to 4584 and is all-in
1DMITRYSPb1: folds 
llleopold: folds 
dfcastro.net: folds 
kesia545: folds 
dr.Prokhor: folds 
ximenes.cr: folds 
worf1k: folds 
Uncalled bet (3784) returned to Bastardo Q9
Bastardo Q9 collected 2400 from pot
*** SUMMARY ***
Total pot 2400 | Rake 0 
Seat 1: worf1k (big blind) folded before Flop
Seat 2: Bastardo Q9 collected (2400)
Seat 3: 1DMITRYSPb1 folded before Flop (didn't bet)
Seat 4: llleopold folded before Flop (didn't bet)
Seat 5: dfcastro.net folded before Flop (didn't bet)
Seat 7: kesia545 folded before Flop (didn't bet)
Seat 8: dr.Prokhor (button) folded before Flop (didn't bet)
Seat 9: ximenes.cr (small blind) folded before Flop



PokerStars Hand #98799421566: Tournament #734961465, $0.23+$0.02 USD Hold'em No Limit - Level XI (400/800) - 2013/05/19 11:47:34 BRT [2013/05/19 10:47:34 ET]
Table '734961465 2' 9-max Seat #9 is the button
Seat 1: worf1k (6830 in chips) 
Seat 2: Bastardo Q9 (6184 in chips) 
Seat 3: 1DMITRYSPb1 (5917 in chips) 
Seat 4: llleopold (7957 in chips) 
Seat 5: dfcastro.net (6674 in chips) 
Seat 7: kesia545 (22429 in chips) 
Seat 8: dr.Prokhor (8680 in chips) 
Seat 9: ximenes.cr (2829 in chips) 
worf1k: posts the ante 50
Bastardo Q9: posts the ante 50
1DMITRYSPb1: posts the ante 50
llleopold: posts the ante 50
dfcastro.net: posts the ante 50
kesia545: posts the ante 50
dr.Prokhor: posts the ante 50
ximenes.cr: posts the ante 50
worf1k: posts small blind 400
Bastardo Q9: posts big blind 800
*** HOLE CARDS ***
Dealt to dfcastro.net [6h Qc]
1DMITRYSPb1: folds 
llleopold: folds 
dfcastro.net: folds 
kesia545: folds 
dr.Prokhor: folds 
ximenes.cr: folds 
worf1k: folds 
Uncalled bet (400) returned to Bastardo Q9
Bastardo Q9 collected 1200 from pot
*** SUMMARY ***
Total pot 1200 | Rake 0 
Seat 1: worf1k (small blind) folded before Flop
Seat 2: Bastardo Q9 (big blind) collected (1200)
Seat 3: 1DMITRYSPb1 folded before Flop (didn't bet)
Seat 4: llleopold folded before Flop (didn't bet)
Seat 5: dfcastro.net folded before Flop (didn't bet)
Seat 7: kesia545 folded before Flop (didn't bet)
Seat 8: dr.Prokhor folded before Flop (didn't bet)
Seat 9: ximenes.cr (button) folded before Flop (didn't bet)



PokerStars Hand #98799437804: Tournament #734961465, $0.23+$0.02 USD Hold'em No Limit - Level XII (500/1000) - 2013/05/19 11:47:57 BRT [2013/05/19 10:47:57 ET]
Table '734961465 2' 9-max Seat #1 is the button
Seat 1: worf1k (6380 in chips) 
Seat 2: Bastardo Q9 (6934 in chips) 
Seat 3: 1DMITRYSPb1 (5867 in chips) 
Seat 4: llleopold (7907 in chips) 
Seat 5: dfcastro.net (6624 in chips) 
Seat 7: kesia545 (22379 in chips) 
Seat 8: dr.Prokhor (8630 in chips) 
Seat 9: ximenes.cr (2779 in chips) 
worf1k: posts the ante 60
Bastardo Q9: posts the ante 60
1DMITRYSPb1: posts the ante 60
llleopold: posts the ante 60
dfcastro.net: posts the ante 60
kesia545: posts the ante 60
dr.Prokhor: posts the ante 60
ximenes.cr: posts the ante 60
Bastardo Q9: posts small blind 500
1DMITRYSPb1: posts big blind 1000
*** HOLE CARDS ***
Dealt to dfcastro.net [3s 6s]
llleopold: folds 
dfcastro.net: folds 
kesia545: calls 1000
dr.Prokhor: folds 
ximenes.cr: folds 
worf1k: folds 
Bastardo Q9: calls 500
1DMITRYSPb1: checks 
*** FLOP *** [8c Td As]
Bastardo Q9: bets 2777
1DMITRYSPb1: folds 
kesia545: calls 2777
*** TURN *** [8c Td As] [Ac]
Bastardo Q9: bets 3097 and is all-in
kesia545: folds 
Uncalled bet (3097) returned to Bastardo Q9
Bastardo Q9 collected 9034 from pot
Bastardo Q9: shows [7d]
*** SUMMARY ***
Total pot 9034 | Rake 0 
Board [8c Td As Ac]
Seat 1: worf1k (button) folded before Flop (didn't bet)
Seat 2: Bastardo Q9 (small blind) collected (9034)
Seat 3: 1DMITRYSPb1 (big blind) folded on the Flop
Seat 4: llleopold folded before Flop (didn't bet)
Seat 5: dfcastro.net folded before Flop (didn't bet)
Seat 7: kesia545 folded on the Turn
Seat 8: dr.Prokhor folded before Flop (didn't bet)
Seat 9: ximenes.cr folded before Flop (didn't bet)



PokerStars Hand #98799471207: Tournament #734961465, $0.23+$0.02 USD Hold'em No Limit - Level XII (500/1000) - 2013/05/19 11:48:43 BRT [2013/05/19 10:48:43 ET]
Table '734961465 2' 9-max Seat #2 is the button
Seat 1: worf1k (6320 in chips) 
Seat 2: Bastardo Q9 (12131 in chips) 
Seat 3: 1DMITRYSPb1 (4807 in chips) 
Seat 4: llleopold (7847 in chips) 
Seat 5: dfcastro.net (6564 in chips) 
Seat 7: kesia545 (18542 in chips) 
Seat 8: dr.Prokhor (8570 in chips) 
Seat 9: ximenes.cr (2719 in chips) 
worf1k: posts the ante 60
Bastardo Q9: posts the ante 60
1DMITRYSPb1: posts the ante 60
llleopold: posts the ante 60
dfcastro.net: posts the ante 60
kesia545: posts the ante 60
dr.Prokhor: posts the ante 60
ximenes.cr: posts the ante 60
1DMITRYSPb1: posts small blind 500
llleopold: posts big blind 1000
*** HOLE CARDS ***
Dealt to dfcastro.net [8c Kc]
dfcastro.net: folds 
kesia545: folds 
dr.Prokhor: folds 
ximenes.cr: folds 
worf1k: raises 5260 to 6260 and is all-in
Bastardo Q9: folds 
1DMITRYSPb1: folds 
llleopold: calls 5260
*** FLOP *** [5s Ad Kd]
*** TURN *** [5s Ad Kd] [2c]
*** RIVER *** [5s Ad Kd 2c] [7d]
*** SHOW DOWN ***
llleopold: shows [Ac 8s] (a pair of Aces)
worf1k: shows [9s 9c] (a pair of Nines)
llleopold collected 13500 from pot
worf1k finished the tournament in 8th place
*** SUMMARY ***
Total pot 13500 | Rake 0 
Board [5s Ad Kd 2c 7d]
Seat 1: worf1k showed [9s 9c] and lost with a pair of Nines
Seat 2: Bastardo Q9 (button) folded before Flop (didn't bet)
Seat 3: 1DMITRYSPb1 (small blind) folded before Flop
Seat 4: llleopold (big blind) showed [Ac 8s] and won (13500) with a pair of Aces
Seat 5: dfcastro.net folded before Flop (didn't bet)
Seat 7: kesia545 folded before Flop (didn't bet)
Seat 8: dr.Prokhor folded before Flop (didn't bet)
Seat 9: ximenes.cr folded before Flop (didn't bet)



PokerStars Hand #98799495677: Tournament #734961465, $0.23+$0.02 USD Hold'em No Limit - Level XII (500/1000) - 2013/05/19 11:49:17 BRT [2013/05/19 10:49:17 ET]
Table '734961465 2' 9-max Seat #3 is the button
Seat 2: Bastardo Q9 (12071 in chips) 
Seat 3: 1DMITRYSPb1 (4247 in chips) 
Seat 4: llleopold (15027 in chips) 
Seat 5: dfcastro.net (6504 in chips) 
Seat 7: kesia545 (18482 in chips) 
Seat 8: dr.Prokhor (8510 in chips) 
Seat 9: ximenes.cr (2659 in chips) 
Bastardo Q9: posts the ante 60
1DMITRYSPb1: posts the ante 60
llleopold: posts the ante 60
dfcastro.net: posts the ante 60
kesia545: posts the ante 60
dr.Prokhor: posts the ante 60
ximenes.cr: posts the ante 60
llleopold: posts small blind 500
dfcastro.net: posts big blind 1000
*** HOLE CARDS ***
Dealt to dfcastro.net [Ts Qd]
kesia545: folds 
dr.Prokhor: raises 1500 to 2500
ximenes.cr: folds 
Bastardo Q9: folds 
1DMITRYSPb1: folds 
llleopold: folds 
dfcastro.net: folds 
Uncalled bet (1500) returned to dr.Prokhor
dr.Prokhor collected 2920 from pot
*** SUMMARY ***
Total pot 2920 | Rake 0 
Seat 2: Bastardo Q9 folded before Flop (didn't bet)
Seat 3: 1DMITRYSPb1 (button) folded before Flop (didn't bet)
Seat 4: llleopold (small blind) folded before Flop
Seat 5: dfcastro.net (big blind) folded before Flop
Seat 7: kesia545 folded before Flop (didn't bet)
Seat 8: dr.Prokhor collected (2920)
Seat 9: ximenes.cr folded before Flop (didn't bet)



PokerStars Hand #98799515952: Tournament #734961465, $0.23+$0.02 USD Hold'em No Limit - Level XII (500/1000) - 2013/05/19 11:49:45 BRT [2013/05/19 10:49:45 ET]
Table '734961465 2' 9-max Seat #4 is the button
Seat 2: Bastardo Q9 (12011 in chips) 
Seat 3: 1DMITRYSPb1 (4187 in chips) 
Seat 4: llleopold (14467 in chips) 
Seat 5: dfcastro.net (5444 in chips) 
Seat 7: kesia545 (18422 in chips) 
Seat 8: dr.Prokhor (10370 in chips) 
Seat 9: ximenes.cr (2599 in chips) 
Bastardo Q9: posts the ante 60
1DMITRYSPb1: posts the ante 60
llleopold: posts the ante 60
dfcastro.net: posts the ante 60
kesia545: posts the ante 60
dr.Prokhor: posts the ante 60
ximenes.cr: posts the ante 60
dfcastro.net: posts small blind 500
kesia545: posts big blind 1000
*** HOLE CARDS ***
Dealt to dfcastro.net [2c 3c]
dr.Prokhor: folds 
ximenes.cr: folds 
Bastardo Q9: folds 
1DMITRYSPb1: folds 
llleopold: raises 1070 to 2070
dfcastro.net: folds 
kesia545: calls 1070
*** FLOP *** [8c Jc Qh]
kesia545: checks 
llleopold: bets 2285
kesia545: calls 2285
*** TURN *** [8c Jc Qh] [5h]
kesia545: checks 
llleopold: checks 
*** RIVER *** [8c Jc Qh 5h] [6s]
kesia545: checks 
llleopold: checks 
*** SHOW DOWN ***
kesia545: shows [Jh Ah] (a pair of Jacks)
llleopold: mucks hand 
kesia545 collected 9630 from pot
*** SUMMARY ***
Total pot 9630 | Rake 0 
Board [8c Jc Qh 5h 6s]
Seat 2: Bastardo Q9 folded before Flop (didn't bet)
Seat 3: 1DMITRYSPb1 folded before Flop (didn't bet)
Seat 4: llleopold (button) mucked [7d 7s]
Seat 5: dfcastro.net (small blind) folded before Flop
Seat 7: kesia545 (big blind) showed [Jh Ah] and won (9630) with a pair of Jacks
Seat 8: dr.Prokhor folded before Flop (didn't bet)
Seat 9: ximenes.cr folded before Flop (didn't bet)



PokerStars Hand #98799540855: Tournament #734961465, $0.23+$0.02 USD Hold'em No Limit - Level XII (500/1000) - 2013/05/19 11:50:20 BRT [2013/05/19 10:50:20 ET]
Table '734961465 2' 9-max Seat #5 is the button
Seat 2: Bastardo Q9 (11951 in chips) 
Seat 3: 1DMITRYSPb1 (4127 in chips) 
Seat 4: llleopold (10052 in chips) 
Seat 5: dfcastro.net (4884 in chips) 
Seat 7: kesia545 (23637 in chips) 
Seat 8: dr.Prokhor (10310 in chips) 
Seat 9: ximenes.cr (2539 in chips) 
Bastardo Q9: posts the ante 60
1DMITRYSPb1: posts the ante 60
llleopold: posts the ante 60
dfcastro.net: posts the ante 60
kesia545: posts the ante 60
dr.Prokhor: posts the ante 60
ximenes.cr: posts the ante 60
kesia545: posts small blind 500
dr.Prokhor: posts big blind 1000
*** HOLE CARDS ***
Dealt to dfcastro.net [5c Jc]
ximenes.cr: calls 1000
Bastardo Q9: folds 
1DMITRYSPb1: folds 
llleopold: raises 8992 to 9992 and is all-in
dfcastro.net: folds 
kesia545: folds 
dr.Prokhor: folds 
ximenes.cr: calls 1479 and is all-in
Uncalled bet (7513) returned to llleopold
*** FLOP *** [8d 3h Ah]
*** TURN *** [8d 3h Ah] [Kh]
*** RIVER *** [8d 3h Ah Kh] [4c]
*** SHOW DOWN ***
ximenes.cr: shows [Qd Js] (high card Ace)
llleopold: shows [Kc Ad] (two pair, Aces and Kings)
llleopold collected 6878 from pot
ximenes.cr finished the tournament in 7th place and received $0.36.
*** SUMMARY ***
Total pot 6878 | Rake 0 
Board [8d 3h Ah Kh 4c]
Seat 2: Bastardo Q9 folded before Flop (didn't bet)
Seat 3: 1DMITRYSPb1 folded before Flop (didn't bet)
Seat 4: llleopold showed [Kc Ad] and won (6878) with two pair, Aces and Kings
Seat 5: dfcastro.net (button) folded before Flop (didn't bet)
Seat 7: kesia545 (small blind) folded before Flop
Seat 8: dr.Prokhor (big blind) folded before Flop
Seat 9: ximenes.cr showed [Qd Js] and lost with high card Ace



PokerStars Hand #98799564596: Tournament #734961465, $0.23+$0.02 USD Hold'em No Limit - Level XII (500/1000) - 2013/05/19 11:50:52 BRT [2013/05/19 10:50:52 ET]
Table '734961465 2' 9-max Seat #7 is the button
Seat 2: Bastardo Q9 (11891 in chips) 
Seat 3: 1DMITRYSPb1 (4067 in chips) 
Seat 4: llleopold (14391 in chips) 
Seat 5: dfcastro.net (4824 in chips) 
Seat 7: kesia545 (23077 in chips) 
Seat 8: dr.Prokhor (9250 in chips) 
Bastardo Q9: posts the ante 60
1DMITRYSPb1: posts the ante 60
llleopold: posts the ante 60
dfcastro.net: posts the ante 60
kesia545: posts the ante 60
dr.Prokhor: posts the ante 60
dr.Prokhor: posts small blind 500
Bastardo Q9: posts big blind 1000
*** HOLE CARDS ***
Dealt to dfcastro.net [As 5h]
1DMITRYSPb1: folds 
llleopold: folds 
dfcastro.net: raises 3764 to 4764 and is all-in
kesia545: folds 
dr.Prokhor: calls 4264
Bastardo Q9: folds 
*** FLOP *** [8c 8h 2h]
*** TURN *** [8c 8h 2h] [4s]
*** RIVER *** [8c 8h 2h 4s] [9c]
*** SHOW DOWN ***
dr.Prokhor: shows [Qh Kd] (a pair of Eights)
dfcastro.net: shows [As 5h] (a pair of Eights - Ace kicker)
dfcastro.net collected 10888 from pot
*** SUMMARY ***
Total pot 10888 | Rake 0 
Board [8c 8h 2h 4s 9c]
Seat 2: Bastardo Q9 (big blind) folded before Flop
Seat 3: 1DMITRYSPb1 folded before Flop (didn't bet)
Seat 4: llleopold folded before Flop (didn't bet)
Seat 5: dfcastro.net showed [As 5h] and won (10888) with a pair of Eights
Seat 7: kesia545 (button) folded before Flop (didn't bet)
Seat 8: dr.Prokhor (small blind) showed [Qh Kd] and lost with a pair of Eights



PokerStars Hand #98799599605: Tournament #734961465, $0.23+$0.02 USD Hold'em No Limit - Level XII (500/1000) - 2013/05/19 11:51:41 BRT [2013/05/19 10:51:41 ET]
Table '734961465 2' 9-max Seat #8 is the button
Seat 2: Bastardo Q9 (10831 in chips) 
Seat 3: 1DMITRYSPb1 (4007 in chips) 
Seat 4: llleopold (14331 in chips) 
Seat 5: dfcastro.net (10888 in chips) 
Seat 7: kesia545 (23017 in chips) 
Seat 8: dr.Prokhor (4426 in chips) 
Bastardo Q9: posts the ante 60
1DMITRYSPb1: posts the ante 60
llleopold: posts the ante 60
dfcastro.net: posts the ante 60
kesia545: posts the ante 60
dr.Prokhor: posts the ante 60
Bastardo Q9: posts small blind 500
1DMITRYSPb1: posts big blind 1000
*** HOLE CARDS ***
Dealt to dfcastro.net [7h 5h]
llleopold: folds 
dfcastro.net: folds 
kesia545: folds 
dr.Prokhor: raises 1500 to 2500
Bastardo Q9: folds 
1DMITRYSPb1: folds 
Uncalled bet (1500) returned to dr.Prokhor
dr.Prokhor collected 2860 from pot
dr.Prokhor: doesn't show hand 
*** SUMMARY ***
Total pot 2860 | Rake 0 
Seat 2: Bastardo Q9 (small blind) folded before Flop
Seat 3: 1DMITRYSPb1 (big blind) folded before Flop
Seat 4: llleopold folded before Flop (didn't bet)
Seat 5: dfcastro.net folded before Flop (didn't bet)
Seat 7: kesia545 folded before Flop (didn't bet)
Seat 8: dr.Prokhor (button) collected (2860)



PokerStars Hand #98799614957: Tournament #734961465, $0.23+$0.02 USD Hold'em No Limit - Level XII (500/1000) - 2013/05/19 11:52:02 BRT [2013/05/19 10:52:02 ET]
Table '734961465 2' 9-max Seat #2 is the button
Seat 2: Bastardo Q9 (10271 in chips) 
Seat 3: 1DMITRYSPb1 (2947 in chips) 
Seat 4: llleopold (14271 in chips) 
Seat 5: dfcastro.net (10828 in chips) 
Seat 7: kesia545 (22957 in chips) 
Seat 8: dr.Prokhor (6226 in chips) 
Bastardo Q9: posts the ante 60
1DMITRYSPb1: posts the ante 60
llleopold: posts the ante 60
dfcastro.net: posts the ante 60
kesia545: posts the ante 60
dr.Prokhor: posts the ante 60
1DMITRYSPb1: posts small blind 500
llleopold: posts big blind 1000
*** HOLE CARDS ***
Dealt to dfcastro.net [4c 3h]
dfcastro.net: folds 
kesia545: folds 
dr.Prokhor: folds 
Bastardo Q9: folds 
1DMITRYSPb1: folds 
Uncalled bet (500) returned to llleopold
llleopold collected 1360 from pot
llleopold: doesn't show hand 
*** SUMMARY ***
Total pot 1360 | Rake 0 
Seat 2: Bastardo Q9 (button) folded before Flop (didn't bet)
Seat 3: 1DMITRYSPb1 (small blind) folded before Flop
Seat 4: llleopold (big blind) collected (1360)
Seat 5: dfcastro.net folded before Flop (didn't bet)
Seat 7: kesia545 folded before Flop (didn't bet)
Seat 8: dr.Prokhor folded before Flop (didn't bet)



PokerStars Hand #98799625389: Tournament #734961465, $0.23+$0.02 USD Hold'em No Limit - Level XII (500/1000) - 2013/05/19 11:52:17 BRT [2013/05/19 10:52:17 ET]
Table '734961465 2' 9-max Seat #3 is the button
Seat 2: Bastardo Q9 (10211 in chips) 
Seat 3: 1DMITRYSPb1 (2387 in chips) 
Seat 4: llleopold (15071 in chips) 
Seat 5: dfcastro.net (10768 in chips) 
Seat 7: kesia545 (22897 in chips) 
Seat 8: dr.Prokhor (6166 in chips) 
Bastardo Q9: posts the ante 60
1DMITRYSPb1: posts the ante 60
llleopold: posts the ante 60
dfcastro.net: posts the ante 60
kesia545: posts the ante 60
dr.Prokhor: posts the ante 60
llleopold: posts small blind 500
dfcastro.net: posts big blind 1000
*** HOLE CARDS ***
Dealt to dfcastro.net [4h 5h]
kesia545: calls 1000
dr.Prokhor: folds 
Bastardo Q9: folds 
1DMITRYSPb1: folds 
llleopold: folds 
dfcastro.net: checks 
*** FLOP *** [6s Jh Ah]
dfcastro.net: checks 
kesia545: checks 
*** TURN *** [6s Jh Ah] [Qh]
dfcastro.net: checks 
kesia545: checks 
*** RIVER *** [6s Jh Ah Qh] [5s]
dfcastro.net: bets 2000
kesia545: calls 2000
*** SHOW DOWN ***
dfcastro.net: shows [4h 5h] (a flush, Ace high)
kesia545: mucks hand 
dfcastro.net collected 6860 from pot
*** SUMMARY ***
Total pot 6860 | Rake 0 
Board [6s Jh Ah Qh 5s]
Seat 2: Bastardo Q9 folded before Flop (didn't bet)
Seat 3: 1DMITRYSPb1 (button) folded before Flop (didn't bet)
Seat 4: llleopold (small blind) folded before Flop
Seat 5: dfcastro.net (big blind) showed [4h 5h] and won (6860) with a flush, Ace high
Seat 7: kesia545 mucked [Ac 8c]
Seat 8: dr.Prokhor folded before Flop (didn't bet)



PokerStars Hand #98799654989: Tournament #734961465, $0.23+$0.02 USD Hold'em No Limit - Level XII (500/1000) - 2013/05/19 11:52:58 BRT [2013/05/19 10:52:58 ET]
Table '734961465 2' 9-max Seat #4 is the button
Seat 2: Bastardo Q9 (10151 in chips) 
Seat 3: 1DMITRYSPb1 (2327 in chips) 
Seat 4: llleopold (14511 in chips) 
Seat 5: dfcastro.net (14568 in chips) 
Seat 7: kesia545 (19837 in chips) 
Seat 8: dr.Prokhor (6106 in chips) 
Bastardo Q9: posts the ante 60
1DMITRYSPb1: posts the ante 60
llleopold: posts the ante 60
dfcastro.net: posts the ante 60
kesia545: posts the ante 60
dr.Prokhor: posts the ante 60
dfcastro.net: posts small blind 500
kesia545: posts big blind 1000
*** HOLE CARDS ***
Dealt to dfcastro.net [Tc 8d]
dr.Prokhor: folds 
Bastardo Q9: folds 
1DMITRYSPb1: raises 1267 to 2267 and is all-in
llleopold: folds 
dfcastro.net: folds 
kesia545: folds 
Uncalled bet (1267) returned to 1DMITRYSPb1
1DMITRYSPb1 collected 2860 from pot
1DMITRYSPb1: doesn't show hand 
*** SUMMARY ***
Total pot 2860 | Rake 0 
Seat 2: Bastardo Q9 folded before Flop (didn't bet)
Seat 3: 1DMITRYSPb1 collected (2860)
Seat 4: llleopold (button) folded before Flop (didn't bet)
Seat 5: dfcastro.net (small blind) folded before Flop
Seat 7: kesia545 (big blind) folded before Flop
Seat 8: dr.Prokhor folded before Flop (didn't bet)



PokerStars Hand #98799666491: Tournament #734961465, $0.23+$0.02 USD Hold'em No Limit - Level XII (500/1000) - 2013/05/19 11:53:14 BRT [2013/05/19 10:53:14 ET]
Table '734961465 2' 9-max Seat #5 is the button
Seat 2: Bastardo Q9 (10091 in chips) 
Seat 3: 1DMITRYSPb1 (4127 in chips) 
Seat 4: llleopold (14451 in chips) 
Seat 5: dfcastro.net (14008 in chips) 
Seat 7: kesia545 (18777 in chips) 
Seat 8: dr.Prokhor (6046 in chips) 
Bastardo Q9: posts the ante 60
1DMITRYSPb1: posts the ante 60
llleopold: posts the ante 60
dfcastro.net: posts the ante 60
kesia545: posts the ante 60
dr.Prokhor: posts the ante 60
kesia545: posts small blind 500
dr.Prokhor: posts big blind 1000
*** HOLE CARDS ***
Dealt to dfcastro.net [6h 5d]
Bastardo Q9: folds 
1DMITRYSPb1: folds 
llleopold: raises 1070 to 2070
dfcastro.net: folds 
kesia545: folds 
dr.Prokhor: folds 
Uncalled bet (1070) returned to llleopold
llleopold collected 2860 from pot
llleopold: doesn't show hand 
*** SUMMARY ***
Total pot 2860 | Rake 0 
Seat 2: Bastardo Q9 folded before Flop (didn't bet)
Seat 3: 1DMITRYSPb1 folded before Flop (didn't bet)
Seat 4: llleopold collected (2860)
Seat 5: dfcastro.net (button) folded before Flop (didn't bet)
Seat 7: kesia545 (small blind) folded before Flop
Seat 8: dr.Prokhor (big blind) folded before Flop



PokerStars Hand #98799676325: Tournament #734961465, $0.23+$0.02 USD Hold'em No Limit - Level XII (500/1000) - 2013/05/19 11:53:27 BRT [2013/05/19 10:53:27 ET]
Table '734961465 2' 9-max Seat #7 is the button
Seat 2: Bastardo Q9 (10031 in chips) 
Seat 3: 1DMITRYSPb1 (4067 in chips) 
Seat 4: llleopold (16251 in chips) 
Seat 5: dfcastro.net (13948 in chips) 
Seat 7: kesia545 (18217 in chips) 
Seat 8: dr.Prokhor (4986 in chips) 
Bastardo Q9: posts the ante 60
1DMITRYSPb1: posts the ante 60
llleopold: posts the ante 60
dfcastro.net: posts the ante 60
kesia545: posts the ante 60
dr.Prokhor: posts the ante 60
dr.Prokhor: posts small blind 500
Bastardo Q9: posts big blind 1000
*** HOLE CARDS ***
Dealt to dfcastro.net [6c 9d]
1DMITRYSPb1: folds 
llleopold: folds 
dfcastro.net: folds 
kesia545: calls 1000
dr.Prokhor: folds 
Bastardo Q9: checks 
*** FLOP *** [Tc 9c Js]
Bastardo Q9: bets 8971 and is all-in
kesia545: calls 8971
*** TURN *** [Tc 9c Js] [4s]
*** RIVER *** [Tc 9c Js 4s] [5s]
*** SHOW DOWN ***
Bastardo Q9: shows [Qh Jd] (a pair of Jacks)
kesia545: shows [Ts Td] (three of a kind, Tens)
kesia545 collected 20802 from pot
Bastardo Q9 finished the tournament in 6th place and received $0.62.
*** SUMMARY ***
Total pot 20802 | Rake 0 
Board [Tc 9c Js 4s 5s]
Seat 2: Bastardo Q9 (big blind) showed [Qh Jd] and lost with a pair of Jacks
Seat 3: 1DMITRYSPb1 folded before Flop (didn't bet)
Seat 4: llleopold folded before Flop (didn't bet)
Seat 5: dfcastro.net folded before Flop (didn't bet)
Seat 7: kesia545 (button) showed [Ts Td] and won (20802) with three of a kind, Tens
Seat 8: dr.Prokhor (small blind) folded before Flop



PokerStars Hand #98799693782: Tournament #734961465, $0.23+$0.02 USD Hold'em No Limit - Level XII (500/1000) - 2013/05/19 11:53:52 BRT [2013/05/19 10:53:52 ET]
Table '734961465 2' 9-max Seat #8 is the button
Seat 3: 1DMITRYSPb1 (4007 in chips) 
Seat 4: llleopold (16191 in chips) 
Seat 5: dfcastro.net (13888 in chips) 
Seat 7: kesia545 (28988 in chips) 
Seat 8: dr.Prokhor (4426 in chips) 
1DMITRYSPb1: posts the ante 60
llleopold: posts the ante 60
dfcastro.net: posts the ante 60
kesia545: posts the ante 60
dr.Prokhor: posts the ante 60
1DMITRYSPb1: posts small blind 500
llleopold: posts big blind 1000
*** HOLE CARDS ***
Dealt to dfcastro.net [9h Qs]
dfcastro.net: folds 
kesia545: folds 
dr.Prokhor: folds 
1DMITRYSPb1: folds 
Uncalled bet (500) returned to llleopold
llleopold collected 1300 from pot
llleopold: doesn't show hand 
*** SUMMARY ***
Total pot 1300 | Rake 0 
Seat 3: 1DMITRYSPb1 (small blind) folded before Flop
Seat 4: llleopold (big blind) collected (1300)
Seat 5: dfcastro.net folded before Flop (didn't bet)
Seat 7: kesia545 folded before Flop (didn't bet)
Seat 8: dr.Prokhor (button) folded before Flop (didn't bet)



PokerStars Hand #98799703078: Tournament #734961465, $0.23+$0.02 USD Hold'em No Limit - Level XII (500/1000) - 2013/05/19 11:54:05 BRT [2013/05/19 10:54:05 ET]
Table '734961465 2' 9-max Seat #3 is the button
Seat 3: 1DMITRYSPb1 (3447 in chips) 
Seat 4: llleopold (16931 in chips) 
Seat 5: dfcastro.net (13828 in chips) 
Seat 7: kesia545 (28928 in chips) 
Seat 8: dr.Prokhor (4366 in chips) 
1DMITRYSPb1: posts the ante 60
llleopold: posts the ante 60
dfcastro.net: posts the ante 60
kesia545: posts the ante 60
dr.Prokhor: posts the ante 60
llleopold: posts small blind 500
dfcastro.net: posts big blind 1000
*** HOLE CARDS ***
Dealt to dfcastro.net [3c Th]
kesia545: folds 
dr.Prokhor: folds 
1DMITRYSPb1: folds 
llleopold: raises 1070 to 2070
dfcastro.net: folds 
Uncalled bet (1070) returned to llleopold
llleopold collected 2300 from pot
llleopold: doesn't show hand 
*** SUMMARY ***
Total pot 2300 | Rake 0 
Seat 3: 1DMITRYSPb1 (button) folded before Flop (didn't bet)
Seat 4: llleopold (small blind) collected (2300)
Seat 5: dfcastro.net (big blind) folded before Flop
Seat 7: kesia545 folded before Flop (didn't bet)
Seat 8: dr.Prokhor folded before Flop (didn't bet)



PokerStars Hand #98799715456: Tournament #734961465, $0.23+$0.02 USD Hold'em No Limit - Level XII (500/1000) - 2013/05/19 11:54:22 BRT [2013/05/19 10:54:22 ET]
Table '734961465 2' 9-max Seat #4 is the button
Seat 3: 1DMITRYSPb1 (3387 in chips) 
Seat 4: llleopold (18171 in chips) 
Seat 5: dfcastro.net (12768 in chips) 
Seat 7: kesia545 (28868 in chips) 
Seat 8: dr.Prokhor (4306 in chips) 
1DMITRYSPb1: posts the ante 60
llleopold: posts the ante 60
dfcastro.net: posts the ante 60
kesia545: posts the ante 60
dr.Prokhor: posts the ante 60
dfcastro.net: posts small blind 500
kesia545: posts big blind 1000
*** HOLE CARDS ***
Dealt to dfcastro.net [6d Jd]
dr.Prokhor: folds 
1DMITRYSPb1: folds 
llleopold: raises 1070 to 2070
dfcastro.net: folds 
kesia545: folds 
Uncalled bet (1070) returned to llleopold
llleopold collected 2800 from pot
llleopold: doesn't show hand 
*** SUMMARY ***
Total pot 2800 | Rake 0 
Seat 3: 1DMITRYSPb1 folded before Flop (didn't bet)
Seat 4: llleopold (button) collected (2800)
Seat 5: dfcastro.net (small blind) folded before Flop
Seat 7: kesia545 (big blind) folded before Flop
Seat 8: dr.Prokhor folded before Flop (didn't bet)



PokerStars Hand #98799729360: Tournament #734961465, $0.23+$0.02 USD Hold'em No Limit - Level XII (500/1000) - 2013/05/19 11:54:41 BRT [2013/05/19 10:54:41 ET]
Table '734961465 2' 9-max Seat #5 is the button
Seat 3: 1DMITRYSPb1 (3327 in chips) 
Seat 4: llleopold (19911 in chips) 
Seat 5: dfcastro.net (12208 in chips) 
Seat 7: kesia545 (27808 in chips) 
Seat 8: dr.Prokhor (4246 in chips) 
1DMITRYSPb1: posts the ante 60
llleopold: posts the ante 60
dfcastro.net: posts the ante 60
kesia545: posts the ante 60
dr.Prokhor: posts the ante 60
kesia545: posts small blind 500
dr.Prokhor: posts big blind 1000
*** HOLE CARDS ***
Dealt to dfcastro.net [Jd Qs]
1DMITRYSPb1: folds 
llleopold: folds 
dfcastro.net: raises 1200 to 2200
kesia545: calls 1700
dr.Prokhor: folds 
*** FLOP *** [As 7c 3c]
kesia545: checks 
dfcastro.net: bets 3600
kesia545: calls 3600
*** TURN *** [As 7c 3c] [8s]
kesia545: checks 
dfcastro.net: checks 
*** RIVER *** [As 7c 3c 8s] [Tc]
kesia545: checks 
dfcastro.net: checks 
*** SHOW DOWN ***
kesia545: shows [Ac Td] (two pair, Aces and Tens)
dfcastro.net: mucks hand 
kesia545 collected 12900 from pot
*** SUMMARY ***
Total pot 12900 | Rake 0 
Board [As 7c 3c 8s Tc]
Seat 3: 1DMITRYSPb1 folded before Flop (didn't bet)
Seat 4: llleopold folded before Flop (didn't bet)
Seat 5: dfcastro.net (button) mucked [Jd Qs]
Seat 7: kesia545 (small blind) showed [Ac Td] and won (12900) with two pair, Aces and Tens
Seat 8: dr.Prokhor (big blind) folded before Flop



PokerStars Hand #98799933491: Tournament #734961465, $0.23+$0.02 USD Hold'em No Limit - Level XII (500/1000) - 2013/05/19 12:00:42 BRT [2013/05/19 11:00:42 ET]
Table '734961465 2' 9-max Seat #7 is the button
Seat 3: 1DMITRYSPb1 (3267 in chips) 
Seat 4: llleopold (19851 in chips) 
Seat 5: dfcastro.net (6348 in chips) 
Seat 7: kesia545 (34848 in chips) 
Seat 8: dr.Prokhor (3186 in chips) 
1DMITRYSPb1: posts the ante 60
llleopold: posts the ante 60
dfcastro.net: posts the ante 60
kesia545: posts the ante 60
dr.Prokhor: posts the ante 60
dr.Prokhor: posts small blind 500
1DMITRYSPb1: posts big blind 1000
*** HOLE CARDS ***
Dealt to dfcastro.net [Qd 4d]
llleopold: folds 
dfcastro.net: folds 
kesia545: calls 1000
dr.Prokhor: folds 
1DMITRYSPb1: checks 
*** FLOP *** [7s Ks Jd]
1DMITRYSPb1: checks 
kesia545: checks 
*** TURN *** [7s Ks Jd] [3c]
1DMITRYSPb1: checks 
kesia545: checks 
*** RIVER *** [7s Ks Jd 3c] [Qh]
1DMITRYSPb1: checks 
kesia545: checks 
*** SHOW DOWN ***
1DMITRYSPb1: shows [5s 6h] (high card King)
kesia545: mucks hand 
1DMITRYSPb1 collected 2800 from pot
*** SUMMARY ***
Total pot 2800 | Rake 0 
Board [7s Ks Jd 3c Qh]
Seat 3: 1DMITRYSPb1 (big blind) showed [5s 6h] and won (2800) with high card King
Seat 4: llleopold folded before Flop (didn't bet)
Seat 5: dfcastro.net folded before Flop (didn't bet)
Seat 7: kesia545 (button) mucked [5c 4c]
Seat 8: dr.Prokhor (small blind) folded before Flop



PokerStars Hand #98799962981: Tournament #734961465, $0.23+$0.02 USD Hold'em No Limit - Level XII (500/1000) - 2013/05/19 12:01:27 BRT [2013/05/19 11:01:27 ET]
Table '734961465 2' 9-max Seat #8 is the button
Seat 3: 1DMITRYSPb1 (5007 in chips) 
Seat 4: llleopold (19791 in chips) 
Seat 5: dfcastro.net (6288 in chips) 
Seat 7: kesia545 (33788 in chips) 
Seat 8: dr.Prokhor (2626 in chips) 
1DMITRYSPb1: posts the ante 60
llleopold: posts the ante 60
dfcastro.net: posts the ante 60
kesia545: posts the ante 60
dr.Prokhor: posts the ante 60
1DMITRYSPb1: posts small blind 500
llleopold: posts big blind 1000
*** HOLE CARDS ***
Dealt to dfcastro.net [Qc Jd]
dfcastro.net: folds 
kesia545: calls 1000
dr.Prokhor: raises 1566 to 2566 and is all-in
1DMITRYSPb1: folds 
llleopold: folds 
kesia545: calls 1566
*** FLOP *** [Ac 7h 9h]
*** TURN *** [Ac 7h 9h] [7s]
*** RIVER *** [Ac 7h 9h 7s] [7c]
*** SHOW DOWN ***
kesia545: shows [8h Kh] (three of a kind, Sevens)
dr.Prokhor: shows [As Qs] (a full house, Sevens full of Aces)
dr.Prokhor collected 6932 from pot
*** SUMMARY ***
Total pot 6932 | Rake 0 
Board [Ac 7h 9h 7s 7c]
Seat 3: 1DMITRYSPb1 (small blind) folded before Flop
Seat 4: llleopold (big blind) folded before Flop
Seat 5: dfcastro.net folded before Flop (didn't bet)
Seat 7: kesia545 showed [8h Kh] and lost with three of a kind, Sevens
Seat 8: dr.Prokhor (button) showed [As Qs] and won (6932) with a full house, Sevens full of Aces



PokerStars Hand #98799986757: Tournament #734961465, $0.23+$0.02 USD Hold'em No Limit - Level XII (500/1000) - 2013/05/19 12:01:59 BRT [2013/05/19 11:01:59 ET]
Table '734961465 2' 9-max Seat #3 is the button
Seat 3: 1DMITRYSPb1 (4447 in chips) 
Seat 4: llleopold (18731 in chips) 
Seat 5: dfcastro.net (6228 in chips) 
Seat 7: kesia545 (31162 in chips) 
Seat 8: dr.Prokhor (6932 in chips) 
1DMITRYSPb1: posts the ante 60
llleopold: posts the ante 60
dfcastro.net: posts the ante 60
kesia545: posts the ante 60
dr.Prokhor: posts the ante 60
llleopold: posts small blind 500
dfcastro.net: posts big blind 1000
*** HOLE CARDS ***
Dealt to dfcastro.net [2d 9c]
kesia545: calls 1000
dr.Prokhor: folds 
1DMITRYSPb1: folds 
llleopold: folds 
dfcastro.net: checks 
*** FLOP *** [Jc Ah As]
dfcastro.net: checks 
kesia545: checks 
*** TURN *** [Jc Ah As] [Qs]
dfcastro.net: checks 
kesia545: checks 
*** RIVER *** [Jc Ah As Qs] [3c]
dfcastro.net: checks 
kesia545: checks 
*** SHOW DOWN ***
dfcastro.net: shows [2d 9c] (a pair of Aces)
kesia545: shows [7d 7c] (two pair, Aces and Sevens)
kesia545 collected 2800 from pot
*** SUMMARY ***
Total pot 2800 | Rake 0 
Board [Jc Ah As Qs 3c]
Seat 3: 1DMITRYSPb1 (button) folded before Flop (didn't bet)
Seat 4: llleopold (small blind) folded before Flop
Seat 5: dfcastro.net (big blind) showed [2d 9c] and lost with a pair of Aces
Seat 7: kesia545 showed [7d 7c] and won (2800) with two pair, Aces and Sevens
Seat 8: dr.Prokhor folded before Flop (didn't bet)



PokerStars Hand #98800016036: Tournament #734961465, $0.23+$0.02 USD Hold'em No Limit - Level XII (500/1000) - 2013/05/19 12:02:39 BRT [2013/05/19 11:02:39 ET]
Table '734961465 2' 9-max Seat #4 is the button
Seat 3: 1DMITRYSPb1 (4387 in chips) 
Seat 4: llleopold (18171 in chips) 
Seat 5: dfcastro.net (5168 in chips) 
Seat 7: kesia545 (32902 in chips) 
Seat 8: dr.Prokhor (6872 in chips) 
1DMITRYSPb1: posts the ante 60
llleopold: posts the ante 60
dfcastro.net: posts the ante 60
kesia545: posts the ante 60
dr.Prokhor: posts the ante 60
dfcastro.net: posts small blind 500
kesia545: posts big blind 1000
*** HOLE CARDS ***
Dealt to dfcastro.net [Jc Ks]
dr.Prokhor: folds 
1DMITRYSPb1: folds 
llleopold: folds 
dfcastro.net: raises 4108 to 5108 and is all-in
kesia545: folds 
Uncalled bet (4108) returned to dfcastro.net
dfcastro.net collected 2300 from pot
dfcastro.net: doesn't show hand 
*** SUMMARY ***
Total pot 2300 | Rake 0 
Seat 3: 1DMITRYSPb1 folded before Flop (didn't bet)
Seat 4: llleopold (button) folded before Flop (didn't bet)
Seat 5: dfcastro.net (small blind) collected (2300)
Seat 7: kesia545 (big blind) folded before Flop
Seat 8: dr.Prokhor folded before Flop (didn't bet)



PokerStars Hand #98800028128: Tournament #734961465, $0.23+$0.02 USD Hold'em No Limit - Level XII (500/1000) - 2013/05/19 12:02:55 BRT [2013/05/19 11:02:55 ET]
Table '734961465 2' 9-max Seat #5 is the button
Seat 3: 1DMITRYSPb1 (4327 in chips) 
Seat 4: llleopold (18111 in chips) 
Seat 5: dfcastro.net (6408 in chips) 
Seat 7: kesia545 (31842 in chips) 
Seat 8: dr.Prokhor (6812 in chips) 
1DMITRYSPb1: posts the ante 60
llleopold: posts the ante 60
dfcastro.net: posts the ante 60
kesia545: posts the ante 60
dr.Prokhor: posts the ante 60
kesia545: posts small blind 500
dr.Prokhor: posts big blind 1000
*** HOLE CARDS ***
Dealt to dfcastro.net [Qs 4c]
1DMITRYSPb1: folds 
llleopold: folds 
dfcastro.net: folds 
kesia545: folds 
Uncalled bet (500) returned to dr.Prokhor
dr.Prokhor collected 1300 from pot
dr.Prokhor: doesn't show hand 
*** SUMMARY ***
Total pot 1300 | Rake 0 
Seat 3: 1DMITRYSPb1 folded before Flop (didn't bet)
Seat 4: llleopold folded before Flop (didn't bet)
Seat 5: dfcastro.net (button) folded before Flop (didn't bet)
Seat 7: kesia545 (small blind) folded before Flop
Seat 8: dr.Prokhor (big blind) collected (1300)



PokerStars Hand #98800037033: Tournament #734961465, $0.23+$0.02 USD Hold'em No Limit - Level XII (500/1000) - 2013/05/19 12:03:07 BRT [2013/05/19 11:03:07 ET]
Table '734961465 2' 9-max Seat #7 is the button
Seat 3: 1DMITRYSPb1 (4267 in chips) 
Seat 4: llleopold (18051 in chips) 
Seat 5: dfcastro.net (6348 in chips) 
Seat 7: kesia545 (31282 in chips) 
Seat 8: dr.Prokhor (7552 in chips) 
1DMITRYSPb1: posts the ante 60
llleopold: posts the ante 60
dfcastro.net: posts the ante 60
kesia545: posts the ante 60
dr.Prokhor: posts the ante 60
dr.Prokhor: posts small blind 500
1DMITRYSPb1: posts big blind 1000
*** HOLE CARDS ***
Dealt to dfcastro.net [9c Js]
llleopold: raises 1070 to 2070
dfcastro.net: folds 
kesia545: calls 2070
dr.Prokhor: folds 
1DMITRYSPb1: folds 
*** FLOP *** [Ah 4d 4c]
llleopold: bets 4039
kesia545: folds 
Uncalled bet (4039) returned to llleopold
llleopold collected 5940 from pot
llleopold: doesn't show hand 
*** SUMMARY ***
Total pot 5940 | Rake 0 
Board [Ah 4d 4c]
Seat 3: 1DMITRYSPb1 (big blind) folded before Flop
Seat 4: llleopold collected (5940)
Seat 5: dfcastro.net folded before Flop (didn't bet)
Seat 7: kesia545 (button) folded on the Flop
Seat 8: dr.Prokhor (small blind) folded before Flop



PokerStars Hand #98800063549: Tournament #734961465, $0.23+$0.02 USD Hold'em No Limit - Level XIII (600/1200) - 2013/05/19 12:03:41 BRT [2013/05/19 11:03:41 ET]
Table '734961465 2' 9-max Seat #8 is the button
Seat 3: 1DMITRYSPb1 (3207 in chips) 
Seat 4: llleopold (21861 in chips) 
Seat 5: dfcastro.net (6288 in chips) 
Seat 7: kesia545 (29152 in chips) 
Seat 8: dr.Prokhor (6992 in chips) 
1DMITRYSPb1: posts the ante 75
llleopold: posts the ante 75
dfcastro.net: posts the ante 75
kesia545: posts the ante 75
dr.Prokhor: posts the ante 75
1DMITRYSPb1: posts small blind 600
llleopold: posts big blind 1200
*** HOLE CARDS ***
Dealt to dfcastro.net [Ac Ad]
dfcastro.net: raises 1440 to 2640
kesia545: folds 
dr.Prokhor: folds 
1DMITRYSPb1: folds 
llleopold: folds 
Uncalled bet (1440) returned to dfcastro.net
dfcastro.net collected 3375 from pot
dfcastro.net: doesn't show hand 
*** SUMMARY ***
Total pot 3375 | Rake 0 
Seat 3: 1DMITRYSPb1 (small blind) folded before Flop
Seat 4: llleopold (big blind) folded before Flop
Seat 5: dfcastro.net collected (3375)
Seat 7: kesia545 folded before Flop (didn't bet)
Seat 8: dr.Prokhor (button) folded before Flop (didn't bet)



PokerStars Hand #98800076673: Tournament #734961465, $0.23+$0.02 USD Hold'em No Limit - Level XIII (600/1200) - 2013/05/19 12:03:58 BRT [2013/05/19 11:03:58 ET]
Table '734961465 2' 9-max Seat #3 is the button
Seat 3: 1DMITRYSPb1 (2532 in chips) 
Seat 4: llleopold (20586 in chips) 
Seat 5: dfcastro.net (8388 in chips) 
Seat 7: kesia545 (29077 in chips) 
Seat 8: dr.Prokhor (6917 in chips) 
1DMITRYSPb1: posts the ante 75
llleopold: posts the ante 75
dfcastro.net: posts the ante 75
kesia545: posts the ante 75
dr.Prokhor: posts the ante 75
llleopold: posts small blind 600
dfcastro.net: posts big blind 1200
*** HOLE CARDS ***
Dealt to dfcastro.net [8d 8h]
kesia545: folds 
dr.Prokhor: folds 
1DMITRYSPb1: folds 
llleopold: folds 
Uncalled bet (600) returned to dfcastro.net
dfcastro.net collected 1575 from pot
dfcastro.net: doesn't show hand 
*** SUMMARY ***
Total pot 1575 | Rake 0 
Seat 3: 1DMITRYSPb1 (button) folded before Flop (didn't bet)
Seat 4: llleopold (small blind) folded before Flop
Seat 5: dfcastro.net (big blind) collected (1575)
Seat 7: kesia545 folded before Flop (didn't bet)
Seat 8: dr.Prokhor folded before Flop (didn't bet)



PokerStars Hand #98800093220: Tournament #734961465, $0.23+$0.02 USD Hold'em No Limit - Level XIII (600/1200) - 2013/05/19 12:04:19 BRT [2013/05/19 11:04:19 ET]
Table '734961465 2' 9-max Seat #4 is the button
Seat 3: 1DMITRYSPb1 (2457 in chips) 
Seat 4: llleopold (19911 in chips) 
Seat 5: dfcastro.net (9288 in chips) 
Seat 7: kesia545 (29002 in chips) 
Seat 8: dr.Prokhor (6842 in chips) 
1DMITRYSPb1: posts the ante 75
llleopold: posts the ante 75
dfcastro.net: posts the ante 75
kesia545: posts the ante 75
dr.Prokhor: posts the ante 75
dfcastro.net: posts small blind 600
kesia545: posts big blind 1200
*** HOLE CARDS ***
Dealt to dfcastro.net [5c 9s]
dr.Prokhor: folds 
1DMITRYSPb1: folds 
llleopold: raises 1284 to 2484
dfcastro.net: folds 
kesia545: folds 
Uncalled bet (1284) returned to llleopold
llleopold collected 3375 from pot
llleopold: doesn't show hand 
*** SUMMARY ***
Total pot 3375 | Rake 0 
Seat 3: 1DMITRYSPb1 folded before Flop (didn't bet)
Seat 4: llleopold (button) collected (3375)
Seat 5: dfcastro.net (small blind) folded before Flop
Seat 7: kesia545 (big blind) folded before Flop
Seat 8: dr.Prokhor folded before Flop (didn't bet)



PokerStars Hand #98800114505: Tournament #734961465, $0.23+$0.02 USD Hold'em No Limit - Level XIII (600/1200) - 2013/05/19 12:04:47 BRT [2013/05/19 11:04:47 ET]
Table '734961465 2' 9-max Seat #5 is the button
Seat 3: 1DMITRYSPb1 (2382 in chips) 
Seat 4: llleopold (22011 in chips) 
Seat 5: dfcastro.net (8613 in chips) 
Seat 7: kesia545 (27727 in chips) 
Seat 8: dr.Prokhor (6767 in chips) 
1DMITRYSPb1: posts the ante 75
llleopold: posts the ante 75
dfcastro.net: posts the ante 75
kesia545: posts the ante 75
dr.Prokhor: posts the ante 75
kesia545: posts small blind 600
dr.Prokhor: posts big blind 1200
*** HOLE CARDS ***
Dealt to dfcastro.net [6h 2d]
1DMITRYSPb1: folds 
llleopold: folds 
dfcastro.net: folds 
kesia545: calls 600
dr.Prokhor: checks 
*** FLOP *** [9d 2s Ts]
kesia545: checks 
dr.Prokhor: checks 
*** TURN *** [9d 2s Ts] [Ac]
kesia545: checks 
dr.Prokhor: checks 
*** RIVER *** [9d 2s Ts Ac] [7c]
kesia545: checks 
dr.Prokhor: bets 1800
kesia545: folds 
Uncalled bet (1800) returned to dr.Prokhor
dr.Prokhor collected 2775 from pot
*** SUMMARY ***
Total pot 2775 | Rake 0 
Board [9d 2s Ts Ac 7c]
Seat 3: 1DMITRYSPb1 folded before Flop (didn't bet)
Seat 4: llleopold folded before Flop (didn't bet)
Seat 5: dfcastro.net (button) folded before Flop (didn't bet)
Seat 7: kesia545 (small blind) folded on the River
Seat 8: dr.Prokhor (big blind) collected (2775)



PokerStars Hand #98800140978: Tournament #734961465, $0.23+$0.02 USD Hold'em No Limit - Level XIII (600/1200) - 2013/05/19 12:05:21 BRT [2013/05/19 11:05:21 ET]
Table '734961465 2' 9-max Seat #7 is the button
Seat 3: 1DMITRYSPb1 (2307 in chips) 
Seat 4: llleopold (21936 in chips) 
Seat 5: dfcastro.net (8538 in chips) 
Seat 7: kesia545 (26452 in chips) 
Seat 8: dr.Prokhor (8267 in chips) 
1DMITRYSPb1: posts the ante 75
llleopold: posts the ante 75
dfcastro.net: posts the ante 75
kesia545: posts the ante 75
dr.Prokhor: posts the ante 75
dr.Prokhor: posts small blind 600
1DMITRYSPb1: posts big blind 1200
*** HOLE CARDS ***
Dealt to dfcastro.net [Qc 5s]
llleopold: folds 
dfcastro.net: folds 
kesia545: folds 
dr.Prokhor: folds 
Uncalled bet (600) returned to 1DMITRYSPb1
1DMITRYSPb1 collected 1575 from pot
1DMITRYSPb1: doesn't show hand 
*** SUMMARY ***
Total pot 1575 | Rake 0 
Seat 3: 1DMITRYSPb1 (big blind) collected (1575)
Seat 4: llleopold folded before Flop (didn't bet)
Seat 5: dfcastro.net folded before Flop (didn't bet)
Seat 7: kesia545 (button) folded before Flop (didn't bet)
Seat 8: dr.Prokhor (small blind) folded before Flop



PokerStars Hand #98800151769: Tournament #734961465, $0.23+$0.02 USD Hold'em No Limit - Level XIII (600/1200) - 2013/05/19 12:05:35 BRT [2013/05/19 11:05:35 ET]
Table '734961465 2' 9-max Seat #8 is the button
Seat 3: 1DMITRYSPb1 (3207 in chips) 
Seat 4: llleopold (21861 in chips) 
Seat 5: dfcastro.net (8463 in chips) 
Seat 7: kesia545 (26377 in chips) 
Seat 8: dr.Prokhor (7592 in chips) 
1DMITRYSPb1: posts the ante 75
llleopold: posts the ante 75
dfcastro.net: posts the ante 75
kesia545: posts the ante 75
dr.Prokhor: posts the ante 75
1DMITRYSPb1: posts small blind 600
llleopold: posts big blind 1200
*** HOLE CARDS ***
Dealt to dfcastro.net [Th As]
dfcastro.net: raises 1440 to 2640
kesia545: folds 
dr.Prokhor: folds 
1DMITRYSPb1: folds 
llleopold: folds 
Uncalled bet (1440) returned to dfcastro.net
dfcastro.net collected 3375 from pot
dfcastro.net: doesn't show hand 
*** SUMMARY ***
Total pot 3375 | Rake 0 
Seat 3: 1DMITRYSPb1 (small blind) folded before Flop
Seat 4: llleopold (big blind) folded before Flop
Seat 5: dfcastro.net collected (3375)
Seat 7: kesia545 folded before Flop (didn't bet)
Seat 8: dr.Prokhor (button) folded before Flop (didn't bet)



PokerStars Hand #98800165508: Tournament #734961465, $0.23+$0.02 USD Hold'em No Limit - Level XIII (600/1200) - 2013/05/19 12:05:52 BRT [2013/05/19 11:05:52 ET]
Table '734961465 2' 9-max Seat #3 is the button
Seat 3: 1DMITRYSPb1 (2532 in chips) 
Seat 4: llleopold (20586 in chips) 
Seat 5: dfcastro.net (10563 in chips) 
Seat 7: kesia545 (26302 in chips) 
Seat 8: dr.Prokhor (7517 in chips) 
1DMITRYSPb1: posts the ante 75
llleopold: posts the ante 75
dfcastro.net: posts the ante 75
kesia545: posts the ante 75
dr.Prokhor: posts the ante 75
llleopold: posts small blind 600
dfcastro.net: posts big blind 1200
*** HOLE CARDS ***
Dealt to dfcastro.net [3s Ac]
kesia545: folds 
dr.Prokhor: folds 
1DMITRYSPb1: raises 1257 to 2457 and is all-in
llleopold: folds 
dfcastro.net: calls 1257
*** FLOP *** [Kc 2s 8d]
*** TURN *** [Kc 2s 8d] [Jd]
*** RIVER *** [Kc 2s 8d Jd] [9s]
*** SHOW DOWN ***
dfcastro.net: shows [3s Ac] (high card Ace)
1DMITRYSPb1: shows [Kh 5h] (a pair of Kings)
1DMITRYSPb1 collected 5889 from pot
*** SUMMARY ***
Total pot 5889 | Rake 0 
Board [Kc 2s 8d Jd 9s]
Seat 3: 1DMITRYSPb1 (button) showed [Kh 5h] and won (5889) with a pair of Kings
Seat 4: llleopold (small blind) folded before Flop
Seat 5: dfcastro.net (big blind) showed [3s Ac] and lost with high card Ace
Seat 7: kesia545 folded before Flop (didn't bet)
Seat 8: dr.Prokhor folded before Flop (didn't bet)



PokerStars Hand #98800185152: Tournament #734961465, $0.23+$0.02 USD Hold'em No Limit - Level XIII (600/1200) - 2013/05/19 12:06:17 BRT [2013/05/19 11:06:17 ET]
Table '734961465 2' 9-max Seat #4 is the button
Seat 3: 1DMITRYSPb1 (5889 in chips) 
Seat 4: llleopold (19911 in chips) 
Seat 5: dfcastro.net (8031 in chips) 
Seat 7: kesia545 (26227 in chips) 
Seat 8: dr.Prokhor (7442 in chips) 
1DMITRYSPb1: posts the ante 75
llleopold: posts the ante 75
dfcastro.net: posts the ante 75
kesia545: posts the ante 75
dr.Prokhor: posts the ante 75
dfcastro.net: posts small blind 600
kesia545: posts big blind 1200
*** HOLE CARDS ***
Dealt to dfcastro.net [5c Qh]
dr.Prokhor: folds 
1DMITRYSPb1: folds 
llleopold: folds 
dfcastro.net: folds 
Uncalled bet (600) returned to kesia545
kesia545 collected 1575 from pot
kesia545: doesn't show hand 
*** SUMMARY ***
Total pot 1575 | Rake 0 
Seat 3: 1DMITRYSPb1 folded before Flop (didn't bet)
Seat 4: llleopold (button) folded before Flop (didn't bet)
Seat 5: dfcastro.net (small blind) folded before Flop
Seat 7: kesia545 (big blind) collected (1575)
Seat 8: dr.Prokhor folded before Flop (didn't bet)



PokerStars Hand #98800200699: Tournament #734961465, $0.23+$0.02 USD Hold'em No Limit - Level XIII (600/1200) - 2013/05/19 12:06:37 BRT [2013/05/19 11:06:37 ET]
Table '734961465 2' 9-max Seat #5 is the button
Seat 3: 1DMITRYSPb1 (5814 in chips) 
Seat 4: llleopold (19836 in chips) 
Seat 5: dfcastro.net (7356 in chips) 
Seat 7: kesia545 (27127 in chips) 
Seat 8: dr.Prokhor (7367 in chips) 
1DMITRYSPb1: posts the ante 75
llleopold: posts the ante 75
dfcastro.net: posts the ante 75
kesia545: posts the ante 75
dr.Prokhor: posts the ante 75
kesia545: posts small blind 600
dr.Prokhor: posts big blind 1200
*** HOLE CARDS ***
Dealt to dfcastro.net [9d 9c]
1DMITRYSPb1: raises 4539 to 5739 and is all-in
llleopold: folds 
dfcastro.net: raises 1542 to 7281 and is all-in
kesia545: folds 
dr.Prokhor: folds 
Uncalled bet (1542) returned to dfcastro.net
*** FLOP *** [9s Kh Tc]
*** TURN *** [9s Kh Tc] [2c]
*** RIVER *** [9s Kh Tc 2c] [3h]
*** SHOW DOWN ***
1DMITRYSPb1: shows [As 6d] (high card Ace)
dfcastro.net: shows [9d 9c] (three of a kind, Nines)
dfcastro.net collected 13653 from pot
1DMITRYSPb1 finished the tournament in 5th place and received $0.93.
*** SUMMARY ***
Total pot 13653 | Rake 0 
Board [9s Kh Tc 2c 3h]
Seat 3: 1DMITRYSPb1 showed [As 6d] and lost with high card Ace
Seat 4: llleopold folded before Flop (didn't bet)
Seat 5: dfcastro.net (button) showed [9d 9c] and won (13653) with three of a kind, Nines
Seat 7: kesia545 (small blind) folded before Flop
Seat 8: dr.Prokhor (big blind) folded before Flop



PokerStars Hand #98800221320: Tournament #734961465, $0.23+$0.02 USD Hold'em No Limit - Level XIII (600/1200) - 2013/05/19 12:07:03 BRT [2013/05/19 11:07:03 ET]
Table '734961465 2' 9-max Seat #7 is the button
Seat 4: llleopold (19761 in chips) 
Seat 5: dfcastro.net (15195 in chips) 
Seat 7: kesia545 (26452 in chips) 
Seat 8: dr.Prokhor (6092 in chips) 
llleopold: posts the ante 75
dfcastro.net: posts the ante 75
kesia545: posts the ante 75
dr.Prokhor: posts the ante 75
dr.Prokhor: posts small blind 600
llleopold: posts big blind 1200
*** HOLE CARDS ***
Dealt to dfcastro.net [5h 3h]
dfcastro.net: folds 
kesia545: folds 
dr.Prokhor: folds 
Uncalled bet (600) returned to llleopold
llleopold collected 1500 from pot
llleopold: doesn't show hand 
*** SUMMARY ***
Total pot 1500 | Rake 0 
Seat 4: llleopold (big blind) collected (1500)
Seat 5: dfcastro.net folded before Flop (didn't bet)
Seat 7: kesia545 (button) folded before Flop (didn't bet)
Seat 8: dr.Prokhor (small blind) folded before Flop



PokerStars Hand #98800229211: Tournament #734961465, $0.23+$0.02 USD Hold'em No Limit - Level XIII (600/1200) - 2013/05/19 12:07:14 BRT [2013/05/19 11:07:14 ET]
Table '734961465 2' 9-max Seat #8 is the button
Seat 4: llleopold (20586 in chips) 
Seat 5: dfcastro.net (15120 in chips) 
Seat 7: kesia545 (26377 in chips) 
Seat 8: dr.Prokhor (5417 in chips) 
llleopold: posts the ante 75
dfcastro.net: posts the ante 75
kesia545: posts the ante 75
dr.Prokhor: posts the ante 75
llleopold: posts small blind 600
dfcastro.net: posts big blind 1200
*** HOLE CARDS ***
Dealt to dfcastro.net [3c 5c]
kesia545: calls 1200
dr.Prokhor: folds 
llleopold: folds 
dfcastro.net: checks 
*** FLOP *** [3d 2h Kd]
dfcastro.net: checks 
kesia545: checks 
*** TURN *** [3d 2h Kd] [2s]
dfcastro.net: checks 
kesia545: checks 
*** RIVER *** [3d 2h Kd 2s] [8d]
dfcastro.net: checks 
kesia545: checks 
*** SHOW DOWN ***
dfcastro.net: shows [3c 5c] (two pair, Threes and Deuces)
kesia545: mucks hand 
dfcastro.net collected 3300 from pot
*** SUMMARY ***
Total pot 3300 | Rake 0 
Board [3d 2h Kd 2s 8d]
Seat 4: llleopold (small blind) folded before Flop
Seat 5: dfcastro.net (big blind) showed [3c 5c] and won (3300) with two pair, Threes and Deuces
Seat 7: kesia545 mucked [Ad Jc]
Seat 8: dr.Prokhor (button) folded before Flop (didn't bet)



PokerStars Hand #98800256494: Tournament #734961465, $0.23+$0.02 USD Hold'em No Limit - Level XIII (600/1200) - 2013/05/19 12:07:48 BRT [2013/05/19 11:07:48 ET]
Table '734961465 2' 9-max Seat #4 is the button
Seat 4: llleopold (19911 in chips) 
Seat 5: dfcastro.net (17145 in chips) 
Seat 7: kesia545 (25102 in chips) 
Seat 8: dr.Prokhor (5342 in chips) 
llleopold: posts the ante 75
dfcastro.net: posts the ante 75
kesia545: posts the ante 75
dr.Prokhor: posts the ante 75
dfcastro.net: posts small blind 600
kesia545: posts big blind 1200
*** HOLE CARDS ***
Dealt to dfcastro.net [Js 3h]
dr.Prokhor: folds 
llleopold: folds 
dfcastro.net: folds 
Uncalled bet (600) returned to kesia545
kesia545 collected 1500 from pot
kesia545: doesn't show hand 
*** SUMMARY ***
Total pot 1500 | Rake 0 
Seat 4: llleopold (button) folded before Flop (didn't bet)
Seat 5: dfcastro.net (small blind) folded before Flop
Seat 7: kesia545 (big blind) collected (1500)
Seat 8: dr.Prokhor folded before Flop (didn't bet)



PokerStars Hand #98800272695: Tournament #734961465, $0.23+$0.02 USD Hold'em No Limit - Level XIII (600/1200) - 2013/05/19 12:08:09 BRT [2013/05/19 11:08:09 ET]
Table '734961465 2' 9-max Seat #5 is the button
Seat 4: llleopold (19836 in chips) 
Seat 5: dfcastro.net (16470 in chips) 
Seat 7: kesia545 (25927 in chips) 
Seat 8: dr.Prokhor (5267 in chips) 
llleopold: posts the ante 75
dfcastro.net: posts the ante 75
kesia545: posts the ante 75
dr.Prokhor: posts the ante 75
kesia545: posts small blind 600
dr.Prokhor: posts big blind 1200
*** HOLE CARDS ***
Dealt to dfcastro.net [5c 2c]
llleopold: raises 1284 to 2484
dfcastro.net: folds 
kesia545: folds 
dr.Prokhor: raises 2708 to 5192 and is all-in
llleopold: calls 2708
*** FLOP *** [4c Kd 9h]
*** TURN *** [4c Kd 9h] [5d]
*** RIVER *** [4c Kd 9h 5d] [6h]
*** SHOW DOWN ***
dr.Prokhor: shows [7h Ac] (high card Ace)
llleopold: shows [Jh Ks] (a pair of Kings)
llleopold collected 11284 from pot
dr.Prokhor finished the tournament in 4th place and received $1.29.
*** SUMMARY ***
Total pot 11284 | Rake 0 
Board [4c Kd 9h 5d 6h]
Seat 4: llleopold showed [Jh Ks] and won (11284) with a pair of Kings
Seat 5: dfcastro.net (button) folded before Flop (didn't bet)
Seat 7: kesia545 (small blind) folded before Flop
Seat 8: dr.Prokhor (big blind) showed [7h Ac] and lost with high card Ace



PokerStars Hand #98800297119: Tournament #734961465, $0.23+$0.02 USD Hold'em No Limit - Level XIII (600/1200) - 2013/05/19 12:08:40 BRT [2013/05/19 11:08:40 ET]
Table '734961465 2' 9-max Seat #7 is the button
Seat 4: llleopold (25853 in chips) 
Seat 5: dfcastro.net (16395 in chips) 
Seat 7: kesia545 (25252 in chips) 
llleopold: posts the ante 75
dfcastro.net: posts the ante 75
kesia545: posts the ante 75
llleopold: posts small blind 600
dfcastro.net: posts big blind 1200
*** HOLE CARDS ***
Dealt to dfcastro.net [2h 3h]
kesia545: folds 
llleopold: folds 
Uncalled bet (600) returned to dfcastro.net
dfcastro.net collected 1425 from pot
dfcastro.net: doesn't show hand 
*** SUMMARY ***
Total pot 1425 | Rake 0 
Seat 4: llleopold (small blind) folded before Flop
Seat 5: dfcastro.net (big blind) collected (1425)
Seat 7: kesia545 (button) folded before Flop (didn't bet)



PokerStars Hand #98800303672: Tournament #734961465, $0.23+$0.02 USD Hold'em No Limit - Level XIII (600/1200) - 2013/05/19 12:08:49 BRT [2013/05/19 11:08:49 ET]
Table '734961465 2' 9-max Seat #4 is the button
Seat 4: llleopold (25178 in chips) 
Seat 5: dfcastro.net (17145 in chips) 
Seat 7: kesia545 (25177 in chips) 
llleopold: posts the ante 75
dfcastro.net: posts the ante 75
kesia545: posts the ante 75
dfcastro.net: posts small blind 600
kesia545: posts big blind 1200
*** HOLE CARDS ***
Dealt to dfcastro.net [Td 6d]
llleopold: folds 
dfcastro.net: folds 
Uncalled bet (600) returned to kesia545
kesia545 collected 1425 from pot
*** SUMMARY ***
Total pot 1425 | Rake 0 
Seat 4: llleopold (button) folded before Flop (didn't bet)
Seat 5: dfcastro.net (small blind) folded before Flop
Seat 7: kesia545 (big blind) collected (1425)



PokerStars Hand #98800312906: Tournament #734961465, $0.23+$0.02 USD Hold'em No Limit - Level XIII (600/1200) - 2013/05/19 12:09:01 BRT [2013/05/19 11:09:01 ET]
Table '734961465 2' 9-max Seat #5 is the button
Seat 4: llleopold (25103 in chips) 
Seat 5: dfcastro.net (16470 in chips) 
Seat 7: kesia545 (25927 in chips) 
llleopold: posts the ante 75
dfcastro.net: posts the ante 75
kesia545: posts the ante 75
kesia545: posts small blind 600
llleopold: posts big blind 1200
*** HOLE CARDS ***
Dealt to dfcastro.net [Js Qd]
dfcastro.net: raises 15195 to 16395 and is all-in
kesia545: folds 
llleopold: folds 
Uncalled bet (15195) returned to dfcastro.net
dfcastro.net collected 3225 from pot
dfcastro.net: doesn't show hand 
*** SUMMARY ***
Total pot 3225 | Rake 0 
Seat 4: llleopold (big blind) folded before Flop
Seat 5: dfcastro.net (button) collected (3225)
Seat 7: kesia545 (small blind) folded before Flop



PokerStars Hand #98800325645: Tournament #734961465, $0.23+$0.02 USD Hold'em No Limit - Level XIII (600/1200) - 2013/05/19 12:09:17 BRT [2013/05/19 11:09:17 ET]
Table '734961465 2' 9-max Seat #7 is the button
Seat 4: llleopold (23828 in chips) 
Seat 5: dfcastro.net (18420 in chips) 
Seat 7: kesia545 (25252 in chips) 
llleopold: posts the ante 75
dfcastro.net: posts the ante 75
kesia545: posts the ante 75
llleopold: posts small blind 600
dfcastro.net: posts big blind 1200
*** HOLE CARDS ***
Dealt to dfcastro.net [9s 9d]
kesia545: folds 
llleopold: folds 
Uncalled bet (600) returned to dfcastro.net
dfcastro.net collected 1425 from pot
dfcastro.net: doesn't show hand 
*** SUMMARY ***
Total pot 1425 | Rake 0 
Seat 4: llleopold (small blind) folded before Flop
Seat 5: dfcastro.net (big blind) collected (1425)
Seat 7: kesia545 (button) folded before Flop (didn't bet)



PokerStars Hand #98800336496: Tournament #734961465, $0.23+$0.02 USD Hold'em No Limit - Level XIII (600/1200) - 2013/05/19 12:09:31 BRT [2013/05/19 11:09:31 ET]
Table '734961465 2' 9-max Seat #4 is the button
Seat 4: llleopold (23153 in chips) 
Seat 5: dfcastro.net (19170 in chips) 
Seat 7: kesia545 (25177 in chips) 
llleopold: posts the ante 75
dfcastro.net: posts the ante 75
kesia545: posts the ante 75
dfcastro.net: posts small blind 600
kesia545: posts big blind 1200
*** HOLE CARDS ***
Dealt to dfcastro.net [Td 7s]
llleopold: folds 
dfcastro.net: folds 
Uncalled bet (600) returned to kesia545
kesia545 collected 1425 from pot
*** SUMMARY ***
Total pot 1425 | Rake 0 
Seat 4: llleopold (button) folded before Flop (didn't bet)
Seat 5: dfcastro.net (small blind) folded before Flop
Seat 7: kesia545 (big blind) collected (1425)



PokerStars Hand #98800342854: Tournament #734961465, $0.23+$0.02 USD Hold'em No Limit - Level XIII (600/1200) - 2013/05/19 12:09:40 BRT [2013/05/19 11:09:40 ET]
Table '734961465 2' 9-max Seat #5 is the button
Seat 4: llleopold (23078 in chips) 
Seat 5: dfcastro.net (18495 in chips) 
Seat 7: kesia545 (25927 in chips) 
llleopold: posts the ante 75
dfcastro.net: posts the ante 75
kesia545: posts the ante 75
kesia545: posts small blind 600
llleopold: posts big blind 1200
*** HOLE CARDS ***
Dealt to dfcastro.net [Ad 9d]
dfcastro.net: raises 17220 to 18420 and is all-in
kesia545: folds 
llleopold: folds 
Uncalled bet (17220) returned to dfcastro.net
dfcastro.net collected 3225 from pot
dfcastro.net: doesn't show hand 
*** SUMMARY ***
Total pot 3225 | Rake 0 
Seat 4: llleopold (big blind) folded before Flop
Seat 5: dfcastro.net (button) collected (3225)
Seat 7: kesia545 (small blind) folded before Flop



PokerStars Hand #98800363939: Tournament #734961465, $0.23+$0.02 USD Hold'em No Limit - Level XIII (600/1200) - 2013/05/19 12:10:07 BRT [2013/05/19 11:10:07 ET]
Table '734961465 2' 9-max Seat #7 is the button
Seat 4: llleopold (21803 in chips) 
Seat 5: dfcastro.net (20445 in chips) 
Seat 7: kesia545 (25252 in chips) 
llleopold: posts the ante 75
dfcastro.net: posts the ante 75
kesia545: posts the ante 75
llleopold: posts small blind 600
dfcastro.net: posts big blind 1200
*** HOLE CARDS ***
Dealt to dfcastro.net [6d 8h]
kesia545: folds 
llleopold: raises 20528 to 21728 and is all-in
dfcastro.net: folds 
Uncalled bet (20528) returned to llleopold
llleopold collected 2625 from pot
llleopold: doesn't show hand 
*** SUMMARY ***
Total pot 2625 | Rake 0 
Seat 4: llleopold (small blind) collected (2625)
Seat 5: dfcastro.net (big blind) folded before Flop
Seat 7: kesia545 (button) folded before Flop (didn't bet)



PokerStars Hand #98800374037: Tournament #734961465, $0.23+$0.02 USD Hold'em No Limit - Level XIII (600/1200) - 2013/05/19 12:10:20 BRT [2013/05/19 11:10:20 ET]
Table '734961465 2' 9-max Seat #4 is the button
Seat 4: llleopold (23153 in chips) 
Seat 5: dfcastro.net (19170 in chips) 
Seat 7: kesia545 (25177 in chips) 
llleopold: posts the ante 75
dfcastro.net: posts the ante 75
kesia545: posts the ante 75
dfcastro.net: posts small blind 600
kesia545: posts big blind 1200
*** HOLE CARDS ***
Dealt to dfcastro.net [Ah 6s]
llleopold: raises 1284 to 2484
dfcastro.net: folds 
kesia545: folds 
Uncalled bet (1284) returned to llleopold
llleopold collected 3225 from pot
llleopold: doesn't show hand 
*** SUMMARY ***
Total pot 3225 | Rake 0 
Seat 4: llleopold (button) collected (3225)
Seat 5: dfcastro.net (small blind) folded before Flop
Seat 7: kesia545 (big blind) folded before Flop



PokerStars Hand #98800385551: Tournament #734961465, $0.23+$0.02 USD Hold'em No Limit - Level XIII (600/1200) - 2013/05/19 12:10:35 BRT [2013/05/19 11:10:35 ET]
Table '734961465 2' 9-max Seat #5 is the button
Seat 4: llleopold (25103 in chips) 
Seat 5: dfcastro.net (18495 in chips) 
Seat 7: kesia545 (23902 in chips) 
llleopold: posts the ante 75
dfcastro.net: posts the ante 75
kesia545: posts the ante 75
kesia545: posts small blind 600
llleopold: posts big blind 1200
*** HOLE CARDS ***
Dealt to dfcastro.net [Qd Qs]
dfcastro.net: raises 17220 to 18420 and is all-in
kesia545: folds 
llleopold: folds 
Uncalled bet (17220) returned to dfcastro.net
dfcastro.net collected 3225 from pot
dfcastro.net: doesn't show hand 
*** SUMMARY ***
Total pot 3225 | Rake 0 
Seat 4: llleopold (big blind) folded before Flop
Seat 5: dfcastro.net (button) collected (3225)
Seat 7: kesia545 (small blind) folded before Flop



PokerStars Hand #98800393723: Tournament #734961465, $0.23+$0.02 USD Hold'em No Limit - Level XIII (600/1200) - 2013/05/19 12:10:46 BRT [2013/05/19 11:10:46 ET]
Table '734961465 2' 9-max Seat #7 is the button
Seat 4: llleopold (23828 in chips) 
Seat 5: dfcastro.net (20445 in chips) 
Seat 7: kesia545 (23227 in chips) 
llleopold: posts the ante 75
dfcastro.net: posts the ante 75
kesia545: posts the ante 75
llleopold: posts small blind 600
dfcastro.net: posts big blind 1200
*** HOLE CARDS ***
Dealt to dfcastro.net [3d Qs]
kesia545: folds 
llleopold: folds 
Uncalled bet (600) returned to dfcastro.net
dfcastro.net collected 1425 from pot
dfcastro.net: doesn't show hand 
*** SUMMARY ***
Total pot 1425 | Rake 0 
Seat 4: llleopold (small blind) folded before Flop
Seat 5: dfcastro.net (big blind) collected (1425)
Seat 7: kesia545 (button) folded before Flop (didn't bet)



PokerStars Hand #98800401413: Tournament #734961465, $0.23+$0.02 USD Hold'em No Limit - Level XIII (600/1200) - 2013/05/19 12:10:56 BRT [2013/05/19 11:10:56 ET]
Table '734961465 2' 9-max Seat #4 is the button
Seat 4: llleopold (23153 in chips) 
Seat 5: dfcastro.net (21195 in chips) 
Seat 7: kesia545 (23152 in chips) 
llleopold: posts the ante 75
dfcastro.net: posts the ante 75
kesia545: posts the ante 75
dfcastro.net: posts small blind 600
kesia545: posts big blind 1200
*** HOLE CARDS ***
Dealt to dfcastro.net [4d 2s]
llleopold: raises 1284 to 2484
dfcastro.net: folds 
kesia545: folds 
Uncalled bet (1284) returned to llleopold
llleopold collected 3225 from pot
llleopold: doesn't show hand 
*** SUMMARY ***
Total pot 3225 | Rake 0 
Seat 4: llleopold (button) collected (3225)
Seat 5: dfcastro.net (small blind) folded before Flop
Seat 7: kesia545 (big blind) folded before Flop



PokerStars Hand #98800413607: Tournament #734961465, $0.23+$0.02 USD Hold'em No Limit - Level XIII (600/1200) - 2013/05/19 12:11:12 BRT [2013/05/19 11:11:12 ET]
Table '734961465 2' 9-max Seat #5 is the button
Seat 4: llleopold (25103 in chips) 
Seat 5: dfcastro.net (20520 in chips) 
Seat 7: kesia545 (21877 in chips) 
llleopold: posts the ante 75
dfcastro.net: posts the ante 75
kesia545: posts the ante 75
kesia545: posts small blind 600
llleopold: posts big blind 1200
*** HOLE CARDS ***
Dealt to dfcastro.net [Th 5h]
dfcastro.net: folds 
kesia545: folds 
Uncalled bet (600) returned to llleopold
llleopold collected 1425 from pot
llleopold: doesn't show hand 
*** SUMMARY ***
Total pot 1425 | Rake 0 
Seat 4: llleopold (big blind) collected (1425)
Seat 5: dfcastro.net (button) folded before Flop (didn't bet)
Seat 7: kesia545 (small blind) folded before Flop



PokerStars Hand #98800419954: Tournament #734961465, $0.23+$0.02 USD Hold'em No Limit - Level XIII (600/1200) - 2013/05/19 12:11:20 BRT [2013/05/19 11:11:20 ET]
Table '734961465 2' 9-max Seat #7 is the button
Seat 4: llleopold (25853 in chips) 
Seat 5: dfcastro.net (20445 in chips) 
Seat 7: kesia545 (21202 in chips) 
llleopold: posts the ante 75
dfcastro.net: posts the ante 75
kesia545: posts the ante 75
llleopold: posts small blind 600
dfcastro.net: posts big blind 1200
*** HOLE CARDS ***
Dealt to dfcastro.net [3s 6c]
kesia545: folds 
llleopold: folds 
Uncalled bet (600) returned to dfcastro.net
dfcastro.net collected 1425 from pot
dfcastro.net: doesn't show hand 
*** SUMMARY ***
Total pot 1425 | Rake 0 
Seat 4: llleopold (small blind) folded before Flop
Seat 5: dfcastro.net (big blind) collected (1425)
Seat 7: kesia545 (button) folded before Flop (didn't bet)



PokerStars Hand #98800427855: Tournament #734961465, $0.23+$0.02 USD Hold'em No Limit - Level XIII (600/1200) - 2013/05/19 12:11:30 BRT [2013/05/19 11:11:30 ET]
Table '734961465 2' 9-max Seat #4 is the button
Seat 4: llleopold (25178 in chips) 
Seat 5: dfcastro.net (21195 in chips) 
Seat 7: kesia545 (21127 in chips) 
llleopold: posts the ante 75
dfcastro.net: posts the ante 75
kesia545: posts the ante 75
dfcastro.net: posts small blind 600
kesia545: posts big blind 1200
*** HOLE CARDS ***
Dealt to dfcastro.net [5h 3d]
llleopold: folds 
dfcastro.net: folds 
Uncalled bet (600) returned to kesia545
kesia545 collected 1425 from pot
kesia545: doesn't show hand 
*** SUMMARY ***
Total pot 1425 | Rake 0 
Seat 4: llleopold (button) folded before Flop (didn't bet)
Seat 5: dfcastro.net (small blind) folded before Flop
Seat 7: kesia545 (big blind) collected (1425)



PokerStars Hand #98800435003: Tournament #734961465, $0.23+$0.02 USD Hold'em No Limit - Level XIII (600/1200) - 2013/05/19 12:11:39 BRT [2013/05/19 11:11:39 ET]
Table '734961465 2' 9-max Seat #5 is the button
Seat 4: llleopold (25103 in chips) 
Seat 5: dfcastro.net (20520 in chips) 
Seat 7: kesia545 (21877 in chips) 
llleopold: posts the ante 75
dfcastro.net: posts the ante 75
kesia545: posts the ante 75
kesia545: posts small blind 600
llleopold: posts big blind 1200
*** HOLE CARDS ***
Dealt to dfcastro.net [7s 9d]
dfcastro.net: folds 
kesia545: folds 
Uncalled bet (600) returned to llleopold
llleopold collected 1425 from pot
llleopold: doesn't show hand 
*** SUMMARY ***
Total pot 1425 | Rake 0 
Seat 4: llleopold (big blind) collected (1425)
Seat 5: dfcastro.net (button) folded before Flop (didn't bet)
Seat 7: kesia545 (small blind) folded before Flop



PokerStars Hand #98800440867: Tournament #734961465, $0.23+$0.02 USD Hold'em No Limit - Level XIII (600/1200) - 2013/05/19 12:11:46 BRT [2013/05/19 11:11:46 ET]
Table '734961465 2' 9-max Seat #7 is the button
Seat 4: llleopold (25853 in chips) 
Seat 5: dfcastro.net (20445 in chips) 
Seat 7: kesia545 (21202 in chips) 
llleopold: posts the ante 75
dfcastro.net: posts the ante 75
kesia545: posts the ante 75
llleopold: posts small blind 600
dfcastro.net: posts big blind 1200
*** HOLE CARDS ***
Dealt to dfcastro.net [2h 4d]
kesia545: folds 
llleopold: raises 1284 to 2484
dfcastro.net: folds 
Uncalled bet (1284) returned to llleopold
llleopold collected 2625 from pot
llleopold: doesn't show hand 
*** SUMMARY ***
Total pot 2625 | Rake 0 
Seat 4: llleopold (small blind) collected (2625)
Seat 5: dfcastro.net (big blind) folded before Flop
Seat 7: kesia545 (button) folded before Flop (didn't bet)



PokerStars Hand #98800451486: Tournament #734961465, $0.23+$0.02 USD Hold'em No Limit - Level XIII (600/1200) - 2013/05/19 12:12:00 BRT [2013/05/19 11:12:00 ET]
Table '734961465 2' 9-max Seat #4 is the button
Seat 4: llleopold (27203 in chips) 
Seat 5: dfcastro.net (19170 in chips) 
Seat 7: kesia545 (21127 in chips) 
llleopold: posts the ante 75
dfcastro.net: posts the ante 75
kesia545: posts the ante 75
dfcastro.net: posts small blind 600
kesia545: posts big blind 1200
*** HOLE CARDS ***
Dealt to dfcastro.net [Tc 5c]
llleopold: folds 
dfcastro.net: raises 1440 to 2640
kesia545: folds 
Uncalled bet (1440) returned to dfcastro.net
dfcastro.net collected 2625 from pot
dfcastro.net: doesn't show hand 
*** SUMMARY ***
Total pot 2625 | Rake 0 
Seat 4: llleopold (button) folded before Flop (didn't bet)
Seat 5: dfcastro.net (small blind) collected (2625)
Seat 7: kesia545 (big blind) folded before Flop



PokerStars Hand #98800462644: Tournament #734961465, $0.23+$0.02 USD Hold'em No Limit - Level XIII (600/1200) - 2013/05/19 12:12:14 BRT [2013/05/19 11:12:14 ET]
Table '734961465 2' 9-max Seat #5 is the button
Seat 4: llleopold (27128 in chips) 
Seat 5: dfcastro.net (20520 in chips) 
Seat 7: kesia545 (19852 in chips) 
llleopold: posts the ante 75
dfcastro.net: posts the ante 75
kesia545: posts the ante 75
kesia545: posts small blind 600
llleopold: posts big blind 1200
*** HOLE CARDS ***
Dealt to dfcastro.net [6h Qh]
dfcastro.net: folds 
kesia545: folds 
Uncalled bet (600) returned to llleopold
llleopold collected 1425 from pot
llleopold: doesn't show hand 
*** SUMMARY ***
Total pot 1425 | Rake 0 
Seat 4: llleopold (big blind) collected (1425)
Seat 5: dfcastro.net (button) folded before Flop (didn't bet)
Seat 7: kesia545 (small blind) folded before Flop



PokerStars Hand #98800469131: Tournament #734961465, $0.23+$0.02 USD Hold'em No Limit - Level XIII (600/1200) - 2013/05/19 12:12:23 BRT [2013/05/19 11:12:23 ET]
Table '734961465 2' 9-max Seat #7 is the button
Seat 4: llleopold (27878 in chips) 
Seat 5: dfcastro.net (20445 in chips) 
Seat 7: kesia545 (19177 in chips) 
llleopold: posts the ante 75
dfcastro.net: posts the ante 75
kesia545: posts the ante 75
llleopold: posts small blind 600
dfcastro.net: posts big blind 1200
*** HOLE CARDS ***
Dealt to dfcastro.net [8c Ts]
kesia545: calls 1200
llleopold: folds 
dfcastro.net: checks 
*** FLOP *** [2c 4c 7h]
dfcastro.net: checks 
kesia545: checks 
*** TURN *** [2c 4c 7h] [Tc]
dfcastro.net: checks 
kesia545: checks 
*** RIVER *** [2c 4c 7h Tc] [6d]
dfcastro.net: checks 
kesia545: checks 
*** SHOW DOWN ***
dfcastro.net: shows [8c Ts] (a pair of Tens)
kesia545: mucks hand 
dfcastro.net collected 3225 from pot
*** SUMMARY ***
Total pot 3225 | Rake 0 
Board [2c 4c 7h Tc 6d]
Seat 4: llleopold (small blind) folded before Flop
Seat 5: dfcastro.net (big blind) showed [8c Ts] and won (3225) with a pair of Tens
Seat 7: kesia545 (button) mucked [8d Ad]



PokerStars Hand #98800493679: Tournament #734961465, $0.23+$0.02 USD Hold'em No Limit - Level XIII (600/1200) - 2013/05/19 12:12:55 BRT [2013/05/19 11:12:55 ET]
Table '734961465 2' 9-max Seat #4 is the button
Seat 4: llleopold (27203 in chips) 
Seat 5: dfcastro.net (22395 in chips) 
Seat 7: kesia545 (17902 in chips) 
llleopold: posts the ante 75
dfcastro.net: posts the ante 75
kesia545: posts the ante 75
dfcastro.net: posts small blind 600
kesia545: posts big blind 1200
*** HOLE CARDS ***
Dealt to dfcastro.net [Qs 9d]
llleopold: folds 
dfcastro.net: raises 1440 to 2640
kesia545: folds 
Uncalled bet (1440) returned to dfcastro.net
dfcastro.net collected 2625 from pot
dfcastro.net: doesn't show hand 
*** SUMMARY ***
Total pot 2625 | Rake 0 
Seat 4: llleopold (button) folded before Flop (didn't bet)
Seat 5: dfcastro.net (small blind) collected (2625)
Seat 7: kesia545 (big blind) folded before Flop



PokerStars Hand #98800509329: Tournament #734961465, $0.23+$0.02 USD Hold'em No Limit - Level XIII (600/1200) - 2013/05/19 12:13:15 BRT [2013/05/19 11:13:15 ET]
Table '734961465 2' 9-max Seat #5 is the button
Seat 4: llleopold (27128 in chips) 
Seat 5: dfcastro.net (23745 in chips) 
Seat 7: kesia545 (16627 in chips) 
llleopold: posts the ante 75
dfcastro.net: posts the ante 75
kesia545: posts the ante 75
kesia545: posts small blind 600
llleopold: posts big blind 1200
*** HOLE CARDS ***
Dealt to dfcastro.net [5h 9s]
dfcastro.net: folds 
kesia545: folds 
Uncalled bet (600) returned to llleopold
llleopold collected 1425 from pot
llleopold: doesn't show hand 
*** SUMMARY ***
Total pot 1425 | Rake 0 
Seat 4: llleopold (big blind) collected (1425)
Seat 5: dfcastro.net (button) folded before Flop (didn't bet)
Seat 7: kesia545 (small blind) folded before Flop



PokerStars Hand #98800517778: Tournament #734961465, $0.23+$0.02 USD Hold'em No Limit - Level XIV (800/1600) - 2013/05/19 12:13:25 BRT [2013/05/19 11:13:25 ET]
Table '734961465 2' 9-max Seat #7 is the button
Seat 4: llleopold (27878 in chips) 
Seat 5: dfcastro.net (23670 in chips) 
Seat 7: kesia545 (15952 in chips) 
llleopold: posts the ante 75
dfcastro.net: posts the ante 75
kesia545: posts the ante 75
llleopold: posts small blind 800
dfcastro.net: posts big blind 1600
*** HOLE CARDS ***
Dealt to dfcastro.net [6c Qd]
kesia545: folds 
llleopold: folds 
Uncalled bet (800) returned to dfcastro.net
dfcastro.net collected 1825 from pot
dfcastro.net: doesn't show hand 
*** SUMMARY ***
Total pot 1825 | Rake 0 
Seat 4: llleopold (small blind) folded before Flop
Seat 5: dfcastro.net (big blind) collected (1825)
Seat 7: kesia545 (button) folded before Flop (didn't bet)



PokerStars Hand #98800523324: Tournament #734961465, $0.23+$0.02 USD Hold'em No Limit - Level XIV (800/1600) - 2013/05/19 12:13:33 BRT [2013/05/19 11:13:33 ET]
Table '734961465 2' 9-max Seat #4 is the button
Seat 4: llleopold (27003 in chips) 
Seat 5: dfcastro.net (24620 in chips) 
Seat 7: kesia545 (15877 in chips) 
llleopold: posts the ante 75
dfcastro.net: posts the ante 75
kesia545: posts the ante 75
dfcastro.net: posts small blind 800
kesia545: posts big blind 1600
*** HOLE CARDS ***
Dealt to dfcastro.net [7c 2h]
llleopold: folds 
dfcastro.net: raises 1920 to 3520
kesia545: folds 
Uncalled bet (1920) returned to dfcastro.net
dfcastro.net collected 3425 from pot
dfcastro.net: doesn't show hand 
*** SUMMARY ***
Total pot 3425 | Rake 0 
Seat 4: llleopold (button) folded before Flop (didn't bet)
Seat 5: dfcastro.net (small blind) collected (3425)
Seat 7: kesia545 (big blind) folded before Flop



PokerStars Hand #98800539179: Tournament #734961465, $0.23+$0.02 USD Hold'em No Limit - Level XIV (800/1600) - 2013/05/19 12:13:53 BRT [2013/05/19 11:13:53 ET]
Table '734961465 2' 9-max Seat #5 is the button
Seat 4: llleopold (26928 in chips) 
Seat 5: dfcastro.net (26370 in chips) 
Seat 7: kesia545 (14202 in chips) 
llleopold: posts the ante 75
dfcastro.net: posts the ante 75
kesia545: posts the ante 75
kesia545: posts small blind 800
llleopold: posts big blind 1600
*** HOLE CARDS ***
Dealt to dfcastro.net [9s Qs]
dfcastro.net: folds 
kesia545: folds 
Uncalled bet (800) returned to llleopold
llleopold collected 1825 from pot
llleopold: doesn't show hand 
*** SUMMARY ***
Total pot 1825 | Rake 0 
Seat 4: llleopold (big blind) collected (1825)
Seat 5: dfcastro.net (button) folded before Flop (didn't bet)
Seat 7: kesia545 (small blind) folded before Flop



PokerStars Hand #98800550670: Tournament #734961465, $0.23+$0.02 USD Hold'em No Limit - Level XIV (800/1600) - 2013/05/19 12:14:08 BRT [2013/05/19 11:14:08 ET]
Table '734961465 2' 9-max Seat #7 is the button
Seat 4: llleopold (27878 in chips) 
Seat 5: dfcastro.net (26295 in chips) 
Seat 7: kesia545 (13327 in chips) 
llleopold: posts the ante 75
dfcastro.net: posts the ante 75
kesia545: posts the ante 75
llleopold: posts small blind 800
dfcastro.net: posts big blind 1600
*** HOLE CARDS ***
Dealt to dfcastro.net [2h Jd]
kesia545: calls 1600
llleopold: folds 
dfcastro.net: checks 
*** FLOP *** [Qd 6d 3h]
dfcastro.net: checks 
kesia545: checks 
*** TURN *** [Qd 6d 3h] [4d]
dfcastro.net: checks 
kesia545: checks 
*** RIVER *** [Qd 6d 3h 4d] [5s]
dfcastro.net: bets 3200
kesia545: raises 3200 to 6400
dfcastro.net: calls 3200
*** SHOW DOWN ***
kesia545: shows [7d Ad] (a flush, Ace high)
dfcastro.net: mucks hand 
kesia545 collected 17025 from pot
*** SUMMARY ***
Total pot 17025 | Rake 0 
Board [Qd 6d 3h 4d 5s]
Seat 4: llleopold (small blind) folded before Flop
Seat 5: dfcastro.net (big blind) mucked [2h Jd]
Seat 7: kesia545 (button) showed [7d Ad] and won (17025) with a flush, Ace high



PokerStars Hand #98800596981: Tournament #734961465, $0.23+$0.02 USD Hold'em No Limit - Level XIV (800/1600) - 2013/05/19 12:15:07 BRT [2013/05/19 11:15:07 ET]
Table '734961465 2' 9-max Seat #4 is the button
Seat 4: llleopold (27003 in chips) 
Seat 5: dfcastro.net (18220 in chips) 
Seat 7: kesia545 (22277 in chips) 
llleopold: posts the ante 75
dfcastro.net: posts the ante 75
kesia545: posts the ante 75
dfcastro.net: posts small blind 800
kesia545: posts big blind 1600
*** HOLE CARDS ***
Dealt to dfcastro.net [9c 2d]
llleopold: folds 
dfcastro.net: raises 1920 to 3520
kesia545: folds 
Uncalled bet (1920) returned to dfcastro.net
dfcastro.net collected 3425 from pot
dfcastro.net: doesn't show hand 
*** SUMMARY ***
Total pot 3425 | Rake 0 
Seat 4: llleopold (button) folded before Flop (didn't bet)
Seat 5: dfcastro.net (small blind) collected (3425)
Seat 7: kesia545 (big blind) folded before Flop



PokerStars Hand #98800607849: Tournament #734961465, $0.23+$0.02 USD Hold'em No Limit - Level XIV (800/1600) - 2013/05/19 12:15:20 BRT [2013/05/19 11:15:20 ET]
Table '734961465 2' 9-max Seat #5 is the button
Seat 4: llleopold (26928 in chips) 
Seat 5: dfcastro.net (19970 in chips) 
Seat 7: kesia545 (20602 in chips) 
llleopold: posts the ante 75
dfcastro.net: posts the ante 75
kesia545: posts the ante 75
kesia545: posts small blind 800
llleopold: posts big blind 1600
*** HOLE CARDS ***
Dealt to dfcastro.net [Qs 8s]
dfcastro.net: folds 
kesia545: folds 
Uncalled bet (800) returned to llleopold
llleopold collected 1825 from pot
llleopold: doesn't show hand 
*** SUMMARY ***
Total pot 1825 | Rake 0 
Seat 4: llleopold (big blind) collected (1825)
Seat 5: dfcastro.net (button) folded before Flop (didn't bet)
Seat 7: kesia545 (small blind) folded before Flop



PokerStars Hand #98800615094: Tournament #734961465, $0.23+$0.02 USD Hold'em No Limit - Level XIV (800/1600) - 2013/05/19 12:15:30 BRT [2013/05/19 11:15:30 ET]
Table '734961465 2' 9-max Seat #7 is the button
Seat 4: llleopold (27878 in chips) 
Seat 5: dfcastro.net (19895 in chips) 
Seat 7: kesia545 (19727 in chips) 
llleopold: posts the ante 75
dfcastro.net: posts the ante 75
kesia545: posts the ante 75
llleopold: posts small blind 800
dfcastro.net: posts big blind 1600
*** HOLE CARDS ***
Dealt to dfcastro.net [5c Jd]
kesia545: folds 
llleopold: folds 
Uncalled bet (800) returned to dfcastro.net
dfcastro.net collected 1825 from pot
dfcastro.net: doesn't show hand 
*** SUMMARY ***
Total pot 1825 | Rake 0 
Seat 4: llleopold (small blind) folded before Flop
Seat 5: dfcastro.net (big blind) collected (1825)
Seat 7: kesia545 (button) folded before Flop (didn't bet)



PokerStars Hand #98800621081: Tournament #734961465, $0.23+$0.02 USD Hold'em No Limit - Level XIV (800/1600) - 2013/05/19 12:15:37 BRT [2013/05/19 11:15:37 ET]
Table '734961465 2' 9-max Seat #4 is the button
Seat 4: llleopold (27003 in chips) 
Seat 5: dfcastro.net (20845 in chips) 
Seat 7: kesia545 (19652 in chips) 
llleopold: posts the ante 75
dfcastro.net: posts the ante 75
kesia545: posts the ante 75
dfcastro.net: posts small blind 800
kesia545: posts big blind 1600
*** HOLE CARDS ***
Dealt to dfcastro.net [Th As]
llleopold: folds 
dfcastro.net: raises 1920 to 3520
kesia545: calls 1920
*** FLOP *** [4d Ad 5s]
dfcastro.net: bets 17250 and is all-in
kesia545: folds 
Uncalled bet (17250) returned to dfcastro.net
dfcastro.net collected 7265 from pot
dfcastro.net: doesn't show hand 
*** SUMMARY ***
Total pot 7265 | Rake 0 
Board [4d Ad 5s]
Seat 4: llleopold (button) folded before Flop (didn't bet)
Seat 5: dfcastro.net (small blind) collected (7265)
Seat 7: kesia545 (big blind) folded on the Flop



PokerStars Hand #98800635592: Tournament #734961465, $0.23+$0.02 USD Hold'em No Limit - Level XIV (800/1600) - 2013/05/19 12:15:56 BRT [2013/05/19 11:15:56 ET]
Table '734961465 2' 9-max Seat #5 is the button
Seat 4: llleopold (26928 in chips) 
Seat 5: dfcastro.net (24515 in chips) 
Seat 7: kesia545 (16057 in chips) 
llleopold: posts the ante 75
dfcastro.net: posts the ante 75
kesia545: posts the ante 75
kesia545: posts small blind 800
llleopold: posts big blind 1600
*** HOLE CARDS ***
Dealt to dfcastro.net [Jh 4d]
dfcastro.net: folds 
kesia545: folds 
Uncalled bet (800) returned to llleopold
llleopold collected 1825 from pot
llleopold: doesn't show hand 
*** SUMMARY ***
Total pot 1825 | Rake 0 
Seat 4: llleopold (big blind) collected (1825)
Seat 5: dfcastro.net (button) folded before Flop (didn't bet)
Seat 7: kesia545 (small blind) folded before Flop



PokerStars Hand #98800643163: Tournament #734961465, $0.23+$0.02 USD Hold'em No Limit - Level XIV (800/1600) - 2013/05/19 12:16:05 BRT [2013/05/19 11:16:05 ET]
Table '734961465 2' 9-max Seat #7 is the button
Seat 4: llleopold (27878 in chips) 
Seat 5: dfcastro.net (24440 in chips) 
Seat 7: kesia545 (15182 in chips) 
llleopold: posts the ante 75
dfcastro.net: posts the ante 75
kesia545: posts the ante 75
llleopold: posts small blind 800
dfcastro.net: posts big blind 1600
*** HOLE CARDS ***
Dealt to dfcastro.net [8d 3s]
kesia545: calls 1600
llleopold: folds 
dfcastro.net: checks 
*** FLOP *** [7c 7d Td]
dfcastro.net: checks 
kesia545: checks 
*** TURN *** [7c 7d Td] [Jc]
dfcastro.net: checks 
kesia545: checks 
*** RIVER *** [7c 7d Td Jc] [2h]
dfcastro.net: checks 
kesia545: bets 3200
dfcastro.net: folds 
Uncalled bet (3200) returned to kesia545
kesia545 collected 4225 from pot
kesia545: doesn't show hand 
*** SUMMARY ***
Total pot 4225 | Rake 0 
Board [7c 7d Td Jc 2h]
Seat 4: llleopold (small blind) folded before Flop
Seat 5: dfcastro.net (big blind) folded on the River
Seat 7: kesia545 (button) collected (4225)



PokerStars Hand #98800668304: Tournament #734961465, $0.23+$0.02 USD Hold'em No Limit - Level XIV (800/1600) - 2013/05/19 12:16:37 BRT [2013/05/19 11:16:37 ET]
Table '734961465 2' 9-max Seat #4 is the button
Seat 4: llleopold (27003 in chips) 
Seat 5: dfcastro.net (22765 in chips) 
Seat 7: kesia545 (17732 in chips) 
llleopold: posts the ante 75
dfcastro.net: posts the ante 75
kesia545: posts the ante 75
dfcastro.net: posts small blind 800
kesia545: posts big blind 1600
*** HOLE CARDS ***
Dealt to dfcastro.net [Kh Td]
llleopold: folds 
dfcastro.net: raises 1920 to 3520
kesia545: calls 1920
*** FLOP *** [9c 4h 2d]
dfcastro.net: checks 
kesia545: checks 
*** TURN *** [9c 4h 2d] [Jc]
dfcastro.net: checks 
kesia545: checks 
*** RIVER *** [9c 4h 2d Jc] [6d]
dfcastro.net: checks 
kesia545: checks 
*** SHOW DOWN ***
dfcastro.net: shows [Kh Td] (high card King)
kesia545: shows [Ts Th] (a pair of Tens)
kesia545 collected 7265 from pot
*** SUMMARY ***
Total pot 7265 | Rake 0 
Board [9c 4h 2d Jc 6d]
Seat 4: llleopold (button) folded before Flop (didn't bet)
Seat 5: dfcastro.net (small blind) showed [Kh Td] and lost with high card King
Seat 7: kesia545 (big blind) showed [Ts Th] and won (7265) with a pair of Tens



PokerStars Hand #98800698491: Tournament #734961465, $0.23+$0.02 USD Hold'em No Limit - Level XIV (800/1600) - 2013/05/19 12:17:15 BRT [2013/05/19 11:17:15 ET]
Table '734961465 2' 9-max Seat #5 is the button
Seat 4: llleopold (26928 in chips) 
Seat 5: dfcastro.net (19170 in chips) 
Seat 7: kesia545 (21402 in chips) 
llleopold: posts the ante 75
dfcastro.net: posts the ante 75
kesia545: posts the ante 75
kesia545: posts small blind 800
llleopold: posts big blind 1600
*** HOLE CARDS ***
Dealt to dfcastro.net [5h Qh]
dfcastro.net: folds 
kesia545: calls 800
llleopold: checks 
*** FLOP *** [Jc 5d Js]
kesia545: checks 
llleopold: checks 
*** TURN *** [Jc 5d Js] [Jd]
kesia545: checks 
llleopold: checks 
*** RIVER *** [Jc 5d Js Jd] [7h]
kesia545: checks 
llleopold: checks 
*** SHOW DOWN ***
kesia545: shows [6h Ad] (three of a kind, Jacks)
llleopold: mucks hand 
kesia545 collected 3425 from pot
*** SUMMARY ***
Total pot 3425 | Rake 0 
Board [Jc 5d Js Jd 7h]
Seat 4: llleopold (big blind) mucked [6c 8h]
Seat 5: dfcastro.net (button) folded before Flop (didn't bet)
Seat 7: kesia545 (small blind) showed [6h Ad] and won (3425) with three of a kind, Jacks



PokerStars Hand #98800721344: Tournament #734961465, $0.23+$0.02 USD Hold'em No Limit - Level XIV (800/1600) - 2013/05/19 12:17:44 BRT [2013/05/19 11:17:44 ET]
Table '734961465 2' 9-max Seat #7 is the button
Seat 4: llleopold (25253 in chips) 
Seat 5: dfcastro.net (19095 in chips) 
Seat 7: kesia545 (23152 in chips) 
llleopold: posts the ante 75
dfcastro.net: posts the ante 75
kesia545: posts the ante 75
llleopold: posts small blind 800
dfcastro.net: posts big blind 1600
*** HOLE CARDS ***
Dealt to dfcastro.net [8c 6d]
kesia545: calls 1600
llleopold: raises 2400 to 4000
dfcastro.net: folds 
kesia545: calls 2400
*** FLOP *** [9d 2c 5s]
llleopold: bets 4814
kesia545: calls 4814
*** TURN *** [9d 2c 5s] [9h]
llleopold: bets 4800
kesia545: calls 4800
*** RIVER *** [9d 2c 5s 9h] [Td]
llleopold: checks 
kesia545: bets 4800
llleopold: folds 
Uncalled bet (4800) returned to kesia545
kesia545 collected 29053 from pot
kesia545: shows [Ts]
*** SUMMARY ***
Total pot 29053 | Rake 0 
Board [9d 2c 5s 9h Td]
Seat 4: llleopold (small blind) folded on the River
Seat 5: dfcastro.net (big blind) folded before Flop
Seat 7: kesia545 (button) collected (29053)



PokerStars Hand #98800756563: Tournament #734961465, $0.23+$0.02 USD Hold'em No Limit - Level XIV (800/1600) - 2013/05/19 12:18:29 BRT [2013/05/19 11:18:29 ET]
Table '734961465 2' 9-max Seat #4 is the button
Seat 4: llleopold (11564 in chips) 
Seat 5: dfcastro.net (17420 in chips) 
Seat 7: kesia545 (38516 in chips) 
llleopold: posts the ante 75
dfcastro.net: posts the ante 75
kesia545: posts the ante 75
dfcastro.net: posts small blind 800
kesia545: posts big blind 1600
*** HOLE CARDS ***
Dealt to dfcastro.net [5h As]
llleopold: raises 9889 to 11489 and is all-in
dfcastro.net: folds 
kesia545: folds 
Uncalled bet (9889) returned to llleopold
llleopold collected 4225 from pot
llleopold: doesn't show hand 
*** SUMMARY ***
Total pot 4225 | Rake 0 
Seat 4: llleopold (button) collected (4225)
Seat 5: dfcastro.net (small blind) folded before Flop
Seat 7: kesia545 (big blind) folded before Flop



PokerStars Hand #98800772318: Tournament #734961465, $0.23+$0.02 USD Hold'em No Limit - Level XIV (800/1600) - 2013/05/19 12:18:49 BRT [2013/05/19 11:18:49 ET]
Table '734961465 2' 9-max Seat #5 is the button
Seat 4: llleopold (14114 in chips) 
Seat 5: dfcastro.net (16545 in chips) 
Seat 7: kesia545 (36841 in chips) 
llleopold: posts the ante 75
dfcastro.net: posts the ante 75
kesia545: posts the ante 75
kesia545: posts small blind 800
llleopold: posts big blind 1600
*** HOLE CARDS ***
Dealt to dfcastro.net [4h 3h]
dfcastro.net: folds 
kesia545: folds 
Uncalled bet (800) returned to llleopold
llleopold collected 1825 from pot
llleopold: doesn't show hand 
*** SUMMARY ***
Total pot 1825 | Rake 0 
Seat 4: llleopold (big blind) collected (1825)
Seat 5: dfcastro.net (button) folded before Flop (didn't bet)
Seat 7: kesia545 (small blind) folded before Flop



PokerStars Hand #98800779840: Tournament #734961465, $0.23+$0.02 USD Hold'em No Limit - Level XIV (800/1600) - 2013/05/19 12:18:58 BRT [2013/05/19 11:18:58 ET]
Table '734961465 2' 9-max Seat #7 is the button
Seat 4: llleopold (15064 in chips) 
Seat 5: dfcastro.net (16470 in chips) 
Seat 7: kesia545 (35966 in chips) 
llleopold: posts the ante 75
dfcastro.net: posts the ante 75
kesia545: posts the ante 75
llleopold: posts small blind 800
dfcastro.net: posts big blind 1600
*** HOLE CARDS ***
Dealt to dfcastro.net [7d 6h]
kesia545: folds 
llleopold: folds 
Uncalled bet (800) returned to dfcastro.net
dfcastro.net collected 1825 from pot
dfcastro.net: doesn't show hand 
*** SUMMARY ***
Total pot 1825 | Rake 0 
Seat 4: llleopold (small blind) folded before Flop
Seat 5: dfcastro.net (big blind) collected (1825)
Seat 7: kesia545 (button) folded before Flop (didn't bet)



PokerStars Hand #98800785912: Tournament #734961465, $0.23+$0.02 USD Hold'em No Limit - Level XIV (800/1600) - 2013/05/19 12:19:06 BRT [2013/05/19 11:19:06 ET]
Table '734961465 2' 9-max Seat #4 is the button
Seat 4: llleopold (14189 in chips) 
Seat 5: dfcastro.net (17420 in chips) 
Seat 7: kesia545 (35891 in chips) 
llleopold: posts the ante 75
dfcastro.net: posts the ante 75
kesia545: posts the ante 75
dfcastro.net: posts small blind 800
kesia545: posts big blind 1600
*** HOLE CARDS ***
Dealt to dfcastro.net [Ah Jc]
llleopold: folds 
dfcastro.net: raises 1920 to 3520
kesia545: calls 1920
*** FLOP *** [8c 3s 9c]
dfcastro.net: checks 
kesia545: checks 
*** TURN *** [8c 3s 9c] [9d]
dfcastro.net: checks 
kesia545: checks 
*** RIVER *** [8c 3s 9c 9d] [Kc]
dfcastro.net: checks 
kesia545: checks 
*** SHOW DOWN ***
dfcastro.net: shows [Ah Jc] (a pair of Nines)
kesia545: shows [Ad Jh] (a pair of Nines)
dfcastro.net collected 3633 from pot
kesia545 collected 3632 from pot
*** SUMMARY ***
Total pot 7265 | Rake 0 
Board [8c 3s 9c 9d Kc]
Seat 4: llleopold (button) folded before Flop (didn't bet)
Seat 5: dfcastro.net (small blind) showed [Ah Jc] and won (3633) with a pair of Nines
Seat 7: kesia545 (big blind) showed [Ad Jh] and won (3632) with a pair of Nines



PokerStars Hand #98800813070: Tournament #734961465, $0.23+$0.02 USD Hold'em No Limit - Level XIV (800/1600) - 2013/05/19 12:19:40 BRT [2013/05/19 11:19:40 ET]
Table '734961465 2' 9-max Seat #5 is the button
Seat 4: llleopold (14114 in chips) 
Seat 5: dfcastro.net (17458 in chips) 
Seat 7: kesia545 (35928 in chips) 
llleopold: posts the ante 75
dfcastro.net: posts the ante 75
kesia545: posts the ante 75
kesia545: posts small blind 800
llleopold: posts big blind 1600
*** HOLE CARDS ***
Dealt to dfcastro.net [8s Qh]
dfcastro.net: folds 
kesia545: calls 800
llleopold: raises 12439 to 14039 and is all-in
kesia545: calls 12439
*** FLOP *** [Kh Ad 9h]
*** TURN *** [Kh Ad 9h] [9s]
*** RIVER *** [Kh Ad 9h 9s] [Qd]
*** SHOW DOWN ***
kesia545: shows [Jd Jh] (two pair, Jacks and Nines)
llleopold: shows [Ks 7d] (two pair, Kings and Nines)
llleopold collected 28303 from pot
*** SUMMARY ***
Total pot 28303 | Rake 0 
Board [Kh Ad 9h 9s Qd]
Seat 4: llleopold (big blind) showed [Ks 7d] and won (28303) with two pair, Kings and Nines
Seat 5: dfcastro.net (button) folded before Flop (didn't bet)
Seat 7: kesia545 (small blind) showed [Jd Jh] and lost with two pair, Jacks and Nines



PokerStars Hand #98800829608: Tournament #734961465, $0.23+$0.02 USD Hold'em No Limit - Level XIV (800/1600) - 2013/05/19 12:20:01 BRT [2013/05/19 11:20:01 ET]
Table '734961465 2' 9-max Seat #7 is the button
Seat 4: llleopold (28303 in chips) 
Seat 5: dfcastro.net (17383 in chips) 
Seat 7: kesia545 (21814 in chips) 
llleopold: posts the ante 75
dfcastro.net: posts the ante 75
kesia545: posts the ante 75
llleopold: posts small blind 800
dfcastro.net: posts big blind 1600
*** HOLE CARDS ***
Dealt to dfcastro.net [5h Jc]
kesia545: folds 
llleopold: raises 1711 to 3311
dfcastro.net: folds 
Uncalled bet (1711) returned to llleopold
llleopold collected 3425 from pot
llleopold: doesn't show hand 
*** SUMMARY ***
Total pot 3425 | Rake 0 
Seat 4: llleopold (small blind) collected (3425)
Seat 5: dfcastro.net (big blind) folded before Flop
Seat 7: kesia545 (button) folded before Flop (didn't bet)



PokerStars Hand #98800839700: Tournament #734961465, $0.23+$0.02 USD Hold'em No Limit - Level XIV (800/1600) - 2013/05/19 12:20:14 BRT [2013/05/19 11:20:14 ET]
Table '734961465 2' 9-max Seat #4 is the button
Seat 4: llleopold (30053 in chips) 
Seat 5: dfcastro.net (15708 in chips) 
Seat 7: kesia545 (21739 in chips) 
llleopold: posts the ante 75
dfcastro.net: posts the ante 75
kesia545: posts the ante 75
dfcastro.net: posts small blind 800
kesia545: posts big blind 1600
*** HOLE CARDS ***
Dealt to dfcastro.net [Jh Kd]
llleopold: folds 
dfcastro.net: raises 1920 to 3520
kesia545: folds 
Uncalled bet (1920) returned to dfcastro.net
dfcastro.net collected 3425 from pot
dfcastro.net: doesn't show hand 
*** SUMMARY ***
Total pot 3425 | Rake 0 
Seat 4: llleopold (button) folded before Flop (didn't bet)
Seat 5: dfcastro.net (small blind) collected (3425)
Seat 7: kesia545 (big blind) folded before Flop



PokerStars Hand #98800853233: Tournament #734961465, $0.23+$0.02 USD Hold'em No Limit - Level XIV (800/1600) - 2013/05/19 12:20:31 BRT [2013/05/19 11:20:31 ET]
Table '734961465 2' 9-max Seat #5 is the button
Seat 4: llleopold (29978 in chips) 
Seat 5: dfcastro.net (17458 in chips) 
Seat 7: kesia545 (20064 in chips) 
llleopold: posts the ante 75
dfcastro.net: posts the ante 75
kesia545: posts the ante 75
kesia545: posts small blind 800
llleopold: posts big blind 1600
*** HOLE CARDS ***
Dealt to dfcastro.net [Kd 8c]
dfcastro.net: folds 
kesia545: calls 800
llleopold: raises 28303 to 29903 and is all-in
kesia545: calls 18389 and is all-in
Uncalled bet (9914) returned to llleopold
*** FLOP *** [Jd 8d 7s]
*** TURN *** [Jd 8d 7s] [Qd]
*** RIVER *** [Jd 8d 7s Qd] [9d]
*** SHOW DOWN ***
kesia545: shows [Ac Ks] (high card Ace)
llleopold: shows [6c As] (high card Ace - lower kicker)
kesia545 collected 40203 from pot
*** SUMMARY ***
Total pot 40203 | Rake 0 
Board [Jd 8d 7s Qd 9d]
Seat 4: llleopold (big blind) showed [6c As] and lost with high card Ace
Seat 5: dfcastro.net (button) folded before Flop (didn't bet)
Seat 7: kesia545 (small blind) showed [Ac Ks] and won (40203) with high card Ace



PokerStars Hand #98800869554: Tournament #734961465, $0.23+$0.02 USD Hold'em No Limit - Level XIV (800/1600) - 2013/05/19 12:20:52 BRT [2013/05/19 11:20:52 ET]
Table '734961465 2' 9-max Seat #7 is the button
Seat 4: llleopold (9914 in chips) 
Seat 5: dfcastro.net (17383 in chips) 
Seat 7: kesia545 (40203 in chips) 
llleopold: posts the ante 75
dfcastro.net: posts the ante 75
kesia545: posts the ante 75
llleopold: posts small blind 800
dfcastro.net: posts big blind 1600
*** HOLE CARDS ***
Dealt to dfcastro.net [8c 9s]
kesia545: folds 
llleopold: raises 8239 to 9839 and is all-in
dfcastro.net: folds 
Uncalled bet (8239) returned to llleopold
llleopold collected 3425 from pot
llleopold: doesn't show hand 
*** SUMMARY ***
Total pot 3425 | Rake 0 
Seat 4: llleopold (small blind) collected (3425)
Seat 5: dfcastro.net (big blind) folded before Flop
Seat 7: kesia545 (button) folded before Flop (didn't bet)



PokerStars Hand #98800879261: Tournament #734961465, $0.23+$0.02 USD Hold'em No Limit - Level XIV (800/1600) - 2013/05/19 12:21:04 BRT [2013/05/19 11:21:04 ET]
Table '734961465 2' 9-max Seat #4 is the button
Seat 4: llleopold (11664 in chips) 
Seat 5: dfcastro.net (15708 in chips) 
Seat 7: kesia545 (40128 in chips) 
llleopold: posts the ante 75
dfcastro.net: posts the ante 75
kesia545: posts the ante 75
dfcastro.net: posts small blind 800
kesia545: posts big blind 1600
*** HOLE CARDS ***
Dealt to dfcastro.net [5h 7h]
llleopold: folds 
dfcastro.net: folds 
Uncalled bet (800) returned to kesia545
kesia545 collected 1825 from pot
kesia545: doesn't show hand 
*** SUMMARY ***
Total pot 1825 | Rake 0 
Seat 4: llleopold (button) folded before Flop (didn't bet)
Seat 5: dfcastro.net (small blind) folded before Flop
Seat 7: kesia545 (big blind) collected (1825)



PokerStars Hand #98800887921: Tournament #734961465, $0.23+$0.02 USD Hold'em No Limit - Level XIV (800/1600) - 2013/05/19 12:21:15 BRT [2013/05/19 11:21:15 ET]
Table '734961465 2' 9-max Seat #5 is the button
Seat 4: llleopold (11589 in chips) 
Seat 5: dfcastro.net (14833 in chips) 
Seat 7: kesia545 (41078 in chips) 
llleopold: posts the ante 75
dfcastro.net: posts the ante 75
kesia545: posts the ante 75
kesia545: posts small blind 800
llleopold: posts big blind 1600
*** HOLE CARDS ***
Dealt to dfcastro.net [9s 3h]
dfcastro.net: folds 
kesia545: folds 
Uncalled bet (800) returned to llleopold
llleopold collected 1825 from pot
llleopold: doesn't show hand 
*** SUMMARY ***
Total pot 1825 | Rake 0 
Seat 4: llleopold (big blind) collected (1825)
Seat 5: dfcastro.net (button) folded before Flop (didn't bet)
Seat 7: kesia545 (small blind) folded before Flop



PokerStars Hand #98800894487: Tournament #734961465, $0.23+$0.02 USD Hold'em No Limit - Level XIV (800/1600) - 2013/05/19 12:21:23 BRT [2013/05/19 11:21:23 ET]
Table '734961465 2' 9-max Seat #7 is the button
Seat 4: llleopold (12539 in chips) 
Seat 5: dfcastro.net (14758 in chips) 
Seat 7: kesia545 (40203 in chips) 
llleopold: posts the ante 75
dfcastro.net: posts the ante 75
kesia545: posts the ante 75
llleopold: posts small blind 800
dfcastro.net: posts big blind 1600
*** HOLE CARDS ***
Dealt to dfcastro.net [3s 8h]
kesia545: folds 
llleopold: raises 10864 to 12464 and is all-in
dfcastro.net: folds 
Uncalled bet (10864) returned to llleopold
llleopold collected 3425 from pot
llleopold: doesn't show hand 
*** SUMMARY ***
Total pot 3425 | Rake 0 
Seat 4: llleopold (small blind) collected (3425)
Seat 5: dfcastro.net (big blind) folded before Flop
Seat 7: kesia545 (button) folded before Flop (didn't bet)



PokerStars Hand #98800905416: Tournament #734961465, $0.23+$0.02 USD Hold'em No Limit - Level XIV (800/1600) - 2013/05/19 12:21:37 BRT [2013/05/19 11:21:37 ET]
Table '734961465 2' 9-max Seat #4 is the button
Seat 4: llleopold (14289 in chips) 
Seat 5: dfcastro.net (13083 in chips) 
Seat 7: kesia545 (40128 in chips) 
llleopold: posts the ante 75
dfcastro.net: posts the ante 75
kesia545: posts the ante 75
dfcastro.net: posts small blind 800
kesia545: posts big blind 1600
*** HOLE CARDS ***
Dealt to dfcastro.net [Ah 5h]
llleopold: raises 12614 to 14214 and is all-in
dfcastro.net: calls 12208 and is all-in
kesia545: folds 
Uncalled bet (1206) returned to llleopold
*** FLOP *** [Kc 8h 5d]
*** TURN *** [Kc 8h 5d] [3c]
*** RIVER *** [Kc 8h 5d 3c] [7c]
*** SHOW DOWN ***
dfcastro.net: shows [Ah 5h] (a pair of Fives)
llleopold: shows [4h Ac] (high card Ace)
dfcastro.net collected 27841 from pot
*** SUMMARY ***
Total pot 27841 | Rake 0 
Board [Kc 8h 5d 3c 7c]
Seat 4: llleopold (button) showed [4h Ac] and lost with high card Ace
Seat 5: dfcastro.net (small blind) showed [Ah 5h] and won (27841) with a pair of Fives
Seat 7: kesia545 (big blind) folded before Flop



PokerStars Hand #98800919172: Tournament #734961465, $0.23+$0.02 USD Hold'em No Limit - Level XIV (800/1600) - 2013/05/19 12:21:54 BRT [2013/05/19 11:21:54 ET]
Table '734961465 2' 9-max Seat #5 is the button
Seat 4: llleopold (1206 in chips) 
Seat 5: dfcastro.net (27841 in chips) 
Seat 7: kesia545 (38453 in chips) 
llleopold: posts the ante 75
dfcastro.net: posts the ante 75
kesia545: posts the ante 75
kesia545: posts small blind 800
llleopold: posts big blind 1131 and is all-in
*** HOLE CARDS ***
Dealt to dfcastro.net [9d 2s]
dfcastro.net: folds 
kesia545: folds 
Uncalled bet (331) returned to llleopold
llleopold collected 1825 from pot
llleopold: doesn't show hand 
*** SUMMARY ***
Total pot 1825 | Rake 0 
Seat 4: llleopold (big blind) collected (1825)
Seat 5: dfcastro.net (button) folded before Flop (didn't bet)
Seat 7: kesia545 (small blind) folded before Flop



PokerStars Hand #98800927019: Tournament #734961465, $0.23+$0.02 USD Hold'em No Limit - Level XIV (800/1600) - 2013/05/19 12:22:04 BRT [2013/05/19 11:22:04 ET]
Table '734961465 2' 9-max Seat #7 is the button
Seat 4: llleopold (2156 in chips) 
Seat 5: dfcastro.net (27766 in chips) 
Seat 7: kesia545 (37578 in chips) 
llleopold: posts the ante 75
dfcastro.net: posts the ante 75
kesia545: posts the ante 75
llleopold: posts small blind 800
dfcastro.net: posts big blind 1600
*** HOLE CARDS ***
Dealt to dfcastro.net [2h Kc]
kesia545: calls 1600
llleopold: raises 481 to 2081 and is all-in
dfcastro.net: calls 481
kesia545: calls 481
*** FLOP *** [9h 5h Qh]
dfcastro.net: checks 
kesia545: checks 
*** TURN *** [9h 5h Qh] [Jh]
dfcastro.net: checks 
kesia545: checks 
*** RIVER *** [9h 5h Qh Jh] [3s]
dfcastro.net: checks 
kesia545: bets 1600
dfcastro.net: calls 1600
*** SHOW DOWN ***
kesia545: shows [7h Ah] (a flush, Ace high)
dfcastro.net: mucks hand 
kesia545 collected 3200 from side pot
llleopold: mucks hand 
kesia545 collected 6468 from main pot
llleopold finished the tournament in 3rd place and received $1.70.
*** SUMMARY ***
Total pot 9668 Main pot 6468. Side pot 3200. | Rake 0 
Board [9h 5h Qh Jh 3s]
Seat 4: llleopold (small blind) mucked [4d 6s]
Seat 5: dfcastro.net (big blind) mucked [2h Kc]
Seat 7: kesia545 (button) showed [7h Ah] and won (9668) with a flush, Ace high



PokerStars Hand #98800957009: Tournament #734961465, $0.23+$0.02 USD Hold'em No Limit - Level XIV (800/1600) - 2013/05/19 12:22:42 BRT [2013/05/19 11:22:42 ET]
Table '734961465 2' 9-max Seat #5 is the button
Seat 5: dfcastro.net (24010 in chips) 
Seat 7: kesia545 (43490 in chips) 
dfcastro.net: posts the ante 75
kesia545: posts the ante 75
dfcastro.net: posts small blind 800
kesia545: posts big blind 1600
*** HOLE CARDS ***
Dealt to dfcastro.net [4d 2s]
dfcastro.net: folds 
Uncalled bet (800) returned to kesia545
kesia545 collected 1750 from pot
kesia545: doesn't show hand 
*** SUMMARY ***
Total pot 1750 | Rake 0 
Seat 5: dfcastro.net (button) (small blind) folded before Flop
Seat 7: kesia545 (big blind) collected (1750)



PokerStars Hand #98800965436: Tournament #734961465, $0.23+$0.02 USD Hold'em No Limit - Level XIV (800/1600) - 2013/05/19 12:22:53 BRT [2013/05/19 11:22:53 ET]
Table '734961465 2' 9-max Seat #7 is the button
Seat 5: dfcastro.net (23135 in chips) 
Seat 7: kesia545 (44365 in chips) 
dfcastro.net: posts the ante 75
kesia545: posts the ante 75
kesia545: posts small blind 800
dfcastro.net: posts big blind 1600
*** HOLE CARDS ***
Dealt to dfcastro.net [Td 8s]
kesia545: folds 
Uncalled bet (800) returned to dfcastro.net
dfcastro.net collected 1750 from pot
dfcastro.net: doesn't show hand 
*** SUMMARY ***
Total pot 1750 | Rake 0 
Seat 5: dfcastro.net (big blind) collected (1750)
Seat 7: kesia545 (button) (small blind) folded before Flop



PokerStars Hand #98800969836: Tournament #734961465, $0.23+$0.02 USD Hold'em No Limit - Level XIV (800/1600) - 2013/05/19 12:22:59 BRT [2013/05/19 11:22:59 ET]
Table '734961465 2' 9-max Seat #5 is the button
Seat 5: dfcastro.net (24010 in chips) 
Seat 7: kesia545 (43490 in chips) 
dfcastro.net: posts the ante 75
kesia545: posts the ante 75
dfcastro.net: posts small blind 800
kesia545: posts big blind 1600
*** HOLE CARDS ***
Dealt to dfcastro.net [2s Qd]
dfcastro.net: folds 
Uncalled bet (800) returned to kesia545
kesia545 collected 1750 from pot
kesia545: doesn't show hand 
*** SUMMARY ***
Total pot 1750 | Rake 0 
Seat 5: dfcastro.net (button) (small blind) folded before Flop
Seat 7: kesia545 (big blind) collected (1750)



PokerStars Hand #98800977502: Tournament #734961465, $0.23+$0.02 USD Hold'em No Limit - Level XIV (800/1600) - 2013/05/19 12:23:09 BRT [2013/05/19 11:23:09 ET]
Table '734961465 2' 9-max Seat #7 is the button
Seat 5: dfcastro.net (23135 in chips) 
Seat 7: kesia545 (44365 in chips) 
dfcastro.net: posts the ante 75
kesia545: posts the ante 75
kesia545: posts small blind 800
dfcastro.net: posts big blind 1600
*** HOLE CARDS ***
Dealt to dfcastro.net [8d Jh]
kesia545: folds 
Uncalled bet (800) returned to dfcastro.net
dfcastro.net collected 1750 from pot
dfcastro.net: doesn't show hand 
*** SUMMARY ***
Total pot 1750 | Rake 0 
Seat 5: dfcastro.net (big blind) collected (1750)
Seat 7: kesia545 (button) (small blind) folded before Flop



PokerStars Hand #98800982069: Tournament #734961465, $0.23+$0.02 USD Hold'em No Limit - Level XIV (800/1600) - 2013/05/19 12:23:14 BRT [2013/05/19 11:23:14 ET]
Table '734961465 2' 9-max Seat #5 is the button
Seat 5: dfcastro.net (24010 in chips) 
Seat 7: kesia545 (43490 in chips) 
dfcastro.net: posts the ante 75
kesia545: posts the ante 75
dfcastro.net: posts small blind 800
kesia545: posts big blind 1600
*** HOLE CARDS ***
Dealt to dfcastro.net [7s Td]
dfcastro.net: folds 
Uncalled bet (800) returned to kesia545
kesia545 collected 1750 from pot
kesia545: doesn't show hand 
*** SUMMARY ***
Total pot 1750 | Rake 0 
Seat 5: dfcastro.net (button) (small blind) folded before Flop
Seat 7: kesia545 (big blind) collected (1750)



PokerStars Hand #98800992644: Tournament #734961465, $0.23+$0.02 USD Hold'em No Limit - Level XV (1000/2000) - 2013/05/19 12:23:28 BRT [2013/05/19 11:23:28 ET]
Table '734961465 2' 9-max Seat #7 is the button
Seat 5: dfcastro.net (23135 in chips) 
Seat 7: kesia545 (44365 in chips) 
dfcastro.net: posts the ante 100
kesia545: posts the ante 100
kesia545: posts small blind 1000
dfcastro.net: posts big blind 2000
*** HOLE CARDS ***
Dealt to dfcastro.net [4d 2h]
kesia545: calls 1000
dfcastro.net: checks 
*** FLOP *** [7s 8c Kh]
dfcastro.net: checks 
kesia545: checks 
*** TURN *** [7s 8c Kh] [Tc]
dfcastro.net: checks 
kesia545: checks 
*** RIVER *** [7s 8c Kh Tc] [Kc]
dfcastro.net: checks 
kesia545: checks 
*** SHOW DOWN ***
dfcastro.net: shows [4d 2h] (a pair of Kings)
kesia545: shows [2c 2s] (two pair, Kings and Deuces)
kesia545 collected 4200 from pot
*** SUMMARY ***
Total pot 4200 | Rake 0 
Board [7s 8c Kh Tc Kc]
Seat 5: dfcastro.net (big blind) showed [4d 2h] and lost with a pair of Kings
Seat 7: kesia545 (button) (small blind) showed [2c 2s] and won (4200) with two pair, Kings and Deuces



PokerStars Hand #98801015379: Tournament #734961465, $0.23+$0.02 USD Hold'em No Limit - Level XV (1000/2000) - 2013/05/19 12:23:57 BRT [2013/05/19 11:23:57 ET]
Table '734961465 2' 9-max Seat #5 is the button
Seat 5: dfcastro.net (21035 in chips) 
Seat 7: kesia545 (46465 in chips) 
dfcastro.net: posts the ante 100
kesia545: posts the ante 100
dfcastro.net: posts small blind 1000
kesia545: posts big blind 2000
*** HOLE CARDS ***
Dealt to dfcastro.net [7h 9d]
dfcastro.net: raises 18935 to 20935 and is all-in
kesia545: folds 
Uncalled bet (18935) returned to dfcastro.net
dfcastro.net collected 4200 from pot
dfcastro.net: doesn't show hand 
*** SUMMARY ***
Total pot 4200 | Rake 0 
Seat 5: dfcastro.net (button) (small blind) collected (4200)
Seat 7: kesia545 (big blind) folded before Flop



PokerStars Hand #98801026765: Tournament #734961465, $0.23+$0.02 USD Hold'em No Limit - Level XV (1000/2000) - 2013/05/19 12:24:11 BRT [2013/05/19 11:24:11 ET]
Table '734961465 2' 9-max Seat #7 is the button
Seat 5: dfcastro.net (23135 in chips) 
Seat 7: kesia545 (44365 in chips) 
dfcastro.net: posts the ante 100
kesia545: posts the ante 100
kesia545: posts small blind 1000
dfcastro.net: posts big blind 2000
*** HOLE CARDS ***
Dealt to dfcastro.net [Ac 9s]
kesia545: folds 
Uncalled bet (1000) returned to dfcastro.net
dfcastro.net collected 2200 from pot
dfcastro.net: doesn't show hand 
*** SUMMARY ***
Total pot 2200 | Rake 0 
Seat 5: dfcastro.net (big blind) collected (2200)
Seat 7: kesia545 (button) (small blind) folded before Flop



PokerStars Hand #98801031772: Tournament #734961465, $0.23+$0.02 USD Hold'em No Limit - Level XV (1000/2000) - 2013/05/19 12:24:18 BRT [2013/05/19 11:24:18 ET]
Table '734961465 2' 9-max Seat #5 is the button
Seat 5: dfcastro.net (24235 in chips) 
Seat 7: kesia545 (43265 in chips) 
dfcastro.net: posts the ante 100
kesia545: posts the ante 100
dfcastro.net: posts small blind 1000
kesia545: posts big blind 2000
*** HOLE CARDS ***
Dealt to dfcastro.net [6d As]
dfcastro.net: raises 22135 to 24135 and is all-in
kesia545: calls 22135
*** FLOP *** [5h 8h Ac]
*** TURN *** [5h 8h Ac] [9c]
*** RIVER *** [5h 8h Ac 9c] [Tc]
*** SHOW DOWN ***
kesia545: shows [9d Ad] (two pair, Aces and Nines)
dfcastro.net: shows [6d As] (a pair of Aces)
kesia545 collected 48470 from pot
dfcastro.net finished the tournament in 2nd place and received $2.22.
kesia545 wins the tournament and receives $3.23 - congratulations!
*** SUMMARY ***
Total pot 48470 | Rake 0 
Board [5h 8h Ac 9c Tc]
Seat 5: dfcastro.net (button) (small blind) showed [6d As] and lost with a pair of Aces
Seat 7: kesia545 (big blind) showed [9d Ad] and won (48470) with two pair, Aces and Nines



