PokerStars Hand #100385665414: Tournament #750518676, $0.23+$0.02 USD Hold'em No Limit - Level I (10/20) - 2013/06/21 20:11:59 BRT [2013/06/21 19:11:59 ET]
Table '750518676 5' 9-max Seat #1 is the button
Seat 1: sportiano (1500 in chips) 
Seat 2: Victorgd764 (1500 in chips) 
Seat 3: Phil_Laak119 (1500 in chips) 
Seat 4: oklandsvag (1500 in chips) 
Seat 5: avril26 (1500 in chips) 
Seat 6: dfcastro.net (1500 in chips) 
Seat 7: meshesh00 (1500 in chips) 
Seat 8: pashaje (1500 in chips) 
Seat 9: batalgazi075 (1500 in chips) 
Victorgd764: posts small blind 10
Phil_Laak119: posts big blind 20
*** HOLE CARDS ***
Dealt to dfcastro.net [Kd Qh]
oklandsvag: folds 
avril26: calls 20
dfcastro.net: calls 20
meshesh00: folds 
pashaje: calls 20
batalgazi075: folds 
sportiano: folds 
Victorgd764: calls 10
Phil_Laak119: checks 
*** FLOP *** [5d Ac 6c]
Victorgd764: checks 
Phil_Laak119: checks 
avril26: bets 100
dfcastro.net: folds 
pashaje: folds 
Victorgd764: folds 
Phil_Laak119: folds 
Uncalled bet (100) returned to avril26
avril26 collected 100 from pot
*** SUMMARY ***
Total pot 100 | Rake 0 
Board [5d Ac 6c]
Seat 1: sportiano (button) folded before Flop (didn't bet)
Seat 2: Victorgd764 (small blind) folded on the Flop
Seat 3: Phil_Laak119 (big blind) folded on the Flop
Seat 4: oklandsvag folded before Flop (didn't bet)
Seat 5: avril26 collected (100)
Seat 6: dfcastro.net folded on the Flop
Seat 7: meshesh00 folded before Flop (didn't bet)
Seat 8: pashaje folded on the Flop
Seat 9: batalgazi075 folded before Flop (didn't bet)



PokerStars Hand #100385721417: Tournament #750518676, $0.23+$0.02 USD Hold'em No Limit - Level I (10/20) - 2013/06/21 20:13:27 BRT [2013/06/21 19:13:27 ET]
Table '750518676 5' 9-max Seat #2 is the button
Seat 1: sportiano (1500 in chips) 
Seat 2: Victorgd764 (1480 in chips) 
Seat 3: Phil_Laak119 (1480 in chips) 
Seat 4: oklandsvag (1500 in chips) 
Seat 5: avril26 (1580 in chips) 
Seat 6: dfcastro.net (1480 in chips) 
Seat 7: meshesh00 (1500 in chips) 
Seat 8: pashaje (1480 in chips) 
Seat 9: batalgazi075 (1500 in chips) 
Phil_Laak119: posts small blind 10
oklandsvag: posts big blind 20
*** HOLE CARDS ***
Dealt to dfcastro.net [2h 8s]
avril26: folds 
dfcastro.net: folds 
meshesh00: folds 
pashaje: folds 
batalgazi075: raises 40 to 60
sportiano: folds 
Victorgd764: folds 
Phil_Laak119: folds 
oklandsvag: calls 40
*** FLOP *** [Ts 5h 9c]
oklandsvag: checks 
batalgazi075: bets 60
oklandsvag: folds 
Uncalled bet (60) returned to batalgazi075
batalgazi075 collected 130 from pot
*** SUMMARY ***
Total pot 130 | Rake 0 
Board [Ts 5h 9c]
Seat 1: sportiano folded before Flop (didn't bet)
Seat 2: Victorgd764 (button) folded before Flop (didn't bet)
Seat 3: Phil_Laak119 (small blind) folded before Flop
Seat 4: oklandsvag (big blind) folded on the Flop
Seat 5: avril26 folded before Flop (didn't bet)
Seat 6: dfcastro.net folded before Flop (didn't bet)
Seat 7: meshesh00 folded before Flop (didn't bet)
Seat 8: pashaje folded before Flop (didn't bet)
Seat 9: batalgazi075 collected (130)



PokerStars Hand #100385743106: Tournament #750518676, $0.23+$0.02 USD Hold'em No Limit - Level I (10/20) - 2013/06/21 20:14:01 BRT [2013/06/21 19:14:01 ET]
Table '750518676 5' 9-max Seat #3 is the button
Seat 1: sportiano (1500 in chips) 
Seat 2: Victorgd764 (1480 in chips) 
Seat 3: Phil_Laak119 (1470 in chips) 
Seat 4: oklandsvag (1440 in chips) 
Seat 5: avril26 (1580 in chips) 
Seat 6: dfcastro.net (1480 in chips) 
Seat 7: meshesh00 (1500 in chips) 
Seat 8: pashaje (1480 in chips) 
Seat 9: batalgazi075 (1570 in chips) 
oklandsvag: posts small blind 10
avril26: posts big blind 20
*** HOLE CARDS ***
Dealt to dfcastro.net [Qd 7s]
dfcastro.net: folds 
meshesh00: folds 
pashaje: calls 20
batalgazi075: raises 1550 to 1570 and is all-in
sportiano: folds 
Victorgd764: folds 
Phil_Laak119: folds 
oklandsvag: calls 1430 and is all-in
avril26: folds 
pashaje: folds 
Uncalled bet (130) returned to batalgazi075
*** FLOP *** [6d Tc 5d]
*** TURN *** [6d Tc 5d] [Qs]
*** RIVER *** [6d Tc 5d Qs] [Qc]
*** SHOW DOWN ***
oklandsvag: shows [Qh Kh] (three of a kind, Queens)
batalgazi075: shows [7h 7d] (two pair, Queens and Sevens)
oklandsvag collected 2920 from pot
*** SUMMARY ***
Total pot 2920 | Rake 0 
Board [6d Tc 5d Qs Qc]
Seat 1: sportiano folded before Flop (didn't bet)
Seat 2: Victorgd764 folded before Flop (didn't bet)
Seat 3: Phil_Laak119 (button) folded before Flop (didn't bet)
Seat 4: oklandsvag (small blind) showed [Qh Kh] and won (2920) with three of a kind, Queens
Seat 5: avril26 (big blind) folded before Flop
Seat 6: dfcastro.net folded before Flop (didn't bet)
Seat 7: meshesh00 folded before Flop (didn't bet)
Seat 8: pashaje folded before Flop
Seat 9: batalgazi075 showed [7h 7d] and lost with two pair, Queens and Sevens



PokerStars Hand #100385767273: Tournament #750518676, $0.23+$0.02 USD Hold'em No Limit - Level I (10/20) - 2013/06/21 20:14:39 BRT [2013/06/21 19:14:39 ET]
Table '750518676 5' 9-max Seat #4 is the button
Seat 1: sportiano (1500 in chips) 
Seat 2: Victorgd764 (1480 in chips) 
Seat 3: Phil_Laak119 (1470 in chips) 
Seat 4: oklandsvag (2920 in chips) 
Seat 5: avril26 (1560 in chips) 
Seat 6: dfcastro.net (1480 in chips) 
Seat 7: meshesh00 (1500 in chips) 
Seat 8: pashaje (1460 in chips) 
Seat 9: batalgazi075 (130 in chips) 
avril26: posts small blind 10
dfcastro.net: posts big blind 20
*** HOLE CARDS ***
Dealt to dfcastro.net [6c 9h]
meshesh00: folds 
pashaje: folds 
batalgazi075: raises 110 to 130 and is all-in
sportiano: folds 
Victorgd764: folds 
Phil_Laak119: folds 
oklandsvag: calls 130
avril26: folds 
dfcastro.net: folds 
*** FLOP *** [Ks 3s 5d]
*** TURN *** [Ks 3s 5d] [3c]
*** RIVER *** [Ks 3s 5d 3c] [7d]
*** SHOW DOWN ***
batalgazi075: shows [8c Js] (a pair of Threes)
oklandsvag: shows [7s 8d] (two pair, Sevens and Threes)
oklandsvag collected 290 from pot
batalgazi075 finished the tournament in 43rd place
*** SUMMARY ***
Total pot 290 | Rake 0 
Board [Ks 3s 5d 3c 7d]
Seat 1: sportiano folded before Flop (didn't bet)
Seat 2: Victorgd764 folded before Flop (didn't bet)
Seat 3: Phil_Laak119 folded before Flop (didn't bet)
Seat 4: oklandsvag (button) showed [7s 8d] and won (290) with two pair, Sevens and Threes
Seat 5: avril26 (small blind) folded before Flop
Seat 6: dfcastro.net (big blind) folded before Flop
Seat 7: meshesh00 folded before Flop (didn't bet)
Seat 8: pashaje folded before Flop (didn't bet)
Seat 9: batalgazi075 showed [8c Js] and lost with a pair of Threes



PokerStars Hand #100385794600: Tournament #750518676, $0.23+$0.02 USD Hold'em No Limit - Level I (10/20) - 2013/06/21 20:15:22 BRT [2013/06/21 19:15:22 ET]
Table '750518676 5' 9-max Seat #5 is the button
Seat 1: sportiano (1500 in chips) 
Seat 2: Victorgd764 (1480 in chips) 
Seat 3: Phil_Laak119 (1470 in chips) 
Seat 4: oklandsvag (3080 in chips) 
Seat 5: avril26 (1550 in chips) 
Seat 6: dfcastro.net (1460 in chips) 
Seat 7: meshesh00 (1500 in chips) 
Seat 8: pashaje (1460 in chips) 
dfcastro.net: posts small blind 10
meshesh00: posts big blind 20
*** HOLE CARDS ***
Dealt to dfcastro.net [8s 4s]
pashaje: folds 
sportiano: folds 
Victorgd764: folds 
Phil_Laak119: calls 20
oklandsvag: folds 
avril26: calls 20
dfcastro.net: folds 
meshesh00: checks 
*** FLOP *** [2s Ad 6h]
meshesh00: folds 
Phil_Laak119: checks 
avril26: checks 
*** TURN *** [2s Ad 6h] [Jd]
Phil_Laak119: checks 
avril26: checks 
*** RIVER *** [2s Ad 6h Jd] [Qs]
Phil_Laak119: checks 
avril26: bets 20
Phil_Laak119: folds 
Uncalled bet (20) returned to avril26
avril26 collected 70 from pot
*** SUMMARY ***
Total pot 70 | Rake 0 
Board [2s Ad 6h Jd Qs]
Seat 1: sportiano folded before Flop (didn't bet)
Seat 2: Victorgd764 folded before Flop (didn't bet)
Seat 3: Phil_Laak119 folded on the River
Seat 4: oklandsvag folded before Flop (didn't bet)
Seat 5: avril26 (button) collected (70)
Seat 6: dfcastro.net (small blind) folded before Flop
Seat 7: meshesh00 (big blind) folded on the Flop
Seat 8: pashaje folded before Flop (didn't bet)



PokerStars Hand #100385831441: Tournament #750518676, $0.23+$0.02 USD Hold'em No Limit - Level I (10/20) - 2013/06/21 20:16:20 BRT [2013/06/21 19:16:20 ET]
Table '750518676 5' 9-max Seat #6 is the button
Seat 1: sportiano (1500 in chips) 
Seat 2: Victorgd764 (1480 in chips) 
Seat 3: Phil_Laak119 (1450 in chips) 
Seat 4: oklandsvag (3080 in chips) 
Seat 5: avril26 (1600 in chips) 
Seat 6: dfcastro.net (1450 in chips) 
Seat 7: meshesh00 (1480 in chips) 
Seat 8: pashaje (1460 in chips) 
meshesh00: posts small blind 10
pashaje: posts big blind 20
*** HOLE CARDS ***
Dealt to dfcastro.net [As 3d]
sportiano: folds 
Victorgd764: folds 
Phil_Laak119: folds 
oklandsvag: folds 
oklandsvag is sitting out
avril26: folds 
dfcastro.net: folds 
meshesh00: folds 
Uncalled bet (10) returned to pashaje
pashaje collected 20 from pot
*** SUMMARY ***
Total pot 20 | Rake 0 
Seat 1: sportiano folded before Flop (didn't bet)
Seat 2: Victorgd764 folded before Flop (didn't bet)
Seat 3: Phil_Laak119 folded before Flop (didn't bet)
Seat 4: oklandsvag folded before Flop (didn't bet)
Seat 5: avril26 folded before Flop (didn't bet)
Seat 6: dfcastro.net (button) folded before Flop (didn't bet)
Seat 7: meshesh00 (small blind) folded before Flop
Seat 8: pashaje (big blind) collected (20)



PokerStars Hand #100385848301: Tournament #750518676, $0.23+$0.02 USD Hold'em No Limit - Level I (10/20) - 2013/06/21 20:16:46 BRT [2013/06/21 19:16:46 ET]
Table '750518676 5' 9-max Seat #7 is the button
Seat 1: sportiano (1500 in chips) 
Seat 2: Victorgd764 (1480 in chips) 
Seat 3: Phil_Laak119 (1450 in chips) 
Seat 4: oklandsvag (3080 in chips) is sitting out
Seat 5: avril26 (1600 in chips) 
Seat 6: dfcastro.net (1450 in chips) 
Seat 7: meshesh00 (1470 in chips) 
Seat 8: pashaje (1470 in chips) 
pashaje: posts small blind 10
sportiano: posts big blind 20
*** HOLE CARDS ***
Dealt to dfcastro.net [6d Kh]
Victorgd764: folds 
Phil_Laak119: raises 60 to 80
oklandsvag: folds 
avril26: folds 
dfcastro.net: folds 
meshesh00: folds 
pashaje: folds 
sportiano: folds 
Uncalled bet (60) returned to Phil_Laak119
Phil_Laak119 collected 50 from pot
*** SUMMARY ***
Total pot 50 | Rake 0 
Seat 1: sportiano (big blind) folded before Flop
Seat 2: Victorgd764 folded before Flop (didn't bet)
Seat 3: Phil_Laak119 collected (50)
Seat 4: oklandsvag folded before Flop (didn't bet)
Seat 5: avril26 folded before Flop (didn't bet)
Seat 6: dfcastro.net folded before Flop (didn't bet)
Seat 7: meshesh00 (button) folded before Flop (didn't bet)
Seat 8: pashaje (small blind) folded before Flop



PokerStars Hand #100385866555: Tournament #750518676, $0.23+$0.02 USD Hold'em No Limit - Level I (10/20) - 2013/06/21 20:17:15 BRT [2013/06/21 19:17:15 ET]
Table '750518676 5' 9-max Seat #8 is the button
Seat 1: sportiano (1480 in chips) 
Seat 2: Victorgd764 (1480 in chips) 
Seat 3: Phil_Laak119 (1480 in chips) 
Seat 4: oklandsvag (3080 in chips) is sitting out
Seat 5: avril26 (1600 in chips) 
Seat 6: dfcastro.net (1450 in chips) 
Seat 7: meshesh00 (1470 in chips) 
Seat 8: pashaje (1460 in chips) 
sportiano: posts small blind 10
Victorgd764: posts big blind 20
*** HOLE CARDS ***
Dealt to dfcastro.net [3s 9d]
Phil_Laak119: folds 
oklandsvag: folds 
avril26: raises 40 to 60
dfcastro.net: folds 
meshesh00: folds 
pashaje: calls 60
sportiano: folds 
Victorgd764: raises 100 to 160
avril26: calls 100
pashaje: calls 100
*** FLOP *** [2s Ah Qh]
Victorgd764: checks 
avril26: checks 
pashaje: checks 
*** TURN *** [2s Ah Qh] [5s]
Victorgd764: bets 80
avril26: calls 80
pashaje: folds 
*** RIVER *** [2s Ah Qh 5s] [3d]
Victorgd764: checks 
avril26: checks 
*** SHOW DOWN ***
Victorgd764: shows [Td Ts] (a pair of Tens)
avril26: shows [Jd Js] (a pair of Jacks)
avril26 collected 650 from pot
*** SUMMARY ***
Total pot 650 | Rake 0 
Board [2s Ah Qh 5s 3d]
Seat 1: sportiano (small blind) folded before Flop
Seat 2: Victorgd764 (big blind) showed [Td Ts] and lost with a pair of Tens
Seat 3: Phil_Laak119 folded before Flop (didn't bet)
Seat 4: oklandsvag folded before Flop (didn't bet)
Seat 5: avril26 showed [Jd Js] and won (650) with a pair of Jacks
Seat 6: dfcastro.net folded before Flop (didn't bet)
Seat 7: meshesh00 folded before Flop (didn't bet)
Seat 8: pashaje (button) folded on the Turn



PokerStars Hand #100385892977: Tournament #750518676, $0.23+$0.02 USD Hold'em No Limit - Level I (10/20) - 2013/06/21 20:17:56 BRT [2013/06/21 19:17:56 ET]
Table '750518676 5' 9-max Seat #1 is the button
Seat 1: sportiano (1470 in chips) 
Seat 2: Victorgd764 (1240 in chips) 
Seat 3: Phil_Laak119 (1480 in chips) 
Seat 4: oklandsvag (3080 in chips) is sitting out
Seat 5: avril26 (2010 in chips) 
Seat 6: dfcastro.net (1450 in chips) 
Seat 7: meshesh00 (1470 in chips) 
Seat 8: pashaje (1300 in chips) 
Victorgd764: posts small blind 10
Phil_Laak119: posts big blind 20
*** HOLE CARDS ***
Dealt to dfcastro.net [Jh 7c]
oklandsvag: folds 
avril26: calls 20
dfcastro.net: folds 
meshesh00: folds 
pashaje: folds 
sportiano: folds 
Victorgd764: calls 10
Phil_Laak119: checks 
*** FLOP *** [6s 5h 9h]
Victorgd764: bets 20
Phil_Laak119: calls 20
avril26: calls 20
*** TURN *** [6s 5h 9h] [Tc]
Victorgd764: bets 20
Phil_Laak119: calls 20
avril26: calls 20
*** RIVER *** [6s 5h 9h Tc] [7s]
Victorgd764: bets 20
Phil_Laak119: folds 
avril26: calls 20
*** SHOW DOWN ***
Victorgd764: shows [2d 6c] (a pair of Sixes)
avril26: shows [Qs Ts] (a pair of Tens)
avril26 collected 220 from pot
*** SUMMARY ***
Total pot 220 | Rake 0 
Board [6s 5h 9h Tc 7s]
Seat 1: sportiano (button) folded before Flop (didn't bet)
Seat 2: Victorgd764 (small blind) showed [2d 6c] and lost with a pair of Sixes
Seat 3: Phil_Laak119 (big blind) folded on the River
Seat 4: oklandsvag folded before Flop (didn't bet)
Seat 5: avril26 showed [Qs Ts] and won (220) with a pair of Tens
Seat 6: dfcastro.net folded before Flop (didn't bet)
Seat 7: meshesh00 folded before Flop (didn't bet)
Seat 8: pashaje folded before Flop (didn't bet)



PokerStars Hand #100385932690: Tournament #750518676, $0.23+$0.02 USD Hold'em No Limit - Level I (10/20) - 2013/06/21 20:18:59 BRT [2013/06/21 19:18:59 ET]
Table '750518676 5' 9-max Seat #2 is the button
Seat 1: sportiano (1470 in chips) 
Seat 2: Victorgd764 (1160 in chips) 
Seat 3: Phil_Laak119 (1420 in chips) 
Seat 4: oklandsvag (3080 in chips) is sitting out
Seat 5: avril26 (2150 in chips) 
Seat 6: dfcastro.net (1450 in chips) 
Seat 7: meshesh00 (1470 in chips) 
Seat 8: pashaje (1300 in chips) 
Phil_Laak119: posts small blind 10
oklandsvag: posts big blind 20
*** HOLE CARDS ***
Dealt to dfcastro.net [3h 9d]
avril26: calls 20
dfcastro.net: folds 
meshesh00: raises 77 to 97
pashaje: folds 
sportiano: folds 
Victorgd764: folds 
Phil_Laak119: folds 
oklandsvag: folds 
avril26: calls 77
*** FLOP *** [Td Jh 3s]
avril26: checks 
meshesh00: bets 190
avril26: folds 
Uncalled bet (190) returned to meshesh00
meshesh00 collected 224 from pot
meshesh00: doesn't show hand 
*** SUMMARY ***
Total pot 224 | Rake 0 
Board [Td Jh 3s]
Seat 1: sportiano folded before Flop (didn't bet)
Seat 2: Victorgd764 (button) folded before Flop (didn't bet)
Seat 3: Phil_Laak119 (small blind) folded before Flop
Seat 4: oklandsvag (big blind) folded before Flop
Seat 5: avril26 folded on the Flop
Seat 6: dfcastro.net folded before Flop (didn't bet)
Seat 7: meshesh00 collected (224)
Seat 8: pashaje folded before Flop (didn't bet)



PokerStars Hand #100385959686: Tournament #750518676, $0.23+$0.02 USD Hold'em No Limit - Level I (10/20) - 2013/06/21 20:19:42 BRT [2013/06/21 19:19:42 ET]
Table '750518676 5' 9-max Seat #3 is the button
Seat 1: sportiano (1470 in chips) 
Seat 2: Victorgd764 (1160 in chips) 
Seat 3: Phil_Laak119 (1410 in chips) 
Seat 4: oklandsvag (3060 in chips) is sitting out
Seat 5: avril26 (2053 in chips) 
Seat 6: dfcastro.net (1450 in chips) 
Seat 7: meshesh00 (1597 in chips) 
Seat 8: pashaje (1300 in chips) 
oklandsvag: posts small blind 10
avril26: posts big blind 20
*** HOLE CARDS ***
Dealt to dfcastro.net [As Kc]
dfcastro.net: raises 80 to 100
meshesh00: folds 
pashaje: calls 100
sportiano: folds 
Victorgd764: folds 
Phil_Laak119: folds 
oklandsvag: folds 
avril26: calls 80
*** FLOP *** [Js Jc Jd]
avril26: checks 
dfcastro.net: checks 
pashaje: checks 
*** TURN *** [Js Jc Jd] [Qd]
avril26: checks 
dfcastro.net: checks 
pashaje: checks 
*** RIVER *** [Js Jc Jd Qd] [6c]
avril26: bets 520
dfcastro.net: folds 
pashaje: folds 
Uncalled bet (520) returned to avril26
avril26 collected 310 from pot
avril26: shows [3s]
*** SUMMARY ***
Total pot 310 | Rake 0 
Board [Js Jc Jd Qd 6c]
Seat 1: sportiano folded before Flop (didn't bet)
Seat 2: Victorgd764 folded before Flop (didn't bet)
Seat 3: Phil_Laak119 (button) folded before Flop (didn't bet)
Seat 4: oklandsvag (small blind) folded before Flop
Seat 5: avril26 (big blind) collected (310)
Seat 6: dfcastro.net folded on the River
Seat 7: meshesh00 folded before Flop (didn't bet)
Seat 8: pashaje folded on the River



PokerStars Hand #100385991756: Tournament #750518676, $0.23+$0.02 USD Hold'em No Limit - Level I (10/20) - 2013/06/21 20:20:33 BRT [2013/06/21 19:20:33 ET]
Table '750518676 5' 9-max Seat #4 is the button
Seat 1: sportiano (1470 in chips) 
Seat 2: Victorgd764 (1160 in chips) 
Seat 3: Phil_Laak119 (1410 in chips) 
Seat 4: oklandsvag (3050 in chips) is sitting out
Seat 5: avril26 (2263 in chips) 
Seat 6: dfcastro.net (1350 in chips) 
Seat 7: meshesh00 (1597 in chips) 
Seat 8: pashaje (1200 in chips) 
avril26: posts small blind 10
dfcastro.net: posts big blind 20
*** HOLE CARDS ***
Dealt to dfcastro.net [4h Ts]
meshesh00: folds 
pashaje: calls 20
sportiano: folds 
Victorgd764: folds 
Phil_Laak119: calls 20
oklandsvag: folds 
avril26: calls 10
dfcastro.net: checks 
*** FLOP *** [4c 6s Qc]
avril26: checks 
dfcastro.net: checks 
pashaje: bets 60
Phil_Laak119: calls 60
avril26: folds 
dfcastro.net: folds 
*** TURN *** [4c 6s Qc] [Jd]
dfcastro.net is sitting out
pashaje: checks 
Phil_Laak119: checks 
*** RIVER *** [4c 6s Qc Jd] [Qd]
pashaje: bets 60
Phil_Laak119: folds 
Uncalled bet (60) returned to pashaje
pashaje collected 200 from pot
*** SUMMARY ***
Total pot 200 | Rake 0 
Board [4c 6s Qc Jd Qd]
Seat 1: sportiano folded before Flop (didn't bet)
Seat 2: Victorgd764 folded before Flop (didn't bet)
Seat 3: Phil_Laak119 folded on the River
Seat 4: oklandsvag (button) folded before Flop (didn't bet)
Seat 5: avril26 (small blind) folded on the Flop
Seat 6: dfcastro.net (big blind) folded on the Flop
Seat 7: meshesh00 folded before Flop (didn't bet)
Seat 8: pashaje collected (200)



PokerStars Hand #100386034383: Tournament #750518676, $0.23+$0.02 USD Hold'em No Limit - Level I (10/20) - 2013/06/21 20:21:41 BRT [2013/06/21 19:21:41 ET]
Table '750518676 5' 9-max Seat #5 is the button
Seat 1: sportiano (1470 in chips) 
Seat 2: Victorgd764 (1160 in chips) 
Seat 3: Phil_Laak119 (1330 in chips) 
Seat 4: oklandsvag (3050 in chips) is sitting out
Seat 5: avril26 (2243 in chips) 
Seat 6: dfcastro.net (1330 in chips) is sitting out
Seat 7: meshesh00 (1597 in chips) 
Seat 8: pashaje (1320 in chips) 
Seat 9: snoopstars (1450 in chips) 
dfcastro.net: posts small blind 10
meshesh00: posts big blind 20
*** HOLE CARDS ***
Dealt to dfcastro.net [3c As]
pashaje: calls 20
snoopstars: folds 
sportiano: folds 
Victorgd764: calls 20
dfcastro.net has returned
Phil_Laak119: folds 
oklandsvag: folds 
avril26: folds 
dfcastro.net: folds 
meshesh00: checks 
*** FLOP *** [5h Ah Tc]
meshesh00: checks 
pashaje: checks 
Victorgd764: checks 
*** TURN *** [5h Ah Tc] [6c]
meshesh00: checks 
dfcastro.net is sitting out
pashaje: bets 20
oklandsvag has returned
Victorgd764: calls 20
meshesh00: calls 20
*** RIVER *** [5h Ah Tc 6c] [8s]
meshesh00: checks 
pashaje: bets 40
Victorgd764: folds 
meshesh00: calls 40
*** SHOW DOWN ***
pashaje: shows [Td Kc] (a pair of Tens)
meshesh00: mucks hand 
pashaje collected 210 from pot
*** SUMMARY ***
Total pot 210 | Rake 0 
Board [5h Ah Tc 6c 8s]
Seat 1: sportiano folded before Flop (didn't bet)
Seat 2: Victorgd764 folded on the River
Seat 3: Phil_Laak119 folded before Flop (didn't bet)
Seat 4: oklandsvag folded before Flop (didn't bet)
Seat 5: avril26 (button) folded before Flop (didn't bet)
Seat 6: dfcastro.net (small blind) folded before Flop
Seat 7: meshesh00 (big blind) mucked [Qh 8h]
Seat 8: pashaje showed [Td Kc] and won (210) with a pair of Tens
Seat 9: snoopstars folded before Flop (didn't bet)



PokerStars Hand #100386076216: Tournament #750518676, $0.23+$0.02 USD Hold'em No Limit - Level II (15/30) - 2013/06/21 20:22:47 BRT [2013/06/21 19:22:47 ET]
Table '750518676 5' 9-max Seat #6 is the button
Seat 1: sportiano (1470 in chips) 
Seat 2: Victorgd764 (1120 in chips) 
Seat 3: Phil_Laak119 (1330 in chips) 
Seat 4: oklandsvag (3050 in chips) 
Seat 5: avril26 (2243 in chips) 
Seat 6: dfcastro.net (1320 in chips) is sitting out
Seat 7: meshesh00 (1517 in chips) 
Seat 8: pashaje (1450 in chips) 
Seat 9: snoopstars (1450 in chips) 
meshesh00: posts small blind 15
pashaje: posts big blind 30
*** HOLE CARDS ***
Dealt to dfcastro.net [6d 4d]
snoopstars: folds 
sportiano: folds 
Victorgd764: folds 
Phil_Laak119: folds 
oklandsvag: raises 60 to 90
avril26: folds 
dfcastro.net: folds 
meshesh00: folds 
pashaje: calls 60
*** FLOP *** [7c Ts 4s]
pashaje: checks 
oklandsvag: checks 
*** TURN *** [7c Ts 4s] [Ks]
pashaje: checks 
oklandsvag: checks 
*** RIVER *** [7c Ts 4s Ks] [Qd]
pashaje: bets 150
oklandsvag: folds 
Uncalled bet (150) returned to pashaje
pashaje collected 195 from pot
*** SUMMARY ***
Total pot 195 | Rake 0 
Board [7c Ts 4s Ks Qd]
Seat 1: sportiano folded before Flop (didn't bet)
Seat 2: Victorgd764 folded before Flop (didn't bet)
Seat 3: Phil_Laak119 folded before Flop (didn't bet)
Seat 4: oklandsvag folded on the River
Seat 5: avril26 folded before Flop (didn't bet)
Seat 6: dfcastro.net (button) folded before Flop (didn't bet)
Seat 7: meshesh00 (small blind) folded before Flop
Seat 8: pashaje (big blind) collected (195)
Seat 9: snoopstars folded before Flop (didn't bet)



PokerStars Hand #100386109473: Tournament #750518676, $0.23+$0.02 USD Hold'em No Limit - Level II (15/30) - 2013/06/21 20:23:40 BRT [2013/06/21 19:23:40 ET]
Table '750518676 5' 9-max Seat #7 is the button
Seat 1: sportiano (1470 in chips) 
Seat 2: Victorgd764 (1120 in chips) 
Seat 3: Phil_Laak119 (1330 in chips) 
Seat 4: oklandsvag (2960 in chips) 
Seat 5: avril26 (2243 in chips) 
Seat 6: dfcastro.net (1320 in chips) is sitting out
Seat 7: meshesh00 (1502 in chips) 
Seat 8: pashaje (1555 in chips) 
Seat 9: snoopstars (1450 in chips) 
pashaje: posts small blind 15
snoopstars: posts big blind 30
*** HOLE CARDS ***
Dealt to dfcastro.net [Th 5c]
sportiano: folds 
dfcastro.net has returned
Victorgd764: folds 
Phil_Laak119: folds 
oklandsvag: folds 
avril26: folds 
dfcastro.net: folds 
meshesh00 has timed out
meshesh00: folds 
meshesh00 is sitting out
pashaje: calls 15
snoopstars: checks 
*** FLOP *** [6d 4s 7s]
pashaje: checks 
meshesh00 has returned
snoopstars: bets 60
pashaje: calls 60
*** TURN *** [6d 4s 7s] [9s]
pashaje: checks 
snoopstars: checks 
*** RIVER *** [6d 4s 7s 9s] [4h]
pashaje: bets 90
snoopstars: calls 90
*** SHOW DOWN ***
pashaje: shows [7h 6c] (two pair, Sevens and Sixes)
snoopstars: mucks hand 
pashaje collected 360 from pot
*** SUMMARY ***
Total pot 360 | Rake 0 
Board [6d 4s 7s 9s 4h]
Seat 1: sportiano folded before Flop (didn't bet)
Seat 2: Victorgd764 folded before Flop (didn't bet)
Seat 3: Phil_Laak119 folded before Flop (didn't bet)
Seat 4: oklandsvag folded before Flop (didn't bet)
Seat 5: avril26 folded before Flop (didn't bet)
Seat 6: dfcastro.net folded before Flop (didn't bet)
Seat 7: meshesh00 (button) folded before Flop (didn't bet)
Seat 8: pashaje (small blind) showed [7h 6c] and won (360) with two pair, Sevens and Sixes
Seat 9: snoopstars (big blind) mucked [2d 6s]



PokerStars Hand #100386147392: Tournament #750518676, $0.23+$0.02 USD Hold'em No Limit - Level II (15/30) - 2013/06/21 20:24:41 BRT [2013/06/21 19:24:41 ET]
Table '750518676 5' 9-max Seat #8 is the button
Seat 1: sportiano (1470 in chips) 
Seat 2: Victorgd764 (1120 in chips) 
Seat 3: Phil_Laak119 (1330 in chips) 
Seat 4: oklandsvag (2960 in chips) 
Seat 5: avril26 (2243 in chips) 
Seat 6: dfcastro.net (1320 in chips) 
Seat 7: meshesh00 (1502 in chips) 
Seat 8: pashaje (1735 in chips) 
Seat 9: snoopstars (1270 in chips) 
snoopstars: posts small blind 15
sportiano: posts big blind 30
*** HOLE CARDS ***
Dealt to dfcastro.net [6s 7s]
Victorgd764: raises 30 to 60
Phil_Laak119: raises 90 to 150
oklandsvag: raises 120 to 270
avril26: calls 270
dfcastro.net: folds 
meshesh00: folds 
pashaje: folds 
snoopstars: folds 
sportiano: folds 
Victorgd764: raises 850 to 1120 and is all-in
Phil_Laak119: raises 210 to 1330 and is all-in
oklandsvag: raises 850 to 2180
avril26: folds 
Uncalled bet (850) returned to oklandsvag
*** FLOP *** [4d 9h Tc]
*** TURN *** [4d 9h Tc] [Td]
*** RIVER *** [4d 9h Tc Td] [2h]
*** SHOW DOWN ***
Phil_Laak119: shows [Qc Qh] (two pair, Queens and Tens)
oklandsvag: shows [Jc Js] (two pair, Jacks and Tens)
Phil_Laak119 collected 420 from side pot
Victorgd764: shows [Ac Ad] (two pair, Aces and Tens)
Victorgd764 collected 3675 from main pot
*** SUMMARY ***
Total pot 4095 Main pot 3675. Side pot 420. | Rake 0 
Board [4d 9h Tc Td 2h]
Seat 1: sportiano (big blind) folded before Flop
Seat 2: Victorgd764 showed [Ac Ad] and won (3675) with two pair, Aces and Tens
Seat 3: Phil_Laak119 showed [Qc Qh] and won (420) with two pair, Queens and Tens
Seat 4: oklandsvag showed [Jc Js] and lost with two pair, Jacks and Tens
Seat 5: avril26 folded before Flop
Seat 6: dfcastro.net folded before Flop (didn't bet)
Seat 7: meshesh00 folded before Flop (didn't bet)
Seat 8: pashaje (button) folded before Flop (didn't bet)
Seat 9: snoopstars (small blind) folded before Flop



PokerStars Hand #100386192622: Tournament #750518676, $0.23+$0.02 USD Hold'em No Limit - Level II (15/30) - 2013/06/21 20:25:54 BRT [2013/06/21 19:25:54 ET]
Table '750518676 5' 9-max Seat #9 is the button
Seat 1: sportiano (1440 in chips) 
Seat 2: Victorgd764 (3675 in chips) 
Seat 3: Phil_Laak119 (420 in chips) 
Seat 4: oklandsvag (1630 in chips) 
Seat 5: avril26 (1973 in chips) 
Seat 6: dfcastro.net (1320 in chips) 
Seat 7: meshesh00 (1502 in chips) 
Seat 8: pashaje (1735 in chips) 
Seat 9: snoopstars (1255 in chips) 
sportiano: posts small blind 15
Victorgd764: posts big blind 30
*** HOLE CARDS ***
Dealt to dfcastro.net [Kh 6d]
Phil_Laak119: folds 
oklandsvag: raises 210 to 240
avril26: folds 
dfcastro.net: folds 
meshesh00: folds 
pashaje: folds 
snoopstars: folds 
sportiano: folds 
Victorgd764: folds 
Uncalled bet (210) returned to oklandsvag
oklandsvag collected 75 from pot
*** SUMMARY ***
Total pot 75 | Rake 0 
Seat 1: sportiano (small blind) folded before Flop
Seat 2: Victorgd764 (big blind) folded before Flop
Seat 3: Phil_Laak119 folded before Flop (didn't bet)
Seat 4: oklandsvag collected (75)
Seat 5: avril26 folded before Flop (didn't bet)
Seat 6: dfcastro.net folded before Flop (didn't bet)
Seat 7: meshesh00 folded before Flop (didn't bet)
Seat 8: pashaje folded before Flop (didn't bet)
Seat 9: snoopstars (button) folded before Flop (didn't bet)



PokerStars Hand #100386214179: Tournament #750518676, $0.23+$0.02 USD Hold'em No Limit - Level II (15/30) - 2013/06/21 20:26:29 BRT [2013/06/21 19:26:29 ET]
Table '750518676 5' 9-max Seat #1 is the button
Seat 1: sportiano (1425 in chips) 
Seat 2: Victorgd764 (3645 in chips) 
Seat 3: Phil_Laak119 (420 in chips) 
Seat 4: oklandsvag (1675 in chips) 
Seat 5: avril26 (1973 in chips) 
Seat 6: dfcastro.net (1320 in chips) 
Seat 7: meshesh00 (1502 in chips) 
Seat 8: pashaje (1735 in chips) 
Seat 9: snoopstars (1255 in chips) 
Victorgd764: posts small blind 15
Phil_Laak119: posts big blind 30
*** HOLE CARDS ***
Dealt to dfcastro.net [Jh Kd]
oklandsvag: raises 90 to 120
avril26: folds 
dfcastro.net: folds 
meshesh00: folds 
pashaje: folds 
snoopstars: folds 
sportiano: folds 
Victorgd764: folds 
Phil_Laak119: folds 
Uncalled bet (90) returned to oklandsvag
oklandsvag collected 75 from pot
*** SUMMARY ***
Total pot 75 | Rake 0 
Seat 1: sportiano (button) folded before Flop (didn't bet)
Seat 2: Victorgd764 (small blind) folded before Flop
Seat 3: Phil_Laak119 (big blind) folded before Flop
Seat 4: oklandsvag collected (75)
Seat 5: avril26 folded before Flop (didn't bet)
Seat 6: dfcastro.net folded before Flop (didn't bet)
Seat 7: meshesh00 folded before Flop (didn't bet)
Seat 8: pashaje folded before Flop (didn't bet)
Seat 9: snoopstars folded before Flop (didn't bet)



PokerStars Hand #100386233393: Tournament #750518676, $0.23+$0.02 USD Hold'em No Limit - Level II (15/30) - 2013/06/21 20:27:01 BRT [2013/06/21 19:27:01 ET]
Table '750518676 5' 9-max Seat #2 is the button
Seat 1: sportiano (1425 in chips) 
Seat 2: Victorgd764 (3630 in chips) 
Seat 3: Phil_Laak119 (390 in chips) 
Seat 4: oklandsvag (1720 in chips) 
Seat 5: avril26 (1973 in chips) 
Seat 6: dfcastro.net (1320 in chips) 
Seat 7: meshesh00 (1502 in chips) 
Seat 8: pashaje (1735 in chips) 
Seat 9: snoopstars (1255 in chips) 
Phil_Laak119: posts small blind 15
oklandsvag: posts big blind 30
*** HOLE CARDS ***
Dealt to dfcastro.net [8c Kc]
avril26: calls 30
dfcastro.net: folds 
meshesh00: folds 
pashaje: calls 30
snoopstars: folds 
sportiano: folds 
Victorgd764: folds 
Phil_Laak119: folds 
oklandsvag: raises 120 to 150
avril26: calls 120
pashaje: calls 120
*** FLOP *** [6s 2s 4c]
oklandsvag: bets 180
avril26: folds 
pashaje: folds 
Uncalled bet (180) returned to oklandsvag
oklandsvag collected 465 from pot
oklandsvag: doesn't show hand 
*** SUMMARY ***
Total pot 465 | Rake 0 
Board [6s 2s 4c]
Seat 1: sportiano folded before Flop (didn't bet)
Seat 2: Victorgd764 (button) folded before Flop (didn't bet)
Seat 3: Phil_Laak119 (small blind) folded before Flop
Seat 4: oklandsvag (big blind) collected (465)
Seat 5: avril26 folded on the Flop
Seat 6: dfcastro.net folded before Flop (didn't bet)
Seat 7: meshesh00 folded before Flop (didn't bet)
Seat 8: pashaje folded on the Flop
Seat 9: snoopstars folded before Flop (didn't bet)



PokerStars Hand #100386272432: Tournament #750518676, $0.23+$0.02 USD Hold'em No Limit - Level II (15/30) - 2013/06/21 20:28:04 BRT [2013/06/21 19:28:04 ET]
Table '750518676 5' 9-max Seat #3 is the button
Seat 1: sportiano (1425 in chips) 
Seat 2: Victorgd764 (3630 in chips) 
Seat 3: Phil_Laak119 (375 in chips) 
Seat 4: oklandsvag (2035 in chips) 
Seat 5: avril26 (1823 in chips) 
Seat 6: dfcastro.net (1320 in chips) 
Seat 7: meshesh00 (1502 in chips) 
Seat 8: pashaje (1585 in chips) 
Seat 9: snoopstars (1255 in chips) 
oklandsvag: posts small blind 15
avril26: posts big blind 30
*** HOLE CARDS ***
Dealt to dfcastro.net [5s 3s]
dfcastro.net: folds 
meshesh00: raises 30 to 60
pashaje: folds 
snoopstars: folds 
sportiano: folds 
Victorgd764: raises 60 to 120
Phil_Laak119: folds 
oklandsvag: folds 
avril26: folds 
meshesh00: calls 60
*** FLOP *** [2s 8h 3h]
meshesh00: folds 
Victorgd764 collected 285 from pot
*** SUMMARY ***
Total pot 285 | Rake 0 
Board [2s 8h 3h]
Seat 1: sportiano folded before Flop (didn't bet)
Seat 2: Victorgd764 collected (285)
Seat 3: Phil_Laak119 (button) folded before Flop (didn't bet)
Seat 4: oklandsvag (small blind) folded before Flop
Seat 5: avril26 (big blind) folded before Flop
Seat 6: dfcastro.net folded before Flop (didn't bet)
Seat 7: meshesh00 folded on the Flop
Seat 8: pashaje folded before Flop (didn't bet)
Seat 9: snoopstars folded before Flop (didn't bet)



PokerStars Hand #100386289295: Tournament #750518676, $0.23+$0.02 USD Hold'em No Limit - Level II (15/30) - 2013/06/21 20:28:32 BRT [2013/06/21 19:28:32 ET]
Table '750518676 5' 9-max Seat #4 is the button
Seat 1: sportiano (1425 in chips) 
Seat 2: Victorgd764 (3795 in chips) 
Seat 3: Phil_Laak119 (375 in chips) 
Seat 4: oklandsvag (2020 in chips) 
Seat 5: avril26 (1793 in chips) 
Seat 6: dfcastro.net (1320 in chips) 
Seat 7: meshesh00 (1382 in chips) 
Seat 8: pashaje (1585 in chips) 
Seat 9: snoopstars (1255 in chips) 
avril26: posts small blind 15
dfcastro.net: posts big blind 30
*** HOLE CARDS ***
Dealt to dfcastro.net [Kd 4c]
meshesh00: folds 
pashaje: folds 
snoopstars: folds 
sportiano: folds 
Victorgd764: raises 30 to 60
Phil_Laak119: folds 
oklandsvag: calls 60
avril26: calls 45
dfcastro.net: folds 
*** FLOP *** [2h 5h Qd]
avril26: checks 
Victorgd764: checks 
oklandsvag: bets 210
avril26: folds 
Victorgd764: folds 
Uncalled bet (210) returned to oklandsvag
oklandsvag collected 210 from pot
*** SUMMARY ***
Total pot 210 | Rake 0 
Board [2h 5h Qd]
Seat 1: sportiano folded before Flop (didn't bet)
Seat 2: Victorgd764 folded on the Flop
Seat 3: Phil_Laak119 folded before Flop (didn't bet)
Seat 4: oklandsvag (button) collected (210)
Seat 5: avril26 (small blind) folded on the Flop
Seat 6: dfcastro.net (big blind) folded before Flop
Seat 7: meshesh00 folded before Flop (didn't bet)
Seat 8: pashaje folded before Flop (didn't bet)
Seat 9: snoopstars folded before Flop (didn't bet)



PokerStars Hand #100386351993: Tournament #750518676, $0.23+$0.02 USD Hold'em No Limit - Level II (15/30) - 2013/06/21 20:30:16 BRT [2013/06/21 19:30:16 ET]
Table '750518676 5' 9-max Seat #5 is the button
Seat 2: Victorgd764 (3735 in chips) 
Seat 3: Phil_Laak119 (375 in chips) 
Seat 4: oklandsvag (2170 in chips) 
Seat 5: avril26 (1733 in chips) 
Seat 6: dfcastro.net (1290 in chips) 
Seat 7: meshesh00 (1382 in chips) 
Seat 8: pashaje (1585 in chips) 
Seat 9: snoopstars (1255 in chips) 
dfcastro.net: posts small blind 15
meshesh00: posts big blind 30
*** HOLE CARDS ***
Dealt to dfcastro.net [6d 3h]
pashaje: raises 30 to 60
snoopstars: folds 
Victorgd764: folds 
Phil_Laak119: folds 
oklandsvag: calls 60
avril26: calls 60
dfcastro.net: folds 
meshesh00: raises 221 to 281
pashaje: calls 221
oklandsvag: calls 221
avril26: folds 
*** FLOP *** [2s 8h Ah]
meshesh00: bets 510
pashaje: folds 
oklandsvag: folds 
Uncalled bet (510) returned to meshesh00
meshesh00 collected 918 from pot
meshesh00: doesn't show hand 
*** SUMMARY ***
Total pot 918 | Rake 0 
Board [2s 8h Ah]
Seat 2: Victorgd764 folded before Flop (didn't bet)
Seat 3: Phil_Laak119 folded before Flop (didn't bet)
Seat 4: oklandsvag folded on the Flop
Seat 5: avril26 (button) folded before Flop
Seat 6: dfcastro.net (small blind) folded before Flop
Seat 7: meshesh00 (big blind) collected (918)
Seat 8: pashaje folded on the Flop
Seat 9: snoopstars folded before Flop (didn't bet)



PokerStars Hand #100386387277: Tournament #750518676, $0.23+$0.02 USD Hold'em No Limit - Level II (15/30) - 2013/06/21 20:31:14 BRT [2013/06/21 19:31:14 ET]
Table '750518676 5' 9-max Seat #6 is the button
Seat 2: Victorgd764 (3735 in chips) 
Seat 3: Phil_Laak119 (375 in chips) 
Seat 4: oklandsvag (1889 in chips) 
Seat 5: avril26 (1673 in chips) 
Seat 6: dfcastro.net (1275 in chips) 
Seat 7: meshesh00 (2019 in chips) 
Seat 8: pashaje (1304 in chips) 
Seat 9: snoopstars (1255 in chips) 
meshesh00: posts small blind 15
pashaje: posts big blind 30
*** HOLE CARDS ***
Dealt to dfcastro.net [7d Jc]
snoopstars: folds 
Victorgd764: folds 
Phil_Laak119: folds 
oklandsvag: raises 90 to 120
avril26: calls 120
dfcastro.net: folds 
meshesh00: folds 
pashaje: folds 
*** FLOP *** [3c Kd 2d]
oklandsvag: checks 
avril26: checks 
*** TURN *** [3c Kd 2d] [Ac]
oklandsvag: checks 
avril26: checks 
*** RIVER *** [3c Kd 2d Ac] [Jd]
oklandsvag: bets 120
avril26: calls 120
*** SHOW DOWN ***
oklandsvag: shows [Js 8d] (a pair of Jacks)
avril26: shows [5h 5c] (a pair of Fives)
oklandsvag collected 525 from pot
*** SUMMARY ***
Total pot 525 | Rake 0 
Board [3c Kd 2d Ac Jd]
Seat 2: Victorgd764 folded before Flop (didn't bet)
Seat 3: Phil_Laak119 folded before Flop (didn't bet)
Seat 4: oklandsvag showed [Js 8d] and won (525) with a pair of Jacks
Seat 5: avril26 showed [5h 5c] and lost with a pair of Fives
Seat 6: dfcastro.net (button) folded before Flop (didn't bet)
Seat 7: meshesh00 (small blind) folded before Flop
Seat 8: pashaje (big blind) folded before Flop
Seat 9: snoopstars folded before Flop (didn't bet)



PokerStars Hand #100386408915: Tournament #750518676, $0.23+$0.02 USD Hold'em No Limit - Level II (15/30) - 2013/06/21 20:31:50 BRT [2013/06/21 19:31:50 ET]
Table '750518676 5' 9-max Seat #7 is the button
Seat 2: Victorgd764 (3735 in chips) 
Seat 3: Phil_Laak119 (375 in chips) 
Seat 4: oklandsvag (2174 in chips) 
Seat 5: avril26 (1433 in chips) 
Seat 6: dfcastro.net (1275 in chips) 
Seat 7: meshesh00 (2004 in chips) 
Seat 8: pashaje (1274 in chips) 
Seat 9: snoopstars (1255 in chips) 
pashaje: posts small blind 15
snoopstars: posts big blind 30
*** HOLE CARDS ***
Dealt to dfcastro.net [Ac 9h]
Victorgd764: folds 
Phil_Laak119: raises 345 to 375 and is all-in
oklandsvag: folds 
avril26: folds 
dfcastro.net: calls 375
meshesh00: folds 
pashaje: folds 
snoopstars: folds 
*** FLOP *** [2h 6s 4h]
*** TURN *** [2h 6s 4h] [As]
*** RIVER *** [2h 6s 4h As] [4d]
*** SHOW DOWN ***
Phil_Laak119: shows [Js Qd] (a pair of Fours)
dfcastro.net: shows [Ac 9h] (two pair, Aces and Fours)
dfcastro.net collected 795 from pot
Phil_Laak119 finished the tournament in 30th place
*** SUMMARY ***
Total pot 795 | Rake 0 
Board [2h 6s 4h As 4d]
Seat 2: Victorgd764 folded before Flop (didn't bet)
Seat 3: Phil_Laak119 showed [Js Qd] and lost with a pair of Fours
Seat 4: oklandsvag folded before Flop (didn't bet)
Seat 5: avril26 folded before Flop (didn't bet)
Seat 6: dfcastro.net showed [Ac 9h] and won (795) with two pair, Aces and Fours
Seat 7: meshesh00 (button) folded before Flop (didn't bet)
Seat 8: pashaje (small blind) folded before Flop
Seat 9: snoopstars (big blind) folded before Flop



PokerStars Hand #100386427575: Tournament #750518676, $0.23+$0.02 USD Hold'em No Limit - Level III (25/50) - 2013/06/21 20:32:22 BRT [2013/06/21 19:32:22 ET]
Table '750518676 5' 9-max Seat #8 is the button
Seat 2: Victorgd764 (3735 in chips) 
Seat 4: oklandsvag (2174 in chips) 
Seat 5: avril26 (1433 in chips) 
Seat 6: dfcastro.net (1695 in chips) 
Seat 7: meshesh00 (2004 in chips) 
Seat 8: pashaje (1259 in chips) 
Seat 9: snoopstars (1225 in chips) 
snoopstars: posts small blind 25
Victorgd764: posts big blind 50
*** HOLE CARDS ***
Dealt to dfcastro.net [Td As]
oklandsvag: raises 150 to 200
avril26: calls 200
dfcastro.net: folds 
meshesh00: folds 
pashaje: raises 1059 to 1259 and is all-in
snoopstars: calls 1200 and is all-in
Victorgd764: folds 
oklandsvag: calls 1059
avril26: folds 
*** FLOP *** [Ks 2d Qc]
*** TURN *** [Ks 2d Qc] [4c]
*** RIVER *** [Ks 2d Qc 4c] [2c]
*** SHOW DOWN ***
oklandsvag: shows [Ad Qd] (two pair, Queens and Deuces)
pashaje: shows [6c Ac] (a flush, Ace high)
pashaje collected 68 from side pot
snoopstars: shows [Ah Kh] (two pair, Kings and Deuces)
pashaje collected 3925 from main pot
snoopstars finished the tournament in 29th place
*** SUMMARY ***
Total pot 3993 Main pot 3925. Side pot 68. | Rake 0 
Board [Ks 2d Qc 4c 2c]
Seat 2: Victorgd764 (big blind) folded before Flop
Seat 4: oklandsvag showed [Ad Qd] and lost with two pair, Queens and Deuces
Seat 5: avril26 folded before Flop
Seat 6: dfcastro.net folded before Flop (didn't bet)
Seat 7: meshesh00 folded before Flop (didn't bet)
Seat 8: pashaje (button) showed [6c Ac] and won (3993) with a flush, Ace high
Seat 9: snoopstars (small blind) showed [Ah Kh] and lost with two pair, Kings and Deuces



PokerStars Hand #100386453518: Tournament #750518676, $0.23+$0.02 USD Hold'em No Limit - Level III (25/50) - 2013/06/21 20:33:06 BRT [2013/06/21 19:33:06 ET]
Table '750518676 5' 9-max Seat #2 is the button
Seat 2: Victorgd764 (3685 in chips) 
Seat 4: oklandsvag (915 in chips) 
Seat 5: avril26 (1233 in chips) 
Seat 6: dfcastro.net (1695 in chips) 
Seat 7: meshesh00 (2004 in chips) 
Seat 8: pashaje (3993 in chips) 
oklandsvag: posts small blind 25
avril26: posts big blind 50
*** HOLE CARDS ***
Dealt to dfcastro.net [Tc 9c]
dfcastro.net: folds 
meshesh00: folds 
pashaje: calls 50
Victorgd764: folds 
oklandsvag: raises 865 to 915 and is all-in
avril26: folds 
pashaje: calls 865
*** FLOP *** [Kc Ad 7s]
*** TURN *** [Kc Ad 7s] [3d]
*** RIVER *** [Kc Ad 7s 3d] [Jd]
*** SHOW DOWN ***
oklandsvag: shows [Kd Jh] (two pair, Kings and Jacks)
pashaje: shows [5c 5s] (a pair of Fives)
oklandsvag collected 1880 from pot
*** SUMMARY ***
Total pot 1880 | Rake 0 
Board [Kc Ad 7s 3d Jd]
Seat 2: Victorgd764 (button) folded before Flop (didn't bet)
Seat 4: oklandsvag (small blind) showed [Kd Jh] and won (1880) with two pair, Kings and Jacks
Seat 5: avril26 (big blind) folded before Flop
Seat 6: dfcastro.net folded before Flop (didn't bet)
Seat 7: meshesh00 folded before Flop (didn't bet)
Seat 8: pashaje showed [5c 5s] and lost with a pair of Fives



PokerStars Hand #100386471804: Tournament #750518676, $0.23+$0.02 USD Hold'em No Limit - Level III (25/50) - 2013/06/21 20:33:37 BRT [2013/06/21 19:33:37 ET]
Table '750518676 5' 9-max Seat #4 is the button
Seat 2: Victorgd764 (3685 in chips) 
Seat 4: oklandsvag (1880 in chips) 
Seat 5: avril26 (1183 in chips) 
Seat 6: dfcastro.net (1695 in chips) 
Seat 7: meshesh00 (2004 in chips) 
Seat 8: pashaje (3078 in chips) 
avril26: posts small blind 25
dfcastro.net: posts big blind 50
*** HOLE CARDS ***
Dealt to dfcastro.net [5d Ts]
meshesh00: folds 
pashaje: calls 50
Victorgd764: folds 
oklandsvag: raises 150 to 200
avril26: calls 175
dfcastro.net: folds 
pashaje: calls 150
*** FLOP *** [6s Jh Jc]
avril26: checks 
pashaje: checks 
oklandsvag: checks 
*** TURN *** [6s Jh Jc] [5h]
avril26: bets 250
pashaje: calls 250
oklandsvag: raises 450 to 700
avril26: calls 450
pashaje: folds 
*** RIVER *** [6s Jh Jc 5h] [6d]
avril26: checks 
oklandsvag: bets 500
avril26: folds 
Uncalled bet (500) returned to oklandsvag
oklandsvag collected 2300 from pot
*** SUMMARY ***
Total pot 2300 | Rake 0 
Board [6s Jh Jc 5h 6d]
Seat 2: Victorgd764 folded before Flop (didn't bet)
Seat 4: oklandsvag (button) collected (2300)
Seat 5: avril26 (small blind) folded on the River
Seat 6: dfcastro.net (big blind) folded before Flop
Seat 7: meshesh00 folded before Flop (didn't bet)
Seat 8: pashaje folded on the Turn



PokerStars Hand #100386504660: Tournament #750518676, $0.23+$0.02 USD Hold'em No Limit - Level III (25/50) - 2013/06/21 20:34:34 BRT [2013/06/21 19:34:34 ET]
Table '750518676 5' 9-max Seat #5 is the button
Seat 2: Victorgd764 (3685 in chips) 
Seat 4: oklandsvag (3280 in chips) 
Seat 5: avril26 (283 in chips) 
Seat 6: dfcastro.net (1645 in chips) 
Seat 7: meshesh00 (2004 in chips) 
Seat 8: pashaje (2628 in chips) 
dfcastro.net: posts small blind 25
meshesh00: posts big blind 50
*** HOLE CARDS ***
Dealt to dfcastro.net [4h 9c]
pashaje: calls 50
Victorgd764: folds 
oklandsvag: folds 
avril26: raises 233 to 283 and is all-in
dfcastro.net: folds 
meshesh00: folds 
pashaje: calls 233
*** FLOP *** [As Qh 8h]
*** TURN *** [As Qh 8h] [Kh]
*** RIVER *** [As Qh 8h Kh] [7h]
*** SHOW DOWN ***
pashaje: shows [3h Jh] (a flush, King high)
avril26: shows [Qs Th] (a flush, King high - lower cards)
pashaje collected 641 from pot
*** SUMMARY ***
Total pot 641 | Rake 0 
Board [As Qh 8h Kh 7h]
Seat 2: Victorgd764 folded before Flop (didn't bet)
Seat 4: oklandsvag folded before Flop (didn't bet)
Seat 5: avril26 (button) showed [Qs Th] and lost with a flush, King high
Seat 6: dfcastro.net (small blind) folded before Flop
Seat 7: meshesh00 (big blind) folded before Flop
Seat 8: pashaje showed [3h Jh] and won (641) with a flush, King high



PokerStars Hand #100386537964: Tournament #750518676, $0.23+$0.02 USD Hold'em No Limit - Level III (25/50) - 2013/06/21 20:35:31 BRT [2013/06/21 19:35:31 ET]
Table '750518676 4' 9-max Seat #8 is the button
Seat 1: Victorgd764 (3685 in chips) 
Seat 2: PeyoURU (1720 in chips) 
Seat 3: dfcastro.net (1620 in chips) 
Seat 4: the vege (2020 in chips) 
Seat 5: giguezinho (3930 in chips) 
Seat 6: 14129088 (4350 in chips) 
Seat 7: Y_NG_X (4680 in chips) 
Seat 8: sportiano (1280 in chips) 
Seat 9: Silvaa.10 (4405 in chips) 
Silvaa.10: posts small blind 25
Victorgd764: posts big blind 50
*** HOLE CARDS ***
Dealt to dfcastro.net [8d Js]
PeyoURU: folds 
dfcastro.net: folds 
the vege: calls 50
giguezinho: folds 
14129088: folds 
Y_NG_X: calls 50
sportiano: folds 
Silvaa.10: calls 25
Victorgd764: checks 
*** FLOP *** [8s Ah 7h]
Silvaa.10: checks 
Victorgd764: bets 50
the vege: calls 50
Y_NG_X: folds 
Silvaa.10: raises 205 to 255
Victorgd764: calls 205
the vege: calls 205
*** TURN *** [8s Ah 7h] [4d]
Silvaa.10: bets 700
Victorgd764: folds 
the vege: folds 
Uncalled bet (700) returned to Silvaa.10
Silvaa.10 collected 965 from pot
*** SUMMARY ***
Total pot 965 | Rake 0 
Board [8s Ah 7h 4d]
Seat 1: Victorgd764 (big blind) folded on the Turn
Seat 2: PeyoURU folded before Flop (didn't bet)
Seat 3: dfcastro.net folded before Flop (didn't bet)
Seat 4: the vege folded on the Turn
Seat 5: giguezinho folded before Flop (didn't bet)
Seat 6: 14129088 folded before Flop (didn't bet)
Seat 7: Y_NG_X folded on the Flop
Seat 8: sportiano (button) folded before Flop (didn't bet)
Seat 9: Silvaa.10 (small blind) collected (965)



PokerStars Hand #100386598453: Tournament #750518676, $0.23+$0.02 USD Hold'em No Limit - Level III (25/50) - 2013/06/21 20:37:15 BRT [2013/06/21 19:37:15 ET]
Table '750518676 4' 9-max Seat #9 is the button
Seat 1: Victorgd764 (3380 in chips) 
Seat 2: PeyoURU (1720 in chips) 
Seat 3: dfcastro.net (1620 in chips) 
Seat 4: the vege (1715 in chips) 
Seat 5: giguezinho (3930 in chips) 
Seat 6: 14129088 (4350 in chips) 
Seat 7: Y_NG_X (4630 in chips) 
Seat 8: sportiano (1280 in chips) 
Seat 9: Silvaa.10 (5065 in chips) 
Victorgd764: posts small blind 25
PeyoURU: posts big blind 50
*** HOLE CARDS ***
Dealt to dfcastro.net [Ts 5h]
dfcastro.net: folds 
the vege: calls 50
giguezinho: folds 
14129088: folds 
Y_NG_X: folds 
sportiano: folds 
Silvaa.10: folds 
Victorgd764: folds 
PeyoURU: checks 
*** FLOP *** [3s 4s Kd]
PeyoURU: bets 100
the vege: calls 100
*** TURN *** [3s 4s Kd] [Qc]
PeyoURU: checks 
the vege: checks 
*** RIVER *** [3s 4s Kd Qc] [Jd]
PeyoURU: checks 
the vege: bets 50
PeyoURU: calls 50
*** SHOW DOWN ***
the vege: shows [7s Ac] (high card Ace)
PeyoURU: shows [7d Ah] (high card Ace)
PeyoURU collected 213 from pot
the vege collected 212 from pot
*** SUMMARY ***
Total pot 425 | Rake 0 
Board [3s 4s Kd Qc Jd]
Seat 1: Victorgd764 (small blind) folded before Flop
Seat 2: PeyoURU (big blind) showed [7d Ah] and won (213) with high card Ace
Seat 3: dfcastro.net folded before Flop (didn't bet)
Seat 4: the vege showed [7s Ac] and won (212) with high card Ace
Seat 5: giguezinho folded before Flop (didn't bet)
Seat 6: 14129088 folded before Flop (didn't bet)
Seat 7: Y_NG_X folded before Flop (didn't bet)
Seat 8: sportiano folded before Flop (didn't bet)
Seat 9: Silvaa.10 (button) folded before Flop (didn't bet)



PokerStars Hand #100386626915: Tournament #750518676, $0.23+$0.02 USD Hold'em No Limit - Level III (25/50) - 2013/06/21 20:38:03 BRT [2013/06/21 19:38:03 ET]
Table '750518676 4' 9-max Seat #1 is the button
Seat 1: Victorgd764 (3355 in chips) 
Seat 2: PeyoURU (1733 in chips) 
Seat 3: dfcastro.net (1620 in chips) 
Seat 4: the vege (1727 in chips) 
Seat 5: giguezinho (3930 in chips) 
Seat 6: 14129088 (4350 in chips) 
Seat 7: Y_NG_X (4630 in chips) 
Seat 8: sportiano (1280 in chips) 
Seat 9: Silvaa.10 (5065 in chips) 
PeyoURU: posts small blind 25
dfcastro.net: posts big blind 50
*** HOLE CARDS ***
Dealt to dfcastro.net [6c 9c]
the vege: calls 50
giguezinho: folds 
14129088: folds 
Y_NG_X: folds 
sportiano: folds 
Silvaa.10: calls 50
Victorgd764: calls 50
PeyoURU: calls 25
dfcastro.net: checks 
*** FLOP *** [Ad Jh Th]
PeyoURU: checks 
dfcastro.net: checks 
the vege: bets 50
Silvaa.10: calls 50
Victorgd764: calls 50
PeyoURU: calls 50
dfcastro.net: folds 
*** TURN *** [Ad Jh Th] [Jd]
PeyoURU: checks 
the vege: bets 50
Silvaa.10: calls 50
Victorgd764: calls 50
PeyoURU: calls 50
*** RIVER *** [Ad Jh Th Jd] [7c]
PeyoURU: checks 
the vege: checks 
Silvaa.10: checks 
Victorgd764: checks 
*** SHOW DOWN ***
PeyoURU: shows [7d 9d] (two pair, Jacks and Sevens)
the vege: mucks hand 
Silvaa.10: mucks hand 
Victorgd764: shows [7s 8s] (two pair, Jacks and Sevens)
PeyoURU collected 325 from pot
Victorgd764 collected 325 from pot
*** SUMMARY ***
Total pot 650 | Rake 0 
Board [Ad Jh Th Jd 7c]
Seat 1: Victorgd764 (button) showed [7s 8s] and won (325) with two pair, Jacks and Sevens
Seat 2: PeyoURU (small blind) showed [7d 9d] and won (325) with two pair, Jacks and Sevens
Seat 3: dfcastro.net (big blind) folded on the Flop
Seat 4: the vege mucked [Kh 2h]
Seat 5: giguezinho folded before Flop (didn't bet)
Seat 6: 14129088 folded before Flop (didn't bet)
Seat 7: Y_NG_X folded before Flop (didn't bet)
Seat 8: sportiano folded before Flop (didn't bet)
Seat 9: Silvaa.10 mucked [Kc 2c]



PokerStars Hand #100386695297: Tournament #750518676, $0.23+$0.02 USD Hold'em No Limit - Level III (25/50) - 2013/06/21 20:40:02 BRT [2013/06/21 19:40:02 ET]
Table '750518676 4' 9-max Seat #2 is the button
Seat 1: Victorgd764 (3530 in chips) 
Seat 2: PeyoURU (1908 in chips) 
Seat 3: dfcastro.net (1570 in chips) 
Seat 4: the vege (1577 in chips) 
Seat 5: giguezinho (3930 in chips) 
Seat 6: 14129088 (4350 in chips) 
Seat 7: Y_NG_X (4630 in chips) 
Seat 8: sportiano (1280 in chips) 
Seat 9: Silvaa.10 (4915 in chips) 
dfcastro.net: posts small blind 25
the vege: posts big blind 50
*** HOLE CARDS ***
Dealt to dfcastro.net [Kd 5d]
giguezinho: folds 
14129088: folds 
Y_NG_X: folds 
sportiano: folds 
Silvaa.10: raises 50 to 100
Victorgd764: folds 
PeyoURU: folds 
dfcastro.net: folds 
the vege: calls 50
*** FLOP *** [3c 3d 7c]
the vege: checks 
Silvaa.10: checks 
*** TURN *** [3c 3d 7c] [9c]
the vege: bets 50
Silvaa.10: calls 50
*** RIVER *** [3c 3d 7c 9c] [2h]
the vege: bets 50
Silvaa.10: raises 250 to 300
the vege: folds 
Uncalled bet (250) returned to Silvaa.10
Silvaa.10 collected 425 from pot
*** SUMMARY ***
Total pot 425 | Rake 0 
Board [3c 3d 7c 9c 2h]
Seat 1: Victorgd764 folded before Flop (didn't bet)
Seat 2: PeyoURU (button) folded before Flop (didn't bet)
Seat 3: dfcastro.net (small blind) folded before Flop
Seat 4: the vege (big blind) folded on the River
Seat 5: giguezinho folded before Flop (didn't bet)
Seat 6: 14129088 folded before Flop (didn't bet)
Seat 7: Y_NG_X folded before Flop (didn't bet)
Seat 8: sportiano folded before Flop (didn't bet)
Seat 9: Silvaa.10 collected (425)



PokerStars Hand #100386736220: Tournament #750518676, $0.23+$0.02 USD Hold'em No Limit - Level III (25/50) - 2013/06/21 20:41:13 BRT [2013/06/21 19:41:13 ET]
Table '750518676 4' 9-max Seat #3 is the button
Seat 1: Victorgd764 (3530 in chips) 
Seat 2: PeyoURU (1908 in chips) 
Seat 3: dfcastro.net (1545 in chips) 
Seat 4: the vege (1377 in chips) 
Seat 5: giguezinho (3930 in chips) 
Seat 6: 14129088 (4350 in chips) 
Seat 8: sportiano (1280 in chips) 
Seat 9: Silvaa.10 (5140 in chips) 
the vege: posts small blind 25
giguezinho: posts big blind 50
*** HOLE CARDS ***
Dealt to dfcastro.net [Ts 5c]
14129088: folds 
sportiano: folds 
Silvaa.10: folds 
Victorgd764: raises 50 to 100
PeyoURU: folds 
dfcastro.net: folds 
the vege: calls 75
giguezinho: folds 
*** FLOP *** [3s Tc 6h]
the vege: checks 
Victorgd764: bets 100
the vege: folds 
Uncalled bet (100) returned to Victorgd764
Victorgd764 collected 250 from pot
*** SUMMARY ***
Total pot 250 | Rake 0 
Board [3s Tc 6h]
Seat 1: Victorgd764 collected (250)
Seat 2: PeyoURU folded before Flop (didn't bet)
Seat 3: dfcastro.net (button) folded before Flop (didn't bet)
Seat 4: the vege (small blind) folded on the Flop
Seat 5: giguezinho (big blind) folded before Flop
Seat 6: 14129088 folded before Flop (didn't bet)
Seat 8: sportiano folded before Flop (didn't bet)
Seat 9: Silvaa.10 folded before Flop (didn't bet)



PokerStars Hand #100386769980: Tournament #750518676, $0.23+$0.02 USD Hold'em No Limit - Level IV (50/100) - 2013/06/21 20:42:13 BRT [2013/06/21 19:42:13 ET]
Table '750518676 4' 9-max Seat #4 is the button
Seat 1: Victorgd764 (3680 in chips) 
Seat 2: PeyoURU (1908 in chips) 
Seat 3: dfcastro.net (1545 in chips) 
Seat 4: the vege (1277 in chips) 
Seat 5: giguezinho (3880 in chips) 
Seat 6: 14129088 (4350 in chips) 
Seat 8: sportiano (1280 in chips) 
Seat 9: Silvaa.10 (5140 in chips) 
giguezinho: posts small blind 50
14129088: posts big blind 100
*** HOLE CARDS ***
Dealt to dfcastro.net [5d 2h]
sportiano: folds 
Silvaa.10: folds 
Victorgd764: raises 100 to 200
PeyoURU: folds 
dfcastro.net: folds 
the vege: folds 
giguezinho: folds 
14129088: folds 
Uncalled bet (100) returned to Victorgd764
Victorgd764 collected 250 from pot
*** SUMMARY ***
Total pot 250 | Rake 0 
Seat 1: Victorgd764 collected (250)
Seat 2: PeyoURU folded before Flop (didn't bet)
Seat 3: dfcastro.net folded before Flop (didn't bet)
Seat 4: the vege (button) folded before Flop (didn't bet)
Seat 5: giguezinho (small blind) folded before Flop
Seat 6: 14129088 (big blind) folded before Flop
Seat 8: sportiano folded before Flop (didn't bet)
Seat 9: Silvaa.10 folded before Flop (didn't bet)



PokerStars Hand #100386788381: Tournament #750518676, $0.23+$0.02 USD Hold'em No Limit - Level IV (50/100) - 2013/06/21 20:42:45 BRT [2013/06/21 19:42:45 ET]
Table '750518676 4' 9-max Seat #5 is the button
Seat 1: Victorgd764 (3830 in chips) 
Seat 2: PeyoURU (1908 in chips) 
Seat 3: dfcastro.net (1545 in chips) 
Seat 4: the vege (1277 in chips) 
Seat 5: giguezinho (3830 in chips) 
Seat 6: 14129088 (4250 in chips) 
Seat 8: sportiano (1280 in chips) 
Seat 9: Silvaa.10 (5140 in chips) 
14129088: posts small blind 50
sportiano: posts big blind 100
*** HOLE CARDS ***
Dealt to dfcastro.net [Ah Th]
Silvaa.10: folds 
Victorgd764: folds 
PeyoURU: folds 
dfcastro.net: raises 400 to 500
the vege: folds 
giguezinho: folds 
14129088: raises 3750 to 4250 and is all-in
sportiano: folds 
dfcastro.net: calls 1045 and is all-in
Uncalled bet (2705) returned to 14129088
*** FLOP *** [7c Ad Qd]
*** TURN *** [7c Ad Qd] [Qh]
*** RIVER *** [7c Ad Qd Qh] [4c]
*** SHOW DOWN ***
14129088: shows [9d 9h] (two pair, Queens and Nines)
dfcastro.net: shows [Ah Th] (two pair, Aces and Queens)
dfcastro.net collected 3190 from pot
*** SUMMARY ***
Total pot 3190 | Rake 0 
Board [7c Ad Qd Qh 4c]
Seat 1: Victorgd764 folded before Flop (didn't bet)
Seat 2: PeyoURU folded before Flop (didn't bet)
Seat 3: dfcastro.net showed [Ah Th] and won (3190) with two pair, Aces and Queens
Seat 4: the vege folded before Flop (didn't bet)
Seat 5: giguezinho (button) folded before Flop (didn't bet)
Seat 6: 14129088 (small blind) showed [9d 9h] and lost with two pair, Queens and Nines
Seat 8: sportiano (big blind) folded before Flop
Seat 9: Silvaa.10 folded before Flop (didn't bet)



PokerStars Hand #100386824919: Tournament #750518676, $0.23+$0.02 USD Hold'em No Limit - Level IV (50/100) - 2013/06/21 20:43:50 BRT [2013/06/21 19:43:50 ET]
Table '750518676 4' 9-max Seat #6 is the button
Seat 1: Victorgd764 (3830 in chips) 
Seat 2: PeyoURU (1908 in chips) 
Seat 3: dfcastro.net (3190 in chips) 
Seat 4: the vege (1277 in chips) 
Seat 5: giguezinho (3830 in chips) 
Seat 6: 14129088 (2705 in chips) 
Seat 8: sportiano (1180 in chips) 
Seat 9: Silvaa.10 (5140 in chips) 
sportiano: posts small blind 50
Silvaa.10: posts big blind 100
*** HOLE CARDS ***
Dealt to dfcastro.net [5d Tc]
Victorgd764: raises 100 to 200
PeyoURU: folds 
dfcastro.net: folds 
the vege: calls 200
giguezinho: folds 
14129088: folds 
sportiano: folds 
Silvaa.10: folds 
*** FLOP *** [4h Th 3d]
Victorgd764: bets 300
the vege: folds 
Uncalled bet (300) returned to Victorgd764
Victorgd764 collected 550 from pot
*** SUMMARY ***
Total pot 550 | Rake 0 
Board [4h Th 3d]
Seat 1: Victorgd764 collected (550)
Seat 2: PeyoURU folded before Flop (didn't bet)
Seat 3: dfcastro.net folded before Flop (didn't bet)
Seat 4: the vege folded on the Flop
Seat 5: giguezinho folded before Flop (didn't bet)
Seat 6: 14129088 (button) folded before Flop (didn't bet)
Seat 8: sportiano (small blind) folded before Flop
Seat 9: Silvaa.10 (big blind) folded before Flop



PokerStars Hand #100386851417: Tournament #750518676, $0.23+$0.02 USD Hold'em No Limit - Level IV (50/100) - 2013/06/21 20:44:37 BRT [2013/06/21 19:44:37 ET]
Table '750518676 4' 9-max Seat #8 is the button
Seat 1: Victorgd764 (4180 in chips) 
Seat 2: PeyoURU (1908 in chips) 
Seat 3: dfcastro.net (3190 in chips) 
Seat 4: the vege (1077 in chips) 
Seat 5: giguezinho (3830 in chips) 
Seat 6: 14129088 (2705 in chips) 
Seat 8: sportiano (1130 in chips) 
Seat 9: Silvaa.10 (5040 in chips) 
Silvaa.10: posts small blind 50
Victorgd764: posts big blind 100
*** HOLE CARDS ***
Dealt to dfcastro.net [4s Kc]
PeyoURU: folds 
dfcastro.net: folds 
the vege: folds 
giguezinho: folds 
14129088: folds 
sportiano: folds 
Silvaa.10: raises 100 to 200
Victorgd764: calls 100
*** FLOP *** [8d Ts 9s]
Silvaa.10: bets 300
Victorgd764: folds 
Uncalled bet (300) returned to Silvaa.10
Silvaa.10 collected 400 from pot
*** SUMMARY ***
Total pot 400 | Rake 0 
Board [8d Ts 9s]
Seat 1: Victorgd764 (big blind) folded on the Flop
Seat 2: PeyoURU folded before Flop (didn't bet)
Seat 3: dfcastro.net folded before Flop (didn't bet)
Seat 4: the vege folded before Flop (didn't bet)
Seat 5: giguezinho folded before Flop (didn't bet)
Seat 6: 14129088 folded before Flop (didn't bet)
Seat 8: sportiano (button) folded before Flop (didn't bet)
Seat 9: Silvaa.10 (small blind) collected (400)



PokerStars Hand #100386887376: Tournament #750518676, $0.23+$0.02 USD Hold'em No Limit - Level IV (50/100) - 2013/06/21 20:45:41 BRT [2013/06/21 19:45:41 ET]
Table '750518676 4' 9-max Seat #9 is the button
Seat 1: Victorgd764 (3980 in chips) 
Seat 3: dfcastro.net (3190 in chips) 
Seat 4: the vege (1077 in chips) 
Seat 5: giguezinho (3830 in chips) 
Seat 6: 14129088 (2705 in chips) 
Seat 8: sportiano (1130 in chips) 
Seat 9: Silvaa.10 (5240 in chips) 
Victorgd764: posts small blind 50
dfcastro.net: posts big blind 100
*** HOLE CARDS ***
Dealt to dfcastro.net [3c Ts]
the vege: calls 100
giguezinho: folds 
14129088: folds 
sportiano: folds 
Silvaa.10: folds 
Victorgd764: calls 50
dfcastro.net: checks 
*** FLOP *** [8c Kd As]
Victorgd764: bets 100
dfcastro.net: folds 
the vege: calls 100
*** TURN *** [8c Kd As] [6d]
Victorgd764: bets 100
the vege: calls 100
*** RIVER *** [8c Kd As 6d] [9h]
Victorgd764: bets 100
the vege: calls 100
*** SHOW DOWN ***
Victorgd764: shows [Kc 5h] (a pair of Kings)
the vege: mucks hand 
Victorgd764 collected 900 from pot
*** SUMMARY ***
Total pot 900 | Rake 0 
Board [8c Kd As 6d 9h]
Seat 1: Victorgd764 (small blind) showed [Kc 5h] and won (900) with a pair of Kings
Seat 3: dfcastro.net (big blind) folded on the Flop
Seat 4: the vege mucked [7c 8h]
Seat 5: giguezinho folded before Flop (didn't bet)
Seat 6: 14129088 folded before Flop (didn't bet)
Seat 8: sportiano folded before Flop (didn't bet)
Seat 9: Silvaa.10 (button) folded before Flop (didn't bet)



PokerStars Hand #100386914902: Tournament #750518676, $0.23+$0.02 USD Hold'em No Limit - Level IV (50/100) - 2013/06/21 20:46:30 BRT [2013/06/21 19:46:30 ET]
Table '750518676 4' 9-max Seat #1 is the button
Seat 1: Victorgd764 (4480 in chips) 
Seat 3: dfcastro.net (3090 in chips) 
Seat 4: the vege (677 in chips) 
Seat 5: giguezinho (3830 in chips) 
Seat 6: 14129088 (2705 in chips) 
Seat 8: sportiano (1130 in chips) 
Seat 9: Silvaa.10 (5240 in chips) 
dfcastro.net: posts small blind 50
the vege: posts big blind 100
*** HOLE CARDS ***
Dealt to dfcastro.net [2c 2s]
giguezinho: calls 100
14129088: folds 
sportiano: raises 1030 to 1130 and is all-in
Silvaa.10: folds 
Victorgd764: folds 
dfcastro.net: folds 
the vege: calls 577 and is all-in
giguezinho: calls 1030
*** FLOP *** [Kd Td Qd]
*** TURN *** [Kd Td Qd] [9s]
*** RIVER *** [Kd Td Qd 9s] [Js]
*** SHOW DOWN ***
giguezinho: shows [Ad 9d] (a flush, Ace high)
sportiano: shows [8d Ac] (a straight, Ten to Ace)
giguezinho collected 906 from side pot
the vege: shows [6c 7c] (a straight, Nine to King)
giguezinho collected 2081 from main pot
sportiano finished the tournament in 20th place
the vege finished the tournament in 21st place
*** SUMMARY ***
Total pot 2987 Main pot 2081. Side pot 906. | Rake 0 
Board [Kd Td Qd 9s Js]
Seat 1: Victorgd764 (button) folded before Flop (didn't bet)
Seat 3: dfcastro.net (small blind) folded before Flop
Seat 4: the vege (big blind) showed [6c 7c] and lost with a straight, Nine to King
Seat 5: giguezinho showed [Ad 9d] and won (2987) with a flush, Ace high
Seat 6: 14129088 folded before Flop (didn't bet)
Seat 8: sportiano showed [8d Ac] and lost with a straight, Ten to Ace
Seat 9: Silvaa.10 folded before Flop (didn't bet)



PokerStars Hand #100386943525: Tournament #750518676, $0.23+$0.02 USD Hold'em No Limit - Level IV (50/100) - 2013/06/21 20:47:22 BRT [2013/06/21 19:47:22 ET]
Table '750518676 4' 9-max Seat #3 is the button
Seat 1: Victorgd764 (4480 in chips) 
Seat 3: dfcastro.net (3040 in chips) 
Seat 5: giguezinho (5687 in chips) 
Seat 6: 14129088 (2705 in chips) 
Seat 9: Silvaa.10 (5240 in chips) 
giguezinho: posts small blind 50
14129088: posts big blind 100
*** HOLE CARDS ***
Dealt to dfcastro.net [Ah 2s]
Silvaa.10: folds 
Victorgd764: folds 
dfcastro.net: folds 
giguezinho: folds 
Uncalled bet (50) returned to 14129088
14129088 collected 100 from pot
*** SUMMARY ***
Total pot 100 | Rake 0 
Seat 1: Victorgd764 folded before Flop (didn't bet)
Seat 3: dfcastro.net (button) folded before Flop (didn't bet)
Seat 5: giguezinho (small blind) folded before Flop
Seat 6: 14129088 (big blind) collected (100)
Seat 9: Silvaa.10 folded before Flop (didn't bet)



PokerStars Hand #100386953618: Tournament #750518676, $0.23+$0.02 USD Hold'em No Limit - Level IV (50/100) - 2013/06/21 20:47:40 BRT [2013/06/21 19:47:40 ET]
Table '750518676 4' 9-max Seat #5 is the button
Seat 1: Victorgd764 (4480 in chips) 
Seat 3: dfcastro.net (3040 in chips) 
Seat 5: giguezinho (5637 in chips) 
Seat 6: 14129088 (2755 in chips) 
Seat 7: betopaiakan (3655 in chips) 
Seat 9: Silvaa.10 (5240 in chips) 
14129088: posts small blind 50
betopaiakan: posts big blind 100
*** HOLE CARDS ***
Dealt to dfcastro.net [8s 7h]
Silvaa.10: folds 
Victorgd764: raises 200 to 300
dfcastro.net: folds 
giguezinho: folds 
14129088: folds 
betopaiakan: calls 200
*** FLOP *** [Qh Kd 8d]
betopaiakan: checks 
Victorgd764: bets 300
betopaiakan: raises 600 to 900
Victorgd764: raises 600 to 1500
betopaiakan: calls 600
*** TURN *** [Qh Kd 8d] [9s]
betopaiakan: bets 300
Victorgd764: raises 2380 to 2680 and is all-in
betopaiakan: calls 1555 and is all-in
Uncalled bet (825) returned to Victorgd764
*** RIVER *** [Qh Kd 8d 9s] [8c]
*** SHOW DOWN ***
betopaiakan: shows [Jc Qd] (two pair, Queens and Eights)
Victorgd764: shows [As Ks] (two pair, Kings and Eights)
Victorgd764 collected 7360 from pot
*** SUMMARY ***
Total pot 7360 | Rake 0 
Board [Qh Kd 8d 9s 8c]
Seat 1: Victorgd764 showed [As Ks] and won (7360) with two pair, Kings and Eights
Seat 3: dfcastro.net folded before Flop (didn't bet)
Seat 5: giguezinho (button) folded before Flop (didn't bet)
Seat 6: 14129088 (small blind) folded before Flop
Seat 7: betopaiakan (big blind) showed [Jc Qd] and lost with two pair, Queens and Eights
Seat 9: Silvaa.10 folded before Flop (didn't bet)



PokerStars Hand #100387032011: Tournament #750518676, $0.23+$0.02 USD Hold'em No Limit - Level IV (50/100) - 2013/06/21 20:50:03 BRT [2013/06/21 19:50:03 ET]
Table '750518676 2' 9-max Seat #9 is the button
Seat 1: oklandsvag (4096 in chips) 
Seat 2: dfcastro.net (3040 in chips) 
Seat 3: Waldavd (3010 in chips) 
Seat 4: Balan.Alex06 (3516 in chips) 
Seat 5: allinkim09 (2918 in chips) 
Seat 6: chertas3 (3164 in chips) 
Seat 7: 14129088 (2705 in chips) 
Seat 8: Victorgd764 (8185 in chips) 
Seat 9: Diapchik (1231 in chips) 
oklandsvag: posts small blind 50
dfcastro.net: posts big blind 100
*** HOLE CARDS ***
Dealt to dfcastro.net [5c 4d]
Waldavd: folds 
Balan.Alex06: calls 100
allinkim09: folds 
chertas3 has timed out
chertas3: folds 
chertas3 is sitting out
14129088: folds 
Victorgd764: folds 
Diapchik: folds 
oklandsvag: raises 300 to 400
chertas3 has returned
dfcastro.net: folds 
Balan.Alex06: folds 
Uncalled bet (300) returned to oklandsvag
oklandsvag collected 300 from pot
*** SUMMARY ***
Total pot 300 | Rake 0 
Seat 1: oklandsvag (small blind) collected (300)
Seat 2: dfcastro.net (big blind) folded before Flop
Seat 3: Waldavd folded before Flop (didn't bet)
Seat 4: Balan.Alex06 folded before Flop
Seat 5: allinkim09 folded before Flop (didn't bet)
Seat 6: chertas3 folded before Flop (didn't bet)
Seat 7: 14129088 folded before Flop (didn't bet)
Seat 8: Victorgd764 folded before Flop (didn't bet)
Seat 9: Diapchik (button) folded before Flop (didn't bet)



PokerStars Hand #100387063565: Tournament #750518676, $0.23+$0.02 USD Hold'em No Limit - Level IV (50/100) - 2013/06/21 20:51:01 BRT [2013/06/21 19:51:01 ET]
Table '750518676 2' 9-max Seat #1 is the button
Seat 1: oklandsvag (4296 in chips) 
Seat 2: dfcastro.net (2940 in chips) 
Seat 3: Waldavd (3010 in chips) 
Seat 4: Balan.Alex06 (3416 in chips) 
Seat 5: allinkim09 (2918 in chips) 
Seat 6: chertas3 (3164 in chips) 
Seat 7: 14129088 (2705 in chips) 
Seat 8: Victorgd764 (8185 in chips) 
Seat 9: Diapchik (1231 in chips) 
dfcastro.net: posts small blind 50
Waldavd: posts big blind 100
*** HOLE CARDS ***
Dealt to dfcastro.net [9d 4d]
Balan.Alex06: folds 
allinkim09: folds 
chertas3: folds 
14129088: folds 
Victorgd764: folds 
Diapchik: folds 
oklandsvag: folds 
dfcastro.net: folds 
Uncalled bet (50) returned to Waldavd
Waldavd collected 100 from pot
*** SUMMARY ***
Total pot 100 | Rake 0 
Seat 1: oklandsvag (button) folded before Flop (didn't bet)
Seat 2: dfcastro.net (small blind) folded before Flop
Seat 3: Waldavd (big blind) collected (100)
Seat 4: Balan.Alex06 folded before Flop (didn't bet)
Seat 5: allinkim09 folded before Flop (didn't bet)
Seat 6: chertas3 folded before Flop (didn't bet)
Seat 7: 14129088 folded before Flop (didn't bet)
Seat 8: Victorgd764 folded before Flop (didn't bet)
Seat 9: Diapchik folded before Flop (didn't bet)



PokerStars Hand #100387080251: Tournament #750518676, $0.23+$0.02 USD Hold'em No Limit - Level IV (50/100) - 2013/06/21 20:51:32 BRT [2013/06/21 19:51:32 ET]
Table '750518676 2' 9-max Seat #2 is the button
Seat 1: oklandsvag (4296 in chips) 
Seat 2: dfcastro.net (2890 in chips) 
Seat 3: Waldavd (3060 in chips) 
Seat 4: Balan.Alex06 (3416 in chips) 
Seat 5: allinkim09 (2918 in chips) 
Seat 6: chertas3 (3164 in chips) 
Seat 7: 14129088 (2705 in chips) 
Seat 8: Victorgd764 (8185 in chips) 
Seat 9: Diapchik (1231 in chips) 
Waldavd: posts small blind 50
Balan.Alex06: posts big blind 100
*** HOLE CARDS ***
Dealt to dfcastro.net [7h 5s]
allinkim09: folds 
chertas3: folds 
14129088: folds 
Victorgd764: raises 100 to 200
Diapchik: folds 
oklandsvag: calls 200
dfcastro.net: folds 
Waldavd: folds 
Balan.Alex06: folds 
*** FLOP *** [Jc 3h Ad]
Victorgd764: checks 
oklandsvag: bets 500
Victorgd764: folds 
Uncalled bet (500) returned to oklandsvag
oklandsvag collected 550 from pot
*** SUMMARY ***
Total pot 550 | Rake 0 
Board [Jc 3h Ad]
Seat 1: oklandsvag collected (550)
Seat 2: dfcastro.net (button) folded before Flop (didn't bet)
Seat 3: Waldavd (small blind) folded before Flop
Seat 4: Balan.Alex06 (big blind) folded before Flop
Seat 5: allinkim09 folded before Flop (didn't bet)
Seat 6: chertas3 folded before Flop (didn't bet)
Seat 7: 14129088 folded before Flop (didn't bet)
Seat 8: Victorgd764 folded on the Flop
Seat 9: Diapchik folded before Flop (didn't bet)



PokerStars Hand #100387110065: Tournament #750518676, $0.23+$0.02 USD Hold'em No Limit - Level V (75/150) - 2013/06/21 20:52:28 BRT [2013/06/21 19:52:28 ET]
Table '750518676 2' 9-max Seat #3 is the button
Seat 1: oklandsvag (4646 in chips) 
Seat 2: dfcastro.net (2890 in chips) 
Seat 3: Waldavd (3010 in chips) 
Seat 4: Balan.Alex06 (3316 in chips) 
Seat 5: allinkim09 (2918 in chips) 
Seat 6: chertas3 (3164 in chips) 
Seat 7: 14129088 (2705 in chips) 
Seat 8: Victorgd764 (7985 in chips) 
Seat 9: Diapchik (1231 in chips) 
Balan.Alex06: posts small blind 75
allinkim09: posts big blind 150
*** HOLE CARDS ***
Dealt to dfcastro.net [9c 5h]
chertas3: folds 
14129088: folds 
Victorgd764: folds 
Diapchik: folds 
oklandsvag: raises 150 to 300
dfcastro.net: folds 
Waldavd: folds 
Balan.Alex06: calls 225
allinkim09: folds 
*** FLOP *** [2c Ad Ts]
Balan.Alex06: checks 
oklandsvag: checks 
*** TURN *** [2c Ad Ts] [8s]
Balan.Alex06: checks 
oklandsvag: checks 
*** RIVER *** [2c Ad Ts 8s] [Tc]
Balan.Alex06: checks 
oklandsvag: checks 
*** SHOW DOWN ***
Balan.Alex06: shows [Qs 6d] (a pair of Tens)
oklandsvag: shows [8c Js] (two pair, Tens and Eights)
oklandsvag collected 750 from pot
*** SUMMARY ***
Total pot 750 | Rake 0 
Board [2c Ad Ts 8s Tc]
Seat 1: oklandsvag showed [8c Js] and won (750) with two pair, Tens and Eights
Seat 2: dfcastro.net folded before Flop (didn't bet)
Seat 3: Waldavd (button) folded before Flop (didn't bet)
Seat 4: Balan.Alex06 (small blind) showed [Qs 6d] and lost with a pair of Tens
Seat 5: allinkim09 (big blind) folded before Flop
Seat 6: chertas3 folded before Flop (didn't bet)
Seat 7: 14129088 folded before Flop (didn't bet)
Seat 8: Victorgd764 folded before Flop (didn't bet)
Seat 9: Diapchik folded before Flop (didn't bet)



PokerStars Hand #100387132819: Tournament #750518676, $0.23+$0.02 USD Hold'em No Limit - Level V (75/150) - 2013/06/21 20:53:10 BRT [2013/06/21 19:53:10 ET]
Table '750518676 2' 9-max Seat #4 is the button
Seat 1: oklandsvag (5096 in chips) 
Seat 2: dfcastro.net (2890 in chips) 
Seat 3: Waldavd (3010 in chips) 
Seat 4: Balan.Alex06 (3016 in chips) 
Seat 5: allinkim09 (2768 in chips) 
Seat 6: chertas3 (3164 in chips) 
Seat 7: 14129088 (2705 in chips) 
Seat 8: Victorgd764 (7985 in chips) 
Seat 9: Diapchik (1231 in chips) 
allinkim09: posts small blind 75
chertas3: posts big blind 150
*** HOLE CARDS ***
Dealt to dfcastro.net [6c Kc]
14129088: folds 
Victorgd764: folds 
Diapchik: folds 
oklandsvag: raises 150 to 300
dfcastro.net: folds 
Waldavd: folds 
Balan.Alex06: folds 
allinkim09: folds 
chertas3: folds 
Uncalled bet (150) returned to oklandsvag
oklandsvag collected 375 from pot
*** SUMMARY ***
Total pot 375 | Rake 0 
Seat 1: oklandsvag collected (375)
Seat 2: dfcastro.net folded before Flop (didn't bet)
Seat 3: Waldavd folded before Flop (didn't bet)
Seat 4: Balan.Alex06 (button) folded before Flop (didn't bet)
Seat 5: allinkim09 (small blind) folded before Flop
Seat 6: chertas3 (big blind) folded before Flop
Seat 7: 14129088 folded before Flop (didn't bet)
Seat 8: Victorgd764 folded before Flop (didn't bet)
Seat 9: Diapchik folded before Flop (didn't bet)



PokerStars Hand #100387158393: Tournament #750518676, $0.23+$0.02 USD Hold'em No Limit - Level V (75/150) - 2013/06/21 20:53:57 BRT [2013/06/21 19:53:57 ET]
Table '750518676 2' 9-max Seat #5 is the button
Seat 1: oklandsvag (5321 in chips) 
Seat 2: dfcastro.net (2890 in chips) 
Seat 3: Waldavd (3010 in chips) 
Seat 4: Balan.Alex06 (3016 in chips) 
Seat 5: allinkim09 (2693 in chips) 
Seat 6: chertas3 (3014 in chips) 
Seat 7: 14129088 (2705 in chips) 
Seat 8: Victorgd764 (7985 in chips) 
Seat 9: Diapchik (1231 in chips) 
chertas3: posts small blind 75
14129088: posts big blind 150
*** HOLE CARDS ***
Dealt to dfcastro.net [9d 5c]
Victorgd764: folds 
Diapchik: raises 1081 to 1231 and is all-in
oklandsvag: folds 
dfcastro.net: folds 
Waldavd: folds 
Balan.Alex06: calls 1231
allinkim09: folds 
chertas3: folds 
14129088: folds 
*** FLOP *** [7c 3d 7s]
*** TURN *** [7c 3d 7s] [9c]
*** RIVER *** [7c 3d 7s 9c] [Kc]
*** SHOW DOWN ***
Diapchik: shows [Tc As] (a pair of Sevens)
Balan.Alex06: shows [Th Qd] (a pair of Sevens - lower kicker)
Diapchik collected 2687 from pot
*** SUMMARY ***
Total pot 2687 | Rake 0 
Board [7c 3d 7s 9c Kc]
Seat 1: oklandsvag folded before Flop (didn't bet)
Seat 2: dfcastro.net folded before Flop (didn't bet)
Seat 3: Waldavd folded before Flop (didn't bet)
Seat 4: Balan.Alex06 showed [Th Qd] and lost with a pair of Sevens
Seat 5: allinkim09 (button) folded before Flop (didn't bet)
Seat 6: chertas3 (small blind) folded before Flop
Seat 7: 14129088 (big blind) folded before Flop
Seat 8: Victorgd764 folded before Flop (didn't bet)
Seat 9: Diapchik showed [Tc As] and won (2687) with a pair of Sevens



PokerStars Hand #100387179317: Tournament #750518676, $0.23+$0.02 USD Hold'em No Limit - Level V (75/150) - 2013/06/21 20:54:36 BRT [2013/06/21 19:54:36 ET]
Table '750518676 2' 9-max Seat #6 is the button
Seat 1: oklandsvag (5321 in chips) 
Seat 2: dfcastro.net (2890 in chips) 
Seat 3: Waldavd (3010 in chips) 
Seat 4: Balan.Alex06 (1785 in chips) 
Seat 5: allinkim09 (2693 in chips) 
Seat 6: chertas3 (2939 in chips) 
Seat 7: 14129088 (2555 in chips) 
Seat 8: Victorgd764 (7985 in chips) 
Seat 9: Diapchik (2687 in chips) 
14129088: posts small blind 75
Victorgd764: posts big blind 150
*** HOLE CARDS ***
Dealt to dfcastro.net [Kd Td]
Diapchik: folds 
oklandsvag: folds 
oklandsvag is sitting out
dfcastro.net: folds 
Waldavd: folds 
Balan.Alex06: raises 300 to 450
allinkim09: folds 
chertas3: folds 
14129088: folds 
Victorgd764: folds 
Uncalled bet (300) returned to Balan.Alex06
Balan.Alex06 collected 375 from pot
Balan.Alex06: doesn't show hand 
*** SUMMARY ***
Total pot 375 | Rake 0 
Seat 1: oklandsvag folded before Flop (didn't bet)
Seat 2: dfcastro.net folded before Flop (didn't bet)
Seat 3: Waldavd folded before Flop (didn't bet)
Seat 4: Balan.Alex06 collected (375)
Seat 5: allinkim09 folded before Flop (didn't bet)
Seat 6: chertas3 (button) folded before Flop (didn't bet)
Seat 7: 14129088 (small blind) folded before Flop
Seat 8: Victorgd764 (big blind) folded before Flop
Seat 9: Diapchik folded before Flop (didn't bet)



PokerStars Hand #100387336419: Tournament #750518676, $0.23+$0.02 USD Hold'em No Limit - Level V (75/150) - 2013/06/21 21:00:41 BRT [2013/06/21 20:00:41 ET]
Table '750518676 2' 9-max Seat #7 is the button
Seat 1: oklandsvag (5321 in chips) is sitting out
Seat 2: dfcastro.net (2890 in chips) 
Seat 3: Waldavd (3010 in chips) 
Seat 4: Balan.Alex06 (2010 in chips) 
Seat 5: allinkim09 (2693 in chips) 
Seat 6: chertas3 (2939 in chips) 
Seat 7: 14129088 (2480 in chips) 
Seat 8: Victorgd764 (7835 in chips) 
Seat 9: Diapchik (2687 in chips) 
Victorgd764: posts small blind 75
Diapchik: posts big blind 150
*** HOLE CARDS ***
Dealt to dfcastro.net [4d Ts]
oklandsvag: folds 
dfcastro.net: folds 
Waldavd: folds 
Balan.Alex06: folds 
allinkim09 has timed out
allinkim09: folds 
allinkim09 is sitting out
chertas3: folds 
14129088: raises 150 to 300
Victorgd764: folds 
Diapchik: folds 
Uncalled bet (150) returned to 14129088
14129088 collected 375 from pot
14129088: doesn't show hand 
*** SUMMARY ***
Total pot 375 | Rake 0 
Seat 1: oklandsvag folded before Flop (didn't bet)
Seat 2: dfcastro.net folded before Flop (didn't bet)
Seat 3: Waldavd folded before Flop (didn't bet)
Seat 4: Balan.Alex06 folded before Flop (didn't bet)
Seat 5: allinkim09 folded before Flop (didn't bet)
Seat 6: chertas3 folded before Flop (didn't bet)
Seat 7: 14129088 (button) collected (375)
Seat 8: Victorgd764 (small blind) folded before Flop
Seat 9: Diapchik (big blind) folded before Flop



PokerStars Hand #100387359574: Tournament #750518676, $0.23+$0.02 USD Hold'em No Limit - Level V (75/150) - 2013/06/21 21:01:28 BRT [2013/06/21 20:01:28 ET]
Table '750518676 2' 9-max Seat #8 is the button
Seat 1: oklandsvag (5321 in chips) is sitting out
Seat 2: dfcastro.net (2890 in chips) 
Seat 3: Waldavd (3010 in chips) 
Seat 4: Balan.Alex06 (2010 in chips) 
Seat 5: allinkim09 (2693 in chips) is sitting out
Seat 6: chertas3 (2939 in chips) 
Seat 7: 14129088 (2705 in chips) 
Seat 8: Victorgd764 (7760 in chips) 
Seat 9: Diapchik (2537 in chips) 
Diapchik: posts small blind 75
oklandsvag: posts big blind 150
*** HOLE CARDS ***
Dealt to dfcastro.net [2h 4c]
allinkim09 has returned
dfcastro.net: folds 
Waldavd: folds 
Balan.Alex06: folds 
allinkim09: folds 
chertas3: folds 
14129088: folds 
Victorgd764: raises 300 to 450
Diapchik: folds 
oklandsvag: folds 
Uncalled bet (300) returned to Victorgd764
Victorgd764 collected 375 from pot
*** SUMMARY ***
Total pot 375 | Rake 0 
Seat 1: oklandsvag (big blind) folded before Flop
Seat 2: dfcastro.net folded before Flop (didn't bet)
Seat 3: Waldavd folded before Flop (didn't bet)
Seat 4: Balan.Alex06 folded before Flop (didn't bet)
Seat 5: allinkim09 folded before Flop (didn't bet)
Seat 6: chertas3 folded before Flop (didn't bet)
Seat 7: 14129088 folded before Flop (didn't bet)
Seat 8: Victorgd764 (button) collected (375)
Seat 9: Diapchik (small blind) folded before Flop



PokerStars Hand #100387382790: Tournament #750518676, $0.23+$0.02 USD Hold'em No Limit - Level V (75/150) - 2013/06/21 21:02:09 BRT [2013/06/21 20:02:09 ET]
Table '750518676 2' 9-max Seat #9 is the button
Seat 1: oklandsvag (5171 in chips) is sitting out
Seat 2: dfcastro.net (2890 in chips) 
Seat 3: Waldavd (3010 in chips) 
Seat 4: Balan.Alex06 (2010 in chips) 
Seat 5: allinkim09 (2693 in chips) 
Seat 6: chertas3 (2939 in chips) 
Seat 7: 14129088 (2705 in chips) 
Seat 8: Victorgd764 (7985 in chips) 
Seat 9: Diapchik (2462 in chips) 
oklandsvag: posts small blind 75
dfcastro.net: posts big blind 150
*** HOLE CARDS ***
Dealt to dfcastro.net [4h Qs]
Waldavd: folds 
Balan.Alex06: raises 150 to 300
allinkim09: folds 
chertas3: folds 
14129088: folds 
Victorgd764: folds 
Diapchik: folds 
oklandsvag: folds 
dfcastro.net: folds 
Uncalled bet (150) returned to Balan.Alex06
Balan.Alex06 collected 375 from pot
*** SUMMARY ***
Total pot 375 | Rake 0 
Seat 1: oklandsvag (small blind) folded before Flop
Seat 2: dfcastro.net (big blind) folded before Flop
Seat 3: Waldavd folded before Flop (didn't bet)
Seat 4: Balan.Alex06 collected (375)
Seat 5: allinkim09 folded before Flop (didn't bet)
Seat 6: chertas3 folded before Flop (didn't bet)
Seat 7: 14129088 folded before Flop (didn't bet)
Seat 8: Victorgd764 folded before Flop (didn't bet)
Seat 9: Diapchik (button) folded before Flop (didn't bet)



PokerStars Hand #100387407933: Tournament #750518676, $0.23+$0.02 USD Hold'em No Limit - Level V (75/150) - 2013/06/21 21:02:55 BRT [2013/06/21 20:02:55 ET]
Table '750518676 2' 9-max Seat #1 is the button
Seat 1: oklandsvag (5096 in chips) is sitting out
Seat 2: dfcastro.net (2740 in chips) 
Seat 3: Waldavd (3010 in chips) 
Seat 4: Balan.Alex06 (2235 in chips) 
Seat 5: allinkim09 (2693 in chips) 
Seat 6: chertas3 (2939 in chips) 
Seat 7: 14129088 (2705 in chips) 
Seat 8: Victorgd764 (7985 in chips) 
Seat 9: Diapchik (2462 in chips) 
dfcastro.net: posts small blind 75
Waldavd: posts big blind 150
*** HOLE CARDS ***
Dealt to dfcastro.net [9h Jc]
Balan.Alex06: folds 
allinkim09: folds 
chertas3: folds 
14129088: folds 
Victorgd764: raises 150 to 300
Diapchik: raises 2162 to 2462 and is all-in
oklandsvag: folds 
dfcastro.net: folds 
Waldavd: folds 
Victorgd764: folds 
Uncalled bet (2162) returned to Diapchik
Diapchik collected 825 from pot
*** SUMMARY ***
Total pot 825 | Rake 0 
Seat 1: oklandsvag (button) folded before Flop (didn't bet)
Seat 2: dfcastro.net (small blind) folded before Flop
Seat 3: Waldavd (big blind) folded before Flop
Seat 4: Balan.Alex06 folded before Flop (didn't bet)
Seat 5: allinkim09 folded before Flop (didn't bet)
Seat 6: chertas3 folded before Flop (didn't bet)
Seat 7: 14129088 folded before Flop (didn't bet)
Seat 8: Victorgd764 folded before Flop
Seat 9: Diapchik collected (825)



PokerStars Hand #100387429208: Tournament #750518676, $0.23+$0.02 USD Hold'em No Limit - Level V (75/150) - 2013/06/21 21:03:34 BRT [2013/06/21 20:03:34 ET]
Table '750518676 2' 9-max Seat #2 is the button
Seat 1: oklandsvag (5096 in chips) is sitting out
Seat 2: dfcastro.net (2665 in chips) 
Seat 3: Waldavd (2860 in chips) 
Seat 4: Balan.Alex06 (2235 in chips) 
Seat 5: allinkim09 (2693 in chips) 
Seat 6: chertas3 (2939 in chips) 
Seat 7: 14129088 (2705 in chips) 
Seat 8: Victorgd764 (7685 in chips) 
Seat 9: Diapchik (2987 in chips) 
Waldavd: posts small blind 75
Balan.Alex06: posts big blind 150
*** HOLE CARDS ***
Dealt to dfcastro.net [2s 8h]
allinkim09: folds 
chertas3: folds 
oklandsvag has returned
14129088: folds 
Victorgd764: folds 
Diapchik: raises 150 to 300
oklandsvag: calls 300
dfcastro.net: folds 
Waldavd: folds 
Balan.Alex06: calls 150
*** FLOP *** [2c Td 9s]
Balan.Alex06: checks 
Diapchik: checks 
oklandsvag: bets 1050
Balan.Alex06: folds 
Diapchik: folds 
Uncalled bet (1050) returned to oklandsvag
oklandsvag collected 975 from pot
oklandsvag: doesn't show hand 
*** SUMMARY ***
Total pot 975 | Rake 0 
Board [2c Td 9s]
Seat 1: oklandsvag collected (975)
Seat 2: dfcastro.net (button) folded before Flop (didn't bet)
Seat 3: Waldavd (small blind) folded before Flop
Seat 4: Balan.Alex06 (big blind) folded on the Flop
Seat 5: allinkim09 folded before Flop (didn't bet)
Seat 6: chertas3 folded before Flop (didn't bet)
Seat 7: 14129088 folded before Flop (didn't bet)
Seat 8: Victorgd764 folded before Flop (didn't bet)
Seat 9: Diapchik folded on the Flop



PokerStars Hand #100387470722: Tournament #750518676, $0.23+$0.02 USD Hold'em No Limit - Level V (75/150) - 2013/06/21 21:04:48 BRT [2013/06/21 20:04:48 ET]
Table '750518676 2' 9-max Seat #3 is the button
Seat 1: oklandsvag (5771 in chips) 
Seat 2: dfcastro.net (2665 in chips) 
Seat 3: Waldavd (2785 in chips) 
Seat 4: Balan.Alex06 (1935 in chips) 
Seat 5: allinkim09 (2693 in chips) 
Seat 6: chertas3 (2939 in chips) 
Seat 7: 14129088 (2705 in chips) 
Seat 8: Victorgd764 (7685 in chips) 
Seat 9: Diapchik (2687 in chips) 
Balan.Alex06: posts small blind 75
allinkim09: posts big blind 150
*** HOLE CARDS ***
Dealt to dfcastro.net [Kd 5s]
chertas3: folds 
14129088: calls 150
Victorgd764: folds 
Diapchik: folds 
oklandsvag: calls 150
dfcastro.net: folds 
Waldavd: folds 
Balan.Alex06: folds 
allinkim09: checks 
*** FLOP *** [Kc 5c 6d]
allinkim09: checks 
14129088: bets 300
oklandsvag: calls 300
allinkim09: folds 
*** TURN *** [Kc 5c 6d] [4s]
14129088: bets 900
oklandsvag: calls 900
*** RIVER *** [Kc 5c 6d 4s] [Qc]
14129088: bets 1355 and is all-in
oklandsvag: folds 
Uncalled bet (1355) returned to 14129088
14129088 collected 2925 from pot
14129088: doesn't show hand 
*** SUMMARY ***
Total pot 2925 | Rake 0 
Board [Kc 5c 6d 4s Qc]
Seat 1: oklandsvag folded on the River
Seat 2: dfcastro.net folded before Flop (didn't bet)
Seat 3: Waldavd (button) folded before Flop (didn't bet)
Seat 4: Balan.Alex06 (small blind) folded before Flop
Seat 5: allinkim09 (big blind) folded on the Flop
Seat 6: chertas3 folded before Flop (didn't bet)
Seat 7: 14129088 collected (2925)
Seat 8: Victorgd764 folded before Flop (didn't bet)
Seat 9: Diapchik folded before Flop (didn't bet)



PokerStars Hand #100387501730: Tournament #750518676, $0.23+$0.02 USD Hold'em No Limit - Level V (75/150) - 2013/06/21 21:05:43 BRT [2013/06/21 20:05:43 ET]
Table '750518676 2' 9-max Seat #4 is the button
Seat 1: oklandsvag (4421 in chips) 
Seat 2: dfcastro.net (2665 in chips) 
Seat 3: Waldavd (2785 in chips) 
Seat 4: Balan.Alex06 (1860 in chips) 
Seat 5: allinkim09 (2543 in chips) 
Seat 6: chertas3 (2939 in chips) 
Seat 7: 14129088 (4280 in chips) 
Seat 8: Victorgd764 (7685 in chips) 
Seat 9: Diapchik (2687 in chips) 
allinkim09: posts small blind 75
chertas3: posts big blind 150
*** HOLE CARDS ***
Dealt to dfcastro.net [2h 5c]
14129088: folds 
Victorgd764: folds 
Diapchik: folds 
oklandsvag: raises 600 to 750
dfcastro.net: folds 
Waldavd: folds 
Balan.Alex06: folds 
allinkim09: folds 
chertas3: folds 
Uncalled bet (600) returned to oklandsvag
oklandsvag collected 375 from pot
*** SUMMARY ***
Total pot 375 | Rake 0 
Seat 1: oklandsvag collected (375)
Seat 2: dfcastro.net folded before Flop (didn't bet)
Seat 3: Waldavd folded before Flop (didn't bet)
Seat 4: Balan.Alex06 (button) folded before Flop (didn't bet)
Seat 5: allinkim09 (small blind) folded before Flop
Seat 6: chertas3 (big blind) folded before Flop
Seat 7: 14129088 folded before Flop (didn't bet)
Seat 8: Victorgd764 folded before Flop (didn't bet)
Seat 9: Diapchik folded before Flop (didn't bet)



PokerStars Hand #100387523561: Tournament #750518676, $0.23+$0.02 USD Hold'em No Limit - Level V (75/150) - 2013/06/21 21:06:22 BRT [2013/06/21 20:06:22 ET]
Table '750518676 2' 9-max Seat #5 is the button
Seat 1: oklandsvag (4646 in chips) 
Seat 2: dfcastro.net (2665 in chips) 
Seat 3: Waldavd (2785 in chips) 
Seat 4: Balan.Alex06 (1860 in chips) 
Seat 5: allinkim09 (2468 in chips) 
Seat 6: chertas3 (2789 in chips) 
Seat 7: 14129088 (4280 in chips) 
Seat 8: Victorgd764 (7685 in chips) 
Seat 9: Diapchik (2687 in chips) 
chertas3: posts small blind 75
14129088: posts big blind 150
*** HOLE CARDS ***
Dealt to dfcastro.net [Ts 8d]
Victorgd764: folds 
Diapchik: folds 
oklandsvag: folds 
dfcastro.net: folds 
Waldavd: folds 
Balan.Alex06: calls 150
allinkim09: folds 
chertas3: folds 
14129088: checks 
*** FLOP *** [2d Ks Qh]
14129088: checks 
Balan.Alex06: checks 
*** TURN *** [2d Ks Qh] [2h]
14129088: checks 
Balan.Alex06: checks 
*** RIVER *** [2d Ks Qh 2h] [Jh]
14129088: checks 
Balan.Alex06: checks 
*** SHOW DOWN ***
14129088: shows [7h 9s] (a pair of Deuces)
Balan.Alex06: shows [Ac 7d] (a pair of Deuces - Ace kicker)
Balan.Alex06 collected 375 from pot
*** SUMMARY ***
Total pot 375 | Rake 0 
Board [2d Ks Qh 2h Jh]
Seat 1: oklandsvag folded before Flop (didn't bet)
Seat 2: dfcastro.net folded before Flop (didn't bet)
Seat 3: Waldavd folded before Flop (didn't bet)
Seat 4: Balan.Alex06 showed [Ac 7d] and won (375) with a pair of Deuces
Seat 5: allinkim09 (button) folded before Flop (didn't bet)
Seat 6: chertas3 (small blind) folded before Flop
Seat 7: 14129088 (big blind) showed [7h 9s] and lost with a pair of Deuces
Seat 8: Victorgd764 folded before Flop (didn't bet)
Seat 9: Diapchik folded before Flop (didn't bet)



PokerStars Hand #100387549265: Tournament #750518676, $0.23+$0.02 USD Hold'em No Limit - Level V (75/150) - 2013/06/21 21:07:08 BRT [2013/06/21 20:07:08 ET]
Table '750518676 2' 9-max Seat #6 is the button
Seat 2: dfcastro.net (2665 in chips) 
Seat 3: Waldavd (2785 in chips) 
Seat 4: Balan.Alex06 (2085 in chips) 
Seat 5: allinkim09 (2468 in chips) 
Seat 6: chertas3 (2714 in chips) 
Seat 7: 14129088 (4130 in chips) 
Seat 8: Victorgd764 (7685 in chips) 
Seat 9: Diapchik (2687 in chips) 
14129088: posts small blind 75
Victorgd764: posts big blind 150
*** HOLE CARDS ***
Dealt to dfcastro.net [9s Kh]
Diapchik: raises 165 to 315
dfcastro.net: folds 
Waldavd: folds 
Balan.Alex06: folds 
allinkim09: folds 
chertas3: folds 
14129088: folds 
Victorgd764: folds 
Uncalled bet (165) returned to Diapchik
Diapchik collected 375 from pot
*** SUMMARY ***
Total pot 375 | Rake 0 
Seat 2: dfcastro.net folded before Flop (didn't bet)
Seat 3: Waldavd folded before Flop (didn't bet)
Seat 4: Balan.Alex06 folded before Flop (didn't bet)
Seat 5: allinkim09 folded before Flop (didn't bet)
Seat 6: chertas3 (button) folded before Flop (didn't bet)
Seat 7: 14129088 (small blind) folded before Flop
Seat 8: Victorgd764 (big blind) folded before Flop
Seat 9: Diapchik collected (375)



PokerStars Hand #100387572363: Tournament #750518676, $0.23+$0.02 USD Hold'em No Limit - Level VI (100/200) - 2013/06/21 21:07:50 BRT [2013/06/21 20:07:50 ET]
Table '750518676 2' 9-max Seat #7 is the button
Seat 2: dfcastro.net (2665 in chips) 
Seat 3: Waldavd (2785 in chips) 
Seat 4: Balan.Alex06 (2085 in chips) 
Seat 5: allinkim09 (2468 in chips) 
Seat 6: chertas3 (2714 in chips) 
Seat 7: 14129088 (4055 in chips) 
Seat 8: Victorgd764 (7535 in chips) 
Seat 9: Diapchik (2912 in chips) 
Victorgd764: posts small blind 100
Diapchik: posts big blind 200
*** HOLE CARDS ***
Dealt to dfcastro.net [2h Kd]
dfcastro.net: folds 
Waldavd: folds 
Balan.Alex06: folds 
allinkim09: raises 2268 to 2468 and is all-in
chertas3: folds 
14129088: folds 
Victorgd764: folds 
Diapchik: folds 
Uncalled bet (2268) returned to allinkim09
allinkim09 collected 500 from pot
allinkim09: doesn't show hand 
*** SUMMARY ***
Total pot 500 | Rake 0 
Seat 2: dfcastro.net folded before Flop (didn't bet)
Seat 3: Waldavd folded before Flop (didn't bet)
Seat 4: Balan.Alex06 folded before Flop (didn't bet)
Seat 5: allinkim09 collected (500)
Seat 6: chertas3 folded before Flop (didn't bet)
Seat 7: 14129088 (button) folded before Flop (didn't bet)
Seat 8: Victorgd764 (small blind) folded before Flop
Seat 9: Diapchik (big blind) folded before Flop



PokerStars Hand #100387590616: Tournament #750518676, $0.23+$0.02 USD Hold'em No Limit - Level VI (100/200) - 2013/06/21 21:08:23 BRT [2013/06/21 20:08:23 ET]
Table '750518676 2' 9-max Seat #8 is the button
Seat 2: dfcastro.net (2665 in chips) 
Seat 3: Waldavd (2785 in chips) 
Seat 4: Balan.Alex06 (2085 in chips) 
Seat 5: allinkim09 (2768 in chips) 
Seat 6: chertas3 (2714 in chips) 
Seat 7: 14129088 (4055 in chips) 
Seat 8: Victorgd764 (7435 in chips) 
Seat 9: Diapchik (2712 in chips) 
Diapchik: posts small blind 100
dfcastro.net: posts big blind 200
*** HOLE CARDS ***
Dealt to dfcastro.net [7c Ah]
Waldavd: calls 200
Balan.Alex06: raises 600 to 800
allinkim09 has timed out
allinkim09: folds 
allinkim09 is sitting out
chertas3: folds 
allinkim09 has returned
14129088: folds 
Victorgd764: folds 
Diapchik: folds 
dfcastro.net: folds 
Waldavd: calls 600
*** FLOP *** [4h 3h Th]
Waldavd: checks 
Balan.Alex06: bets 1285 and is all-in
Waldavd: folds 
Uncalled bet (1285) returned to Balan.Alex06
Balan.Alex06 collected 1900 from pot
Balan.Alex06: shows [4s 4c] (three of a kind, Fours)
*** SUMMARY ***
Total pot 1900 | Rake 0 
Board [4h 3h Th]
Seat 2: dfcastro.net (big blind) folded before Flop
Seat 3: Waldavd folded on the Flop
Seat 4: Balan.Alex06 collected (1900)
Seat 5: allinkim09 folded before Flop (didn't bet)
Seat 6: chertas3 folded before Flop (didn't bet)
Seat 7: 14129088 folded before Flop (didn't bet)
Seat 8: Victorgd764 (button) folded before Flop (didn't bet)
Seat 9: Diapchik (small blind) folded before Flop



PokerStars Hand #100387627554: Tournament #750518676, $0.23+$0.02 USD Hold'em No Limit - Level VI (100/200) - 2013/06/21 21:09:30 BRT [2013/06/21 20:09:30 ET]
Table '750518676 2' 9-max Seat #9 is the button
Seat 2: dfcastro.net (2465 in chips) 
Seat 3: Waldavd (1985 in chips) 
Seat 4: Balan.Alex06 (3185 in chips) 
Seat 5: allinkim09 (2768 in chips) 
Seat 6: chertas3 (2714 in chips) 
Seat 7: 14129088 (4055 in chips) 
Seat 8: Victorgd764 (7435 in chips) 
Seat 9: Diapchik (2612 in chips) 
dfcastro.net: posts small blind 100
Waldavd: posts big blind 200
*** HOLE CARDS ***
Dealt to dfcastro.net [7d Jc]
Balan.Alex06: calls 200
allinkim09: raises 2568 to 2768 and is all-in
chertas3: folds 
14129088: folds 
Victorgd764: folds 
Diapchik: folds 
dfcastro.net: folds 
Waldavd: folds 
Balan.Alex06: calls 2568
*** FLOP *** [Qc 3s 4h]
*** TURN *** [Qc 3s 4h] [7h]
*** RIVER *** [Qc 3s 4h 7h] [2c]
*** SHOW DOWN ***
Balan.Alex06: shows [Ad 9c] (high card Ace)
allinkim09: shows [Qh Ah] (a pair of Queens)
allinkim09 collected 5836 from pot
*** SUMMARY ***
Total pot 5836 | Rake 0 
Board [Qc 3s 4h 7h 2c]
Seat 2: dfcastro.net (small blind) folded before Flop
Seat 3: Waldavd (big blind) folded before Flop
Seat 4: Balan.Alex06 showed [Ad 9c] and lost with high card Ace
Seat 5: allinkim09 showed [Qh Ah] and won (5836) with a pair of Queens
Seat 6: chertas3 folded before Flop (didn't bet)
Seat 7: 14129088 folded before Flop (didn't bet)
Seat 8: Victorgd764 folded before Flop (didn't bet)
Seat 9: Diapchik (button) folded before Flop (didn't bet)



PokerStars Hand #100387655096: Tournament #750518676, $0.23+$0.02 USD Hold'em No Limit - Level VI (100/200) - 2013/06/21 21:10:21 BRT [2013/06/21 20:10:21 ET]
Table '750518676 2' 9-max Seat #2 is the button
Seat 2: dfcastro.net (2365 in chips) 
Seat 3: Waldavd (1785 in chips) 
Seat 4: Balan.Alex06 (417 in chips) 
Seat 5: allinkim09 (5836 in chips) 
Seat 6: chertas3 (2714 in chips) 
Seat 7: 14129088 (4055 in chips) 
Seat 8: Victorgd764 (7435 in chips) 
Seat 9: Diapchik (2612 in chips) 
Waldavd: posts small blind 100
Balan.Alex06: posts big blind 200
*** HOLE CARDS ***
Dealt to dfcastro.net [Kd 4c]
allinkim09: folds 
chertas3: folds 
14129088: folds 
Victorgd764: raises 350 to 550
Diapchik: folds 
dfcastro.net: folds 
Waldavd: folds 
Balan.Alex06: calls 217 and is all-in
Uncalled bet (133) returned to Victorgd764
*** FLOP *** [Ah 5h Qd]
*** TURN *** [Ah 5h Qd] [Ks]
*** RIVER *** [Ah 5h Qd Ks] [6h]
*** SHOW DOWN ***
Balan.Alex06: shows [4s 4d] (a pair of Fours)
Victorgd764: shows [Th Ts] (a pair of Tens)
Victorgd764 collected 934 from pot
Balan.Alex06 finished the tournament in 16th place
*** SUMMARY ***
Total pot 934 | Rake 0 
Board [Ah 5h Qd Ks 6h]
Seat 2: dfcastro.net (button) folded before Flop (didn't bet)
Seat 3: Waldavd (small blind) folded before Flop
Seat 4: Balan.Alex06 (big blind) showed [4s 4d] and lost with a pair of Fours
Seat 5: allinkim09 folded before Flop (didn't bet)
Seat 6: chertas3 folded before Flop (didn't bet)
Seat 7: 14129088 folded before Flop (didn't bet)
Seat 8: Victorgd764 showed [Th Ts] and won (934) with a pair of Tens
Seat 9: Diapchik folded before Flop (didn't bet)



PokerStars Hand #100387678652: Tournament #750518676, $0.23+$0.02 USD Hold'em No Limit - Level VI (100/200) - 2013/06/21 21:11:04 BRT [2013/06/21 20:11:04 ET]
Table '750518676 2' 9-max Seat #3 is the button
Seat 2: dfcastro.net (2365 in chips) 
Seat 3: Waldavd (1685 in chips) 
Seat 5: allinkim09 (5836 in chips) 
Seat 6: chertas3 (2714 in chips) 
Seat 7: 14129088 (4055 in chips) 
Seat 8: Victorgd764 (7952 in chips) 
Seat 9: Diapchik (2612 in chips) 
allinkim09: posts small blind 100
chertas3: posts big blind 200
*** HOLE CARDS ***
Dealt to dfcastro.net [4s 4d]
14129088: folds 
Victorgd764: folds 
Diapchik: raises 220 to 420
dfcastro.net: calls 420
Waldavd: calls 420
allinkim09: folds 
chertas3: folds 
*** FLOP *** [2d 2c 4c]
Diapchik: checks 
dfcastro.net: bets 1600
Waldavd: folds 
Diapchik: folds 
Uncalled bet (1600) returned to dfcastro.net
dfcastro.net collected 1560 from pot
dfcastro.net: doesn't show hand 
*** SUMMARY ***
Total pot 1560 | Rake 0 
Board [2d 2c 4c]
Seat 2: dfcastro.net collected (1560)
Seat 3: Waldavd (button) folded on the Flop
Seat 5: allinkim09 (small blind) folded before Flop
Seat 6: chertas3 (big blind) folded before Flop
Seat 7: 14129088 folded before Flop (didn't bet)
Seat 8: Victorgd764 folded before Flop (didn't bet)
Seat 9: Diapchik folded on the Flop



PokerStars Hand #100387708318: Tournament #750518676, $0.23+$0.02 USD Hold'em No Limit - Level VI (100/200) - 2013/06/21 21:12:00 BRT [2013/06/21 20:12:00 ET]
Table '750518676 2' 9-max Seat #5 is the button
Seat 2: dfcastro.net (3505 in chips) 
Seat 3: Waldavd (1265 in chips) 
Seat 5: allinkim09 (5736 in chips) 
Seat 6: chertas3 (2514 in chips) 
Seat 7: 14129088 (4055 in chips) 
Seat 8: Victorgd764 (7952 in chips) 
Seat 9: Diapchik (2192 in chips) 
chertas3: posts small blind 100
14129088: posts big blind 200
*** HOLE CARDS ***
Dealt to dfcastro.net [Th Kd]
Victorgd764: folds 
Diapchik: folds 
dfcastro.net: folds 
Waldavd: folds 
allinkim09: folds 
chertas3: folds 
Uncalled bet (100) returned to 14129088
14129088 collected 200 from pot
14129088: doesn't show hand 
*** SUMMARY ***
Total pot 200 | Rake 0 
Seat 2: dfcastro.net folded before Flop (didn't bet)
Seat 3: Waldavd folded before Flop (didn't bet)
Seat 5: allinkim09 (button) folded before Flop (didn't bet)
Seat 6: chertas3 (small blind) folded before Flop
Seat 7: 14129088 (big blind) collected (200)
Seat 8: Victorgd764 folded before Flop (didn't bet)
Seat 9: Diapchik folded before Flop (didn't bet)



PokerStars Hand #100387718732: Tournament #750518676, $0.23+$0.02 USD Hold'em No Limit - Level VI (100/200) - 2013/06/21 21:12:19 BRT [2013/06/21 20:12:19 ET]
Table '750518676 2' 9-max Seat #6 is the button
Seat 2: dfcastro.net (3505 in chips) 
Seat 3: Waldavd (1265 in chips) 
Seat 5: allinkim09 (5736 in chips) 
Seat 6: chertas3 (2414 in chips) 
Seat 7: 14129088 (4155 in chips) 
Seat 8: Victorgd764 (7952 in chips) 
Seat 9: Diapchik (2192 in chips) 
14129088: posts small blind 100
Victorgd764: posts big blind 200
*** HOLE CARDS ***
Dealt to dfcastro.net [As 2c]
Diapchik: folds 
dfcastro.net: folds 
Waldavd: folds 
allinkim09: folds 
chertas3: folds 
14129088: folds 
Uncalled bet (100) returned to Victorgd764
Victorgd764 collected 200 from pot
*** SUMMARY ***
Total pot 200 | Rake 0 
Seat 2: dfcastro.net folded before Flop (didn't bet)
Seat 3: Waldavd folded before Flop (didn't bet)
Seat 5: allinkim09 folded before Flop (didn't bet)
Seat 6: chertas3 (button) folded before Flop (didn't bet)
Seat 7: 14129088 (small blind) folded before Flop
Seat 8: Victorgd764 (big blind) collected (200)
Seat 9: Diapchik folded before Flop (didn't bet)



PokerStars Hand #100387727638: Tournament #750518676, $0.23+$0.02 USD Hold'em No Limit - Level VI (100/200) - 2013/06/21 21:12:36 BRT [2013/06/21 20:12:36 ET]
Table '750518676 2' 9-max Seat #7 is the button
Seat 2: dfcastro.net (3505 in chips) 
Seat 3: Waldavd (1265 in chips) 
Seat 5: allinkim09 (5736 in chips) 
Seat 6: chertas3 (2414 in chips) 
Seat 7: 14129088 (4055 in chips) 
Seat 8: Victorgd764 (8052 in chips) 
Seat 9: Diapchik (2192 in chips) 
Victorgd764: posts small blind 100
Diapchik: posts big blind 200
*** HOLE CARDS ***
Dealt to dfcastro.net [5d 6s]
dfcastro.net: folds 
Waldavd: folds 
allinkim09: folds 
chertas3: folds 
14129088: raises 200 to 400
Victorgd764: folds 
Diapchik: folds 
Uncalled bet (200) returned to 14129088
14129088 collected 500 from pot
14129088: doesn't show hand 
*** SUMMARY ***
Total pot 500 | Rake 0 
Seat 2: dfcastro.net folded before Flop (didn't bet)
Seat 3: Waldavd folded before Flop (didn't bet)
Seat 5: allinkim09 folded before Flop (didn't bet)
Seat 6: chertas3 folded before Flop (didn't bet)
Seat 7: 14129088 (button) collected (500)
Seat 8: Victorgd764 (small blind) folded before Flop
Seat 9: Diapchik (big blind) folded before Flop



PokerStars Hand #100387752268: Tournament #750518676, $0.23+$0.02 USD Hold'em No Limit - Level VI (100/200) - 2013/06/21 21:13:22 BRT [2013/06/21 20:13:22 ET]
Table '750518676 2' 9-max Seat #8 is the button
Seat 2: dfcastro.net (3505 in chips) 
Seat 3: Waldavd (1265 in chips) 
Seat 5: allinkim09 (5736 in chips) 
Seat 6: chertas3 (2414 in chips) 
Seat 7: 14129088 (4355 in chips) 
Seat 8: Victorgd764 (7952 in chips) 
Seat 9: Diapchik (1992 in chips) 
Diapchik: posts small blind 100
dfcastro.net: posts big blind 200
*** HOLE CARDS ***
Dealt to dfcastro.net [Td 2d]
Waldavd: calls 200
allinkim09: folds 
chertas3: folds 
14129088: folds 
Victorgd764: raises 250 to 450
Diapchik: raises 1050 to 1500
dfcastro.net: folds 
Waldavd: calls 1065 and is all-in
Victorgd764: calls 1050
*** FLOP *** [3d Ks Qs]
Diapchik: checks 
Victorgd764: bets 600
Diapchik: calls 492 and is all-in
Uncalled bet (108) returned to Victorgd764
*** TURN *** [3d Ks Qs] [Ac]
*** RIVER *** [3d Ks Qs Ac] [7h]
*** SHOW DOWN ***
Diapchik: shows [Jh Jd] (a pair of Jacks)
Victorgd764: shows [Th Ah] (a pair of Aces)
Victorgd764 collected 1454 from side pot
Waldavd: shows [9s As] (a pair of Aces - lower kicker)
Victorgd764 collected 3995 from main pot
Diapchik finished the tournament in 14th place
Waldavd finished the tournament in 15th place
*** SUMMARY ***
Total pot 5449 Main pot 3995. Side pot 1454. | Rake 0 
Board [3d Ks Qs Ac 7h]
Seat 2: dfcastro.net (big blind) folded before Flop
Seat 3: Waldavd showed [9s As] and lost with a pair of Aces
Seat 5: allinkim09 folded before Flop (didn't bet)
Seat 6: chertas3 folded before Flop (didn't bet)
Seat 7: 14129088 folded before Flop (didn't bet)
Seat 8: Victorgd764 (button) showed [Th Ah] and won (5449) with a pair of Aces
Seat 9: Diapchik (small blind) showed [Jh Jd] and lost with a pair of Jacks



PokerStars Hand #100387787691: Tournament #750518676, $0.23+$0.02 USD Hold'em No Limit - Level VI (100/200) - 2013/06/21 21:14:28 BRT [2013/06/21 20:14:28 ET]
Table '750518676 2' 9-max Seat #2 is the button
Seat 2: dfcastro.net (3305 in chips) 
Seat 5: allinkim09 (5736 in chips) 
Seat 6: chertas3 (2414 in chips) 
Seat 7: 14129088 (4355 in chips) 
Seat 8: Victorgd764 (11409 in chips) 
allinkim09: posts small blind 100
chertas3: posts big blind 200
*** HOLE CARDS ***
Dealt to dfcastro.net [2s 5c]
14129088: raises 200 to 400
Victorgd764 has timed out
Victorgd764: folds 
Victorgd764 is sitting out
dfcastro.net: folds 
Victorgd764 has returned
allinkim09: folds 
chertas3: folds 
Uncalled bet (200) returned to 14129088
14129088 collected 500 from pot
14129088: doesn't show hand 
*** SUMMARY ***
Total pot 500 | Rake 0 
Seat 2: dfcastro.net (button) folded before Flop (didn't bet)
Seat 5: allinkim09 (small blind) folded before Flop
Seat 6: chertas3 (big blind) folded before Flop
Seat 7: 14129088 collected (500)
Seat 8: Victorgd764 folded before Flop (didn't bet)



PokerStars Hand #100387815971: Tournament #750518676, $0.23+$0.02 USD Hold'em No Limit - Level VI (100/200) - 2013/06/21 21:15:20 BRT [2013/06/21 20:15:20 ET]
Table '750518676 2' 9-max Seat #5 is the button
Seat 2: dfcastro.net (3305 in chips) 
Seat 3: SSkrelya (4095 in chips) 
Seat 5: allinkim09 (5636 in chips) 
Seat 6: chertas3 (2214 in chips) 
Seat 7: 14129088 (4655 in chips) 
Seat 8: Victorgd764 (11409 in chips) 
chertas3: posts small blind 100
14129088: posts big blind 200
*** HOLE CARDS ***
Dealt to dfcastro.net [4d Jc]
Victorgd764: raises 200 to 400
dfcastro.net: folds 
SSkrelya: folds 
allinkim09: folds 
chertas3: folds 
14129088: raises 600 to 1000
Victorgd764: calls 600
*** FLOP *** [4h 7h Qc]
14129088: checks 
Victorgd764: checks 
*** TURN *** [4h 7h Qc] [3c]
14129088: bets 1400
Victorgd764: folds 
Uncalled bet (1400) returned to 14129088
14129088 collected 2100 from pot
14129088: doesn't show hand 
*** SUMMARY ***
Total pot 2100 | Rake 0 
Board [4h 7h Qc 3c]
Seat 2: dfcastro.net folded before Flop (didn't bet)
Seat 3: SSkrelya folded before Flop (didn't bet)
Seat 5: allinkim09 (button) folded before Flop (didn't bet)
Seat 6: chertas3 (small blind) folded before Flop
Seat 7: 14129088 (big blind) collected (2100)
Seat 8: Victorgd764 folded on the Turn



PokerStars Hand #100387842845: Tournament #750518676, $0.23+$0.02 USD Hold'em No Limit - Level VI (100/200) - 2013/06/21 21:16:10 BRT [2013/06/21 20:16:10 ET]
Table '750518676 2' 9-max Seat #6 is the button
Seat 2: dfcastro.net (3305 in chips) 
Seat 3: SSkrelya (4095 in chips) 
Seat 5: allinkim09 (5636 in chips) 
Seat 6: chertas3 (2114 in chips) 
Seat 7: 14129088 (5755 in chips) 
Seat 8: Victorgd764 (10409 in chips) 
14129088: posts small blind 100
Victorgd764: posts big blind 200
*** HOLE CARDS ***
Dealt to dfcastro.net [5h 2s]
dfcastro.net: folds 
SSkrelya: folds 
allinkim09: folds 
chertas3: folds 
14129088: raises 200 to 400
Victorgd764: folds [3d]
Uncalled bet (200) returned to 14129088
14129088 collected 400 from pot
14129088: doesn't show hand 
*** SUMMARY ***
Total pot 400 | Rake 0 
Seat 2: dfcastro.net folded before Flop (didn't bet)
Seat 3: SSkrelya folded before Flop (didn't bet)
Seat 5: allinkim09 folded before Flop (didn't bet)
Seat 6: chertas3 (button) folded before Flop (didn't bet)
Seat 7: 14129088 (small blind) collected (400)
Seat 8: Victorgd764 (big blind) folded before Flop



PokerStars Hand #100387871675: Tournament #750518676, $0.23+$0.02 USD Hold'em No Limit - Level VI (100/200) - 2013/06/21 21:17:03 BRT [2013/06/21 20:17:03 ET]
Table '750518676 2' 9-max Seat #7 is the button
Seat 2: dfcastro.net (3305 in chips) 
Seat 3: SSkrelya (4095 in chips) 
Seat 5: allinkim09 (5636 in chips) 
Seat 6: chertas3 (2114 in chips) 
Seat 7: 14129088 (5955 in chips) 
Seat 8: Victorgd764 (10209 in chips) 
Victorgd764: posts small blind 100
dfcastro.net: posts big blind 200
*** HOLE CARDS ***
Dealt to dfcastro.net [As Kd]
SSkrelya: folds 
allinkim09: folds 
chertas3: raises 1914 to 2114 and is all-in
14129088: folds 
Victorgd764: folds 
dfcastro.net: calls 1914
*** FLOP *** [2h 9d 9h]
*** TURN *** [2h 9d 9h] [6h]
*** RIVER *** [2h 9d 9h 6h] [7c]
*** SHOW DOWN ***
dfcastro.net: shows [As Kd] (a pair of Nines)
chertas3: shows [Kc Ks] (two pair, Kings and Nines)
chertas3 collected 4328 from pot
*** SUMMARY ***
Total pot 4328 | Rake 0 
Board [2h 9d 9h 6h 7c]
Seat 2: dfcastro.net (big blind) showed [As Kd] and lost with a pair of Nines
Seat 3: SSkrelya folded before Flop (didn't bet)
Seat 5: allinkim09 folded before Flop (didn't bet)
Seat 6: chertas3 showed [Kc Ks] and won (4328) with two pair, Kings and Nines
Seat 7: 14129088 (button) folded before Flop (didn't bet)
Seat 8: Victorgd764 (small blind) folded before Flop



PokerStars Hand #100387887844: Tournament #750518676, $0.23+$0.02 USD Hold'em No Limit - Level VI (100/200) - 2013/06/21 21:17:32 BRT [2013/06/21 20:17:32 ET]
Table '750518676 2' 9-max Seat #8 is the button
Seat 2: dfcastro.net (1191 in chips) 
Seat 3: SSkrelya (4095 in chips) 
Seat 5: allinkim09 (5636 in chips) 
Seat 6: chertas3 (4328 in chips) 
Seat 7: 14129088 (5955 in chips) 
Seat 8: Victorgd764 (10109 in chips) 
dfcastro.net: posts small blind 100
SSkrelya: posts big blind 200
*** HOLE CARDS ***
Dealt to dfcastro.net [Ac Td]
allinkim09: folds 
chertas3: folds 
14129088: folds 
Victorgd764: folds 
dfcastro.net: raises 991 to 1191 and is all-in
SSkrelya: folds 
Uncalled bet (991) returned to dfcastro.net
dfcastro.net collected 400 from pot
dfcastro.net: doesn't show hand 
*** SUMMARY ***
Total pot 400 | Rake 0 
Seat 2: dfcastro.net (small blind) collected (400)
Seat 3: SSkrelya (big blind) folded before Flop
Seat 5: allinkim09 folded before Flop (didn't bet)
Seat 6: chertas3 folded before Flop (didn't bet)
Seat 7: 14129088 folded before Flop (didn't bet)
Seat 8: Victorgd764 (button) folded before Flop (didn't bet)



PokerStars Hand #100387908223: Tournament #750518676, $0.23+$0.02 USD Hold'em No Limit - Level VII (100/200) - 2013/06/21 21:18:10 BRT [2013/06/21 20:18:10 ET]
Table '750518676 2' 9-max Seat #2 is the button
Seat 2: dfcastro.net (1391 in chips) 
Seat 3: SSkrelya (3895 in chips) 
Seat 5: allinkim09 (5636 in chips) 
Seat 6: chertas3 (4328 in chips) 
Seat 7: 14129088 (5955 in chips) 
Seat 8: Victorgd764 (10109 in chips) 
dfcastro.net: posts the ante 25
SSkrelya: posts the ante 25
allinkim09: posts the ante 25
chertas3: posts the ante 25
14129088: posts the ante 25
Victorgd764: posts the ante 25
SSkrelya: posts small blind 100
allinkim09: posts big blind 200
*** HOLE CARDS ***
Dealt to dfcastro.net [8s Ks]
chertas3: folds 
14129088: folds 
Victorgd764: folds 
dfcastro.net: raises 1166 to 1366 and is all-in
SSkrelya: folds 
allinkim09: folds 
Uncalled bet (1166) returned to dfcastro.net
dfcastro.net collected 650 from pot
dfcastro.net: doesn't show hand 
*** SUMMARY ***
Total pot 650 | Rake 0 
Seat 2: dfcastro.net (button) collected (650)
Seat 3: SSkrelya (small blind) folded before Flop
Seat 5: allinkim09 (big blind) folded before Flop
Seat 6: chertas3 folded before Flop (didn't bet)
Seat 7: 14129088 folded before Flop (didn't bet)
Seat 8: Victorgd764 folded before Flop (didn't bet)



PokerStars Hand #100387939790: Tournament #750518676, $0.23+$0.02 USD Hold'em No Limit - Level VII (100/200) - 2013/06/21 21:19:08 BRT [2013/06/21 20:19:08 ET]
Table '750518676 2' 9-max Seat #3 is the button
Seat 2: dfcastro.net (1816 in chips) 
Seat 3: SSkrelya (3770 in chips) 
Seat 5: allinkim09 (5411 in chips) 
Seat 6: chertas3 (4303 in chips) 
Seat 7: 14129088 (5930 in chips) 
Seat 8: Victorgd764 (10084 in chips) 
dfcastro.net: posts the ante 25
SSkrelya: posts the ante 25
allinkim09: posts the ante 25
chertas3: posts the ante 25
14129088: posts the ante 25
Victorgd764: posts the ante 25
allinkim09: posts small blind 100
chertas3: posts big blind 200
*** HOLE CARDS ***
Dealt to dfcastro.net [Jh Kc]
14129088: folds 
Victorgd764: folds 
dfcastro.net: raises 1591 to 1791 and is all-in
SSkrelya: folds 
allinkim09: folds 
chertas3: folds 
Uncalled bet (1591) returned to dfcastro.net
dfcastro.net collected 650 from pot
dfcastro.net: doesn't show hand 
*** SUMMARY ***
Total pot 650 | Rake 0 
Seat 2: dfcastro.net collected (650)
Seat 3: SSkrelya (button) folded before Flop (didn't bet)
Seat 5: allinkim09 (small blind) folded before Flop
Seat 6: chertas3 (big blind) folded before Flop
Seat 7: 14129088 folded before Flop (didn't bet)
Seat 8: Victorgd764 folded before Flop (didn't bet)



PokerStars Hand #100387969162: Tournament #750518676, $0.23+$0.02 USD Hold'em No Limit - Level VII (100/200) - 2013/06/21 21:20:03 BRT [2013/06/21 20:20:03 ET]
Table '750518676 2' 9-max Seat #5 is the button
Seat 2: dfcastro.net (2241 in chips) 
Seat 5: allinkim09 (5286 in chips) 
Seat 6: chertas3 (4078 in chips) 
Seat 7: 14129088 (5905 in chips) 
Seat 8: Victorgd764 (10059 in chips) 
dfcastro.net: posts the ante 25
allinkim09: posts the ante 25
chertas3: posts the ante 25
14129088: posts the ante 25
Victorgd764: posts the ante 25
chertas3: posts small blind 100
14129088: posts big blind 200
*** HOLE CARDS ***
Dealt to dfcastro.net [7d 8h]
Victorgd764: folds 
dfcastro.net: folds 
allinkim09: folds 
chertas3: folds 
Uncalled bet (100) returned to 14129088
14129088 collected 325 from pot
14129088: doesn't show hand 
*** SUMMARY ***
Total pot 325 | Rake 0 
Seat 2: dfcastro.net folded before Flop (didn't bet)
Seat 5: allinkim09 (button) folded before Flop (didn't bet)
Seat 6: chertas3 (small blind) folded before Flop
Seat 7: 14129088 (big blind) collected (325)
Seat 8: Victorgd764 folded before Flop (didn't bet)



PokerStars Hand #100387984612: Tournament #750518676, $0.23+$0.02 USD Hold'em No Limit - Level VII (100/200) - 2013/06/21 21:20:32 BRT [2013/06/21 20:20:32 ET]
Table '750518676 2' 9-max Seat #6 is the button
Seat 2: dfcastro.net (2216 in chips) 
Seat 5: allinkim09 (5261 in chips) 
Seat 6: chertas3 (3953 in chips) 
Seat 7: 14129088 (6105 in chips) 
Seat 8: Victorgd764 (10034 in chips) 
dfcastro.net: posts the ante 25
allinkim09: posts the ante 25
chertas3: posts the ante 25
14129088: posts the ante 25
Victorgd764: posts the ante 25
14129088: posts small blind 100
Victorgd764: posts big blind 200
*** HOLE CARDS ***
Dealt to dfcastro.net [Ks 5s]
dfcastro.net: raises 1600 to 1800
allinkim09: raises 1600 to 3400
chertas3: folds 
14129088: folds 
Victorgd764: folds 
dfcastro.net: calls 391 and is all-in
Uncalled bet (1209) returned to allinkim09
*** FLOP *** [Th Jd Ac]
*** TURN *** [Th Jd Ac] [8d]
*** RIVER *** [Th Jd Ac 8d] [Qc]
*** SHOW DOWN ***
dfcastro.net: shows [Ks 5s] (a straight, Ten to Ace)
allinkim09: shows [Ad Ah] (three of a kind, Aces)
dfcastro.net collected 4807 from pot
*** SUMMARY ***
Total pot 4807 | Rake 0 
Board [Th Jd Ac 8d Qc]
Seat 2: dfcastro.net showed [Ks 5s] and won (4807) with a straight, Ten to Ace
Seat 5: allinkim09 showed [Ad Ah] and lost with three of a kind, Aces
Seat 6: chertas3 (button) folded before Flop (didn't bet)
Seat 7: 14129088 (small blind) folded before Flop
Seat 8: Victorgd764 (big blind) folded before Flop



PokerStars Hand #100387998994: Tournament #750518676, $0.23+$0.02 USD Hold'em No Limit - Level VII (100/200) - 2013/06/21 21:21:00 BRT [2013/06/21 20:21:00 ET]
Table '750518676 2' 9-max Seat #7 is the button
Seat 2: dfcastro.net (4807 in chips) 
Seat 5: allinkim09 (3045 in chips) 
Seat 6: chertas3 (3928 in chips) 
Seat 7: 14129088 (5980 in chips) 
Seat 8: Victorgd764 (9809 in chips) 
dfcastro.net: posts the ante 25
allinkim09: posts the ante 25
chertas3: posts the ante 25
14129088: posts the ante 25
Victorgd764: posts the ante 25
Victorgd764: posts small blind 100
dfcastro.net: posts big blind 200
*** HOLE CARDS ***
Dealt to dfcastro.net [4s 7c]
Victorgd764 said, "lol"
allinkim09: folds 
chertas3: folds 
14129088: folds 
Victorgd764: raises 200 to 400
dfcastro.net: folds 
Uncalled bet (200) returned to Victorgd764
Victorgd764 collected 525 from pot
*** SUMMARY ***
Total pot 525 | Rake 0 
Seat 2: dfcastro.net (big blind) folded before Flop
Seat 5: allinkim09 folded before Flop (didn't bet)
Seat 6: chertas3 folded before Flop (didn't bet)
Seat 7: 14129088 (button) folded before Flop (didn't bet)
Seat 8: Victorgd764 (small blind) collected (525)



PokerStars Hand #100388008437: Tournament #750518676, $0.23+$0.02 USD Hold'em No Limit - Level VII (100/200) - 2013/06/21 21:21:17 BRT [2013/06/21 20:21:17 ET]
Table '750518676 2' 9-max Seat #8 is the button
Seat 2: dfcastro.net (4582 in chips) 
Seat 5: allinkim09 (3020 in chips) 
Seat 6: chertas3 (3903 in chips) 
Seat 7: 14129088 (5955 in chips) 
Seat 8: Victorgd764 (10109 in chips) 
dfcastro.net: posts the ante 25
allinkim09: posts the ante 25
chertas3: posts the ante 25
14129088: posts the ante 25
Victorgd764: posts the ante 25
dfcastro.net: posts small blind 100
allinkim09: posts big blind 200
*** HOLE CARDS ***
Dealt to dfcastro.net [9s 9c]
chertas3: folds 
14129088: folds 
Victorgd764: folds 
dfcastro.net: raises 4357 to 4557 and is all-in
allinkim09: folds 
Uncalled bet (4357) returned to dfcastro.net
dfcastro.net collected 525 from pot
dfcastro.net: doesn't show hand 
*** SUMMARY ***
Total pot 525 | Rake 0 
Seat 2: dfcastro.net (small blind) collected (525)
Seat 5: allinkim09 (big blind) folded before Flop
Seat 6: chertas3 folded before Flop (didn't bet)
Seat 7: 14129088 folded before Flop (didn't bet)
Seat 8: Victorgd764 (button) folded before Flop (didn't bet)



PokerStars Hand #100388024580: Tournament #750518676, $0.23+$0.02 USD Hold'em No Limit - Level VII (100/200) - 2013/06/21 21:21:48 BRT [2013/06/21 20:21:48 ET]
Table '750518676 2' 9-max Seat #2 is the button
Seat 2: dfcastro.net (4882 in chips) 
Seat 5: allinkim09 (2795 in chips) 
Seat 6: chertas3 (3878 in chips) 
Seat 7: 14129088 (5930 in chips) 
Seat 8: Victorgd764 (10084 in chips) 
dfcastro.net: posts the ante 25
allinkim09: posts the ante 25
chertas3: posts the ante 25
14129088: posts the ante 25
Victorgd764: posts the ante 25
allinkim09: posts small blind 100
chertas3: posts big blind 200
*** HOLE CARDS ***
Dealt to dfcastro.net [Js Ah]
14129088: folds 
Victorgd764: folds 
dfcastro.net: raises 400 to 600
allinkim09: folds 
chertas3: folds 
Uncalled bet (400) returned to dfcastro.net
dfcastro.net collected 625 from pot
dfcastro.net: doesn't show hand 
*** SUMMARY ***
Total pot 625 | Rake 0 
Seat 2: dfcastro.net (button) collected (625)
Seat 5: allinkim09 (small blind) folded before Flop
Seat 6: chertas3 (big blind) folded before Flop
Seat 7: 14129088 folded before Flop (didn't bet)
Seat 8: Victorgd764 folded before Flop (didn't bet)



PokerStars Hand #100388039041: Tournament #750518676, $0.23+$0.02 USD Hold'em No Limit - Level VII (100/200) - 2013/06/21 21:22:15 BRT [2013/06/21 20:22:15 ET]
Table '750518676 2' 9-max Seat #5 is the button
Seat 2: dfcastro.net (5282 in chips) 
Seat 5: allinkim09 (2670 in chips) 
Seat 6: chertas3 (3653 in chips) 
Seat 7: 14129088 (5905 in chips) 
Seat 8: Victorgd764 (10059 in chips) 
dfcastro.net: posts the ante 25
allinkim09: posts the ante 25
chertas3: posts the ante 25
14129088: posts the ante 25
Victorgd764: posts the ante 25
chertas3: posts small blind 100
14129088: posts big blind 200
*** HOLE CARDS ***
Dealt to dfcastro.net [Td 8h]
Victorgd764: folds 
dfcastro.net: folds 
allinkim09: raises 2445 to 2645 and is all-in
chertas3: folds 
14129088: folds 
Uncalled bet (2445) returned to allinkim09
allinkim09 collected 625 from pot
allinkim09: doesn't show hand 
*** SUMMARY ***
Total pot 625 | Rake 0 
Seat 2: dfcastro.net folded before Flop (didn't bet)
Seat 5: allinkim09 (button) collected (625)
Seat 6: chertas3 (small blind) folded before Flop
Seat 7: 14129088 (big blind) folded before Flop
Seat 8: Victorgd764 folded before Flop (didn't bet)



PokerStars Hand #100388056961: Tournament #750518676, $0.23+$0.02 USD Hold'em No Limit - Level VII (100/200) - 2013/06/21 21:22:49 BRT [2013/06/21 20:22:49 ET]
Table '750518676 2' 9-max Seat #6 is the button
Seat 2: dfcastro.net (5257 in chips) 
Seat 5: allinkim09 (3070 in chips) 
Seat 6: chertas3 (3528 in chips) 
Seat 7: 14129088 (5680 in chips) 
Seat 8: Victorgd764 (10034 in chips) 
dfcastro.net: posts the ante 25
allinkim09: posts the ante 25
chertas3: posts the ante 25
14129088: posts the ante 25
Victorgd764: posts the ante 25
14129088: posts small blind 100
Victorgd764: posts big blind 200
*** HOLE CARDS ***
Dealt to dfcastro.net [8c 3s]
dfcastro.net: folds 
allinkim09: raises 2845 to 3045 and is all-in
chertas3: folds 
14129088: folds 
Victorgd764: folds 
Uncalled bet (2845) returned to allinkim09
allinkim09 collected 625 from pot
*** SUMMARY ***
Total pot 625 | Rake 0 
Seat 2: dfcastro.net folded before Flop (didn't bet)
Seat 5: allinkim09 collected (625)
Seat 6: chertas3 (button) folded before Flop (didn't bet)
Seat 7: 14129088 (small blind) folded before Flop
Seat 8: Victorgd764 (big blind) folded before Flop



PokerStars Hand #100388072161: Tournament #750518676, $0.23+$0.02 USD Hold'em No Limit - Level VII (100/200) - 2013/06/21 21:23:18 BRT [2013/06/21 20:23:18 ET]
Table '750518676 2' 9-max Seat #7 is the button
Seat 2: dfcastro.net (5232 in chips) 
Seat 5: allinkim09 (3470 in chips) 
Seat 6: chertas3 (3503 in chips) 
Seat 7: 14129088 (5555 in chips) 
Seat 8: Victorgd764 (9809 in chips) 
dfcastro.net: posts the ante 25
allinkim09: posts the ante 25
chertas3: posts the ante 25
14129088: posts the ante 25
Victorgd764: posts the ante 25
Victorgd764: posts small blind 100
dfcastro.net: posts big blind 200
*** HOLE CARDS ***
Dealt to dfcastro.net [Ts 5d]
allinkim09: folds 
chertas3: folds 
14129088: folds 
Victorgd764: raises 350 to 550
dfcastro.net: folds 
Uncalled bet (350) returned to Victorgd764
Victorgd764 collected 525 from pot
*** SUMMARY ***
Total pot 525 | Rake 0 
Seat 2: dfcastro.net (big blind) folded before Flop
Seat 5: allinkim09 folded before Flop (didn't bet)
Seat 6: chertas3 folded before Flop (didn't bet)
Seat 7: 14129088 (button) folded before Flop (didn't bet)
Seat 8: Victorgd764 (small blind) collected (525)



PokerStars Hand #100388086648: Tournament #750518676, $0.23+$0.02 USD Hold'em No Limit - Level VII (100/200) - 2013/06/21 21:23:46 BRT [2013/06/21 20:23:46 ET]
Table '750518676 2' 9-max Seat #8 is the button
Seat 2: dfcastro.net (5007 in chips) 
Seat 5: allinkim09 (3445 in chips) 
Seat 6: chertas3 (3478 in chips) 
Seat 7: 14129088 (5530 in chips) 
Seat 8: Victorgd764 (10109 in chips) 
dfcastro.net: posts the ante 25
allinkim09: posts the ante 25
chertas3: posts the ante 25
14129088: posts the ante 25
Victorgd764: posts the ante 25
dfcastro.net: posts small blind 100
allinkim09: posts big blind 200
*** HOLE CARDS ***
Dealt to dfcastro.net [5s Jh]
chertas3: folds 
14129088: folds 
Victorgd764: folds 
dfcastro.net: folds 
Uncalled bet (100) returned to allinkim09
allinkim09 collected 325 from pot
allinkim09: doesn't show hand 
*** SUMMARY ***
Total pot 325 | Rake 0 
Seat 2: dfcastro.net (small blind) folded before Flop
Seat 5: allinkim09 (big blind) collected (325)
Seat 6: chertas3 folded before Flop (didn't bet)
Seat 7: 14129088 folded before Flop (didn't bet)
Seat 8: Victorgd764 (button) folded before Flop (didn't bet)



PokerStars Hand #100388092937: Tournament #750518676, $0.23+$0.02 USD Hold'em No Limit - Level VII (100/200) - 2013/06/21 21:23:58 BRT [2013/06/21 20:23:58 ET]
Table '750518676 2' 9-max Seat #2 is the button
Seat 2: dfcastro.net (4882 in chips) 
Seat 5: allinkim09 (3645 in chips) 
Seat 6: chertas3 (3453 in chips) 
Seat 7: 14129088 (5505 in chips) 
Seat 8: Victorgd764 (10084 in chips) 
dfcastro.net: posts the ante 25
allinkim09: posts the ante 25
chertas3: posts the ante 25
14129088: posts the ante 25
Victorgd764: posts the ante 25
allinkim09: posts small blind 100
chertas3: posts big blind 200
*** HOLE CARDS ***
Dealt to dfcastro.net [9d Ks]
14129088: folds 
Victorgd764: raises 275 to 475
dfcastro.net: folds 
allinkim09: folds 
chertas3: folds 
Uncalled bet (275) returned to Victorgd764
Victorgd764 collected 625 from pot
*** SUMMARY ***
Total pot 625 | Rake 0 
Seat 2: dfcastro.net (button) folded before Flop (didn't bet)
Seat 5: allinkim09 (small blind) folded before Flop
Seat 6: chertas3 (big blind) folded before Flop
Seat 7: 14129088 folded before Flop (didn't bet)
Seat 8: Victorgd764 collected (625)



PokerStars Hand #100388103254: Tournament #750518676, $0.23+$0.02 USD Hold'em No Limit - Level VII (100/200) - 2013/06/21 21:24:18 BRT [2013/06/21 20:24:18 ET]
Table '750518676 2' 9-max Seat #5 is the button
Seat 2: dfcastro.net (4857 in chips) 
Seat 5: allinkim09 (3520 in chips) 
Seat 6: chertas3 (3228 in chips) 
Seat 7: 14129088 (5480 in chips) 
Seat 8: Victorgd764 (10484 in chips) 
dfcastro.net: posts the ante 25
allinkim09: posts the ante 25
chertas3: posts the ante 25
14129088: posts the ante 25
Victorgd764: posts the ante 25
chertas3: posts small blind 100
14129088: posts big blind 200
*** HOLE CARDS ***
Dealt to dfcastro.net [7s Jd]
Victorgd764: folds 
dfcastro.net: folds 
allinkim09: folds 
chertas3: folds 
Uncalled bet (100) returned to 14129088
14129088 collected 325 from pot
14129088: doesn't show hand 
*** SUMMARY ***
Total pot 325 | Rake 0 
Seat 2: dfcastro.net folded before Flop (didn't bet)
Seat 5: allinkim09 (button) folded before Flop (didn't bet)
Seat 6: chertas3 (small blind) folded before Flop
Seat 7: 14129088 (big blind) collected (325)
Seat 8: Victorgd764 folded before Flop (didn't bet)



PokerStars Hand #100388112559: Tournament #750518676, $0.23+$0.02 USD Hold'em No Limit - Level VII (100/200) - 2013/06/21 21:24:35 BRT [2013/06/21 20:24:35 ET]
Table '750518676 2' 9-max Seat #6 is the button
Seat 2: dfcastro.net (4832 in chips) 
Seat 5: allinkim09 (3495 in chips) 
Seat 6: chertas3 (3103 in chips) 
Seat 7: 14129088 (5680 in chips) 
Seat 8: Victorgd764 (10459 in chips) 
dfcastro.net: posts the ante 25
allinkim09: posts the ante 25
chertas3: posts the ante 25
14129088: posts the ante 25
Victorgd764: posts the ante 25
14129088: posts small blind 100
Victorgd764: posts big blind 200
*** HOLE CARDS ***
Dealt to dfcastro.net [Qd Qh]
dfcastro.net: raises 400 to 600
allinkim09: folds 
chertas3: folds 
14129088: folds 
Victorgd764: folds 
Uncalled bet (400) returned to dfcastro.net
dfcastro.net collected 625 from pot
dfcastro.net: doesn't show hand 
*** SUMMARY ***
Total pot 625 | Rake 0 
Seat 2: dfcastro.net collected (625)
Seat 5: allinkim09 folded before Flop (didn't bet)
Seat 6: chertas3 (button) folded before Flop (didn't bet)
Seat 7: 14129088 (small blind) folded before Flop
Seat 8: Victorgd764 (big blind) folded before Flop



PokerStars Hand #100388129239: Tournament #750518676, $0.23+$0.02 USD Hold'em No Limit - Level VII (100/200) - 2013/06/21 21:25:07 BRT [2013/06/21 20:25:07 ET]
Table '750518676 2' 9-max Seat #7 is the button
Seat 2: dfcastro.net (5232 in chips) 
Seat 5: allinkim09 (3470 in chips) 
Seat 6: chertas3 (3078 in chips) 
Seat 7: 14129088 (5555 in chips) 
Seat 8: Victorgd764 (10234 in chips) 
dfcastro.net: posts the ante 25
allinkim09: posts the ante 25
chertas3: posts the ante 25
14129088: posts the ante 25
Victorgd764: posts the ante 25
Victorgd764: posts small blind 100
dfcastro.net: posts big blind 200
*** HOLE CARDS ***
Dealt to dfcastro.net [Ts 4d]
allinkim09: folds 
chertas3: folds 
14129088: folds 
Victorgd764: raises 350 to 550
dfcastro.net: folds 
Uncalled bet (350) returned to Victorgd764
Victorgd764 collected 525 from pot
*** SUMMARY ***
Total pot 525 | Rake 0 
Seat 2: dfcastro.net (big blind) folded before Flop
Seat 5: allinkim09 folded before Flop (didn't bet)
Seat 6: chertas3 folded before Flop (didn't bet)
Seat 7: 14129088 (button) folded before Flop (didn't bet)
Seat 8: Victorgd764 (small blind) collected (525)



PokerStars Hand #100388140654: Tournament #750518676, $0.23+$0.02 USD Hold'em No Limit - Level VII (100/200) - 2013/06/21 21:25:29 BRT [2013/06/21 20:25:29 ET]
Table '750518676 2' 9-max Seat #8 is the button
Seat 2: dfcastro.net (5007 in chips) 
Seat 5: allinkim09 (3445 in chips) 
Seat 6: chertas3 (3053 in chips) 
Seat 7: 14129088 (5530 in chips) 
Seat 8: Victorgd764 (10534 in chips) 
dfcastro.net: posts the ante 25
allinkim09: posts the ante 25
chertas3: posts the ante 25
14129088: posts the ante 25
Victorgd764: posts the ante 25
dfcastro.net: posts small blind 100
allinkim09: posts big blind 200
*** HOLE CARDS ***
Dealt to dfcastro.net [9s 2h]
chertas3: folds 
14129088: folds 
Victorgd764: folds 
dfcastro.net: folds 
Uncalled bet (100) returned to allinkim09
allinkim09 collected 325 from pot
allinkim09: doesn't show hand 
*** SUMMARY ***
Total pot 325 | Rake 0 
Seat 2: dfcastro.net (small blind) folded before Flop
Seat 5: allinkim09 (big blind) collected (325)
Seat 6: chertas3 folded before Flop (didn't bet)
Seat 7: 14129088 folded before Flop (didn't bet)
Seat 8: Victorgd764 (button) folded before Flop (didn't bet)



PokerStars Hand #100388146971: Tournament #750518676, $0.23+$0.02 USD Hold'em No Limit - Level VII (100/200) - 2013/06/21 21:25:41 BRT [2013/06/21 20:25:41 ET]
Table '750518676 2' 9-max Seat #2 is the button
Seat 2: dfcastro.net (4882 in chips) 
Seat 5: allinkim09 (3645 in chips) 
Seat 6: chertas3 (3028 in chips) 
Seat 7: 14129088 (5505 in chips) 
Seat 8: Victorgd764 (10509 in chips) 
dfcastro.net: posts the ante 25
allinkim09: posts the ante 25
chertas3: posts the ante 25
14129088: posts the ante 25
Victorgd764: posts the ante 25
allinkim09: posts small blind 100
chertas3: posts big blind 200
*** HOLE CARDS ***
Dealt to dfcastro.net [7h 8c]
14129088: folds 
Victorgd764: folds 
dfcastro.net: folds 
allinkim09: raises 3420 to 3620 and is all-in
chertas3: folds 
Uncalled bet (3420) returned to allinkim09
allinkim09 collected 525 from pot
allinkim09: doesn't show hand 
*** SUMMARY ***
Total pot 525 | Rake 0 
Seat 2: dfcastro.net (button) folded before Flop (didn't bet)
Seat 5: allinkim09 (small blind) collected (525)
Seat 6: chertas3 (big blind) folded before Flop
Seat 7: 14129088 folded before Flop (didn't bet)
Seat 8: Victorgd764 folded before Flop (didn't bet)



PokerStars Hand #100388166355: Tournament #750518676, $0.23+$0.02 USD Hold'em No Limit - Level VII (100/200) - 2013/06/21 21:26:19 BRT [2013/06/21 20:26:19 ET]
Table '750518676 2' 9-max Seat #5 is the button
Seat 1: Y_NG_X (5330 in chips) 
Seat 2: dfcastro.net (4857 in chips) 
Seat 3: SSkrelya (3045 in chips) 
Seat 4: oklandsvag (3879 in chips) 
Seat 5: allinkim09 (3945 in chips) 
Seat 6: chertas3 (2803 in chips) 
Seat 7: 14129088 (5480 in chips) 
Seat 8: Victorgd764 (10484 in chips) 
Seat 9: Silvaa.10 (27677 in chips) 
Y_NG_X: posts the ante 25
dfcastro.net: posts the ante 25
SSkrelya: posts the ante 25
oklandsvag: posts the ante 25
allinkim09: posts the ante 25
chertas3: posts the ante 25
14129088: posts the ante 25
Victorgd764: posts the ante 25
Silvaa.10: posts the ante 25
chertas3: posts small blind 100
14129088: posts big blind 200
*** HOLE CARDS ***
Dealt to dfcastro.net [8h Js]
Victorgd764: folds 
Silvaa.10: folds 
Y_NG_X: folds 
dfcastro.net: folds 
SSkrelya: raises 240 to 440
oklandsvag: folds 
allinkim09: folds 
chertas3: folds 
14129088: folds 
Uncalled bet (240) returned to SSkrelya
SSkrelya collected 725 from pot
*** SUMMARY ***
Total pot 725 | Rake 0 
Seat 1: Y_NG_X folded before Flop (didn't bet)
Seat 2: dfcastro.net folded before Flop (didn't bet)
Seat 3: SSkrelya collected (725)
Seat 4: oklandsvag folded before Flop (didn't bet)
Seat 5: allinkim09 (button) folded before Flop (didn't bet)
Seat 6: chertas3 (small blind) folded before Flop
Seat 7: 14129088 (big blind) folded before Flop
Seat 8: Victorgd764 folded before Flop (didn't bet)
Seat 9: Silvaa.10 folded before Flop (didn't bet)



PokerStars Hand #100388192062: Tournament #750518676, $0.23+$0.02 USD Hold'em No Limit - Level VII (100/200) - 2013/06/21 21:27:09 BRT [2013/06/21 20:27:09 ET]
Table '750518676 2' 9-max Seat #6 is the button
Seat 1: Y_NG_X (5305 in chips) 
Seat 2: dfcastro.net (4832 in chips) 
Seat 3: SSkrelya (3545 in chips) 
Seat 4: oklandsvag (3854 in chips) 
Seat 5: allinkim09 (3920 in chips) 
Seat 6: chertas3 (2678 in chips) 
Seat 7: 14129088 (5255 in chips) 
Seat 8: Victorgd764 (10459 in chips) 
Seat 9: Silvaa.10 (27652 in chips) 
Y_NG_X: posts the ante 25
dfcastro.net: posts the ante 25
SSkrelya: posts the ante 25
oklandsvag: posts the ante 25
allinkim09: posts the ante 25
chertas3: posts the ante 25
14129088: posts the ante 25
Victorgd764: posts the ante 25
Silvaa.10: posts the ante 25
14129088: posts small blind 100
Victorgd764: posts big blind 200
*** HOLE CARDS ***
Dealt to dfcastro.net [Kh Qh]
Silvaa.10: folds 
Y_NG_X: folds 
dfcastro.net: raises 400 to 600
SSkrelya: folds 
oklandsvag: calls 600
allinkim09: folds 
chertas3: folds 
14129088: folds 
Victorgd764: folds 
*** FLOP *** [5h 6c 4c]
dfcastro.net: checks 
oklandsvag: checks 
*** TURN *** [5h 6c 4c] [3d]
dfcastro.net: checks 
oklandsvag: checks 
*** RIVER *** [5h 6c 4c 3d] [2s]
dfcastro.net: bets 1800
oklandsvag: calls 1800
*** SHOW DOWN ***
dfcastro.net: shows [Kh Qh] (a straight, Deuce to Six)
oklandsvag: shows [Jd 9d] (a straight, Deuce to Six)
dfcastro.net collected 2663 from pot
oklandsvag collected 2662 from pot
*** SUMMARY ***
Total pot 5325 | Rake 0 
Board [5h 6c 4c 3d 2s]
Seat 1: Y_NG_X folded before Flop (didn't bet)
Seat 2: dfcastro.net showed [Kh Qh] and won (2663) with a straight, Deuce to Six
Seat 3: SSkrelya folded before Flop (didn't bet)
Seat 4: oklandsvag showed [Jd 9d] and won (2662) with a straight, Deuce to Six
Seat 5: allinkim09 folded before Flop (didn't bet)
Seat 6: chertas3 (button) folded before Flop (didn't bet)
Seat 7: 14129088 (small blind) folded before Flop
Seat 8: Victorgd764 (big blind) folded before Flop
Seat 9: Silvaa.10 folded before Flop (didn't bet)



PokerStars Hand #100388223358: Tournament #750518676, $0.23+$0.02 USD Hold'em No Limit - Level VIII (150/300) - 2013/06/21 21:28:11 BRT [2013/06/21 20:28:11 ET]
Table '750518676 2' 9-max Seat #7 is the button
Seat 1: Y_NG_X (5280 in chips) 
Seat 2: dfcastro.net (5070 in chips) 
Seat 3: SSkrelya (3520 in chips) 
Seat 4: oklandsvag (4091 in chips) 
Seat 5: allinkim09 (3895 in chips) 
Seat 6: chertas3 (2653 in chips) 
Seat 7: 14129088 (5130 in chips) 
Seat 8: Victorgd764 (10234 in chips) 
Seat 9: Silvaa.10 (27627 in chips) 
Y_NG_X: posts the ante 25
dfcastro.net: posts the ante 25
SSkrelya: posts the ante 25
oklandsvag: posts the ante 25
allinkim09: posts the ante 25
chertas3: posts the ante 25
14129088: posts the ante 25
Victorgd764: posts the ante 25
Silvaa.10: posts the ante 25
Victorgd764: posts small blind 150
Silvaa.10: posts big blind 300
*** HOLE CARDS ***
Dealt to dfcastro.net [6s As]
Y_NG_X: folds 
dfcastro.net: raises 600 to 900
SSkrelya: folds 
oklandsvag: raises 900 to 1800
allinkim09: folds 
chertas3: folds 
14129088: raises 3305 to 5105 and is all-in
Victorgd764: folds 
Silvaa.10: folds 
dfcastro.net: folds 
oklandsvag: calls 2266 and is all-in
Uncalled bet (1039) returned to 14129088
*** FLOP *** [9s 5h 2h]
*** TURN *** [9s 5h 2h] [7d]
*** RIVER *** [9s 5h 2h 7d] [Js]
*** SHOW DOWN ***
oklandsvag: shows [Ac Kd] (high card Ace)
14129088: shows [Ah Ad] (a pair of Aces)
14129088 collected 9707 from pot
oklandsvag finished the tournament in 9th place
*** SUMMARY ***
Total pot 9707 | Rake 0 
Board [9s 5h 2h 7d Js]
Seat 1: Y_NG_X folded before Flop (didn't bet)
Seat 2: dfcastro.net folded before Flop
Seat 3: SSkrelya folded before Flop (didn't bet)
Seat 4: oklandsvag showed [Ac Kd] and lost with high card Ace
Seat 5: allinkim09 folded before Flop (didn't bet)
Seat 6: chertas3 folded before Flop (didn't bet)
Seat 7: 14129088 (button) showed [Ah Ad] and won (9707) with a pair of Aces
Seat 8: Victorgd764 (small blind) folded before Flop
Seat 9: Silvaa.10 (big blind) folded before Flop



PokerStars Hand #100388246607: Tournament #750518676, $0.23+$0.02 USD Hold'em No Limit - Level VIII (150/300) - 2013/06/21 21:28:56 BRT [2013/06/21 20:28:56 ET]
Table '750518676 2' 9-max Seat #8 is the button
Seat 1: Y_NG_X (5255 in chips) 
Seat 2: dfcastro.net (4145 in chips) 
Seat 3: SSkrelya (3495 in chips) 
Seat 5: allinkim09 (3870 in chips) 
Seat 6: chertas3 (2628 in chips) 
Seat 7: 14129088 (10746 in chips) 
Seat 8: Victorgd764 (10059 in chips) 
Seat 9: Silvaa.10 (27302 in chips) 
Y_NG_X: posts the ante 25
dfcastro.net: posts the ante 25
SSkrelya: posts the ante 25
allinkim09: posts the ante 25
chertas3: posts the ante 25
14129088: posts the ante 25
Victorgd764: posts the ante 25
Silvaa.10: posts the ante 25
Silvaa.10: posts small blind 150
Y_NG_X: posts big blind 300
*** HOLE CARDS ***
Dealt to dfcastro.net [6h 7d]
dfcastro.net: folds 
SSkrelya: folds 
allinkim09: folds 
chertas3: folds 
14129088: folds 
Victorgd764: raises 375 to 675
Silvaa.10: folds 
Y_NG_X: folds 
Uncalled bet (375) returned to Victorgd764
Victorgd764 collected 950 from pot
*** SUMMARY ***
Total pot 950 | Rake 0 
Seat 1: Y_NG_X (big blind) folded before Flop
Seat 2: dfcastro.net folded before Flop (didn't bet)
Seat 3: SSkrelya folded before Flop (didn't bet)
Seat 5: allinkim09 folded before Flop (didn't bet)
Seat 6: chertas3 folded before Flop (didn't bet)
Seat 7: 14129088 folded before Flop (didn't bet)
Seat 8: Victorgd764 (button) collected (950)
Seat 9: Silvaa.10 (small blind) folded before Flop



PokerStars Hand #100388262629: Tournament #750518676, $0.23+$0.02 USD Hold'em No Limit - Level VIII (150/300) - 2013/06/21 21:29:28 BRT [2013/06/21 20:29:28 ET]
Table '750518676 2' 9-max Seat #9 is the button
Seat 1: Y_NG_X (4930 in chips) 
Seat 2: dfcastro.net (4120 in chips) 
Seat 3: SSkrelya (3470 in chips) 
Seat 5: allinkim09 (3845 in chips) 
Seat 6: chertas3 (2603 in chips) 
Seat 7: 14129088 (10721 in chips) 
Seat 8: Victorgd764 (10684 in chips) 
Seat 9: Silvaa.10 (27127 in chips) 
Y_NG_X: posts the ante 25
dfcastro.net: posts the ante 25
SSkrelya: posts the ante 25
allinkim09: posts the ante 25
chertas3: posts the ante 25
14129088: posts the ante 25
Victorgd764: posts the ante 25
Silvaa.10: posts the ante 25
Y_NG_X: posts small blind 150
dfcastro.net: posts big blind 300
*** HOLE CARDS ***
Dealt to dfcastro.net [6s 7h]
SSkrelya: folds 
allinkim09: folds 
chertas3: folds 
14129088: folds 
Victorgd764: raises 385 to 685
Silvaa.10: raises 515 to 1200
Y_NG_X: folds 
dfcastro.net: folds 
Victorgd764: calls 515
*** FLOP *** [Jc Tc Qh]
Victorgd764: checks 
Silvaa.10: bets 900
Victorgd764: folds [5d 5h]
Uncalled bet (900) returned to Silvaa.10
Silvaa.10 collected 3050 from pot
*** SUMMARY ***
Total pot 3050 | Rake 0 
Board [Jc Tc Qh]
Seat 1: Y_NG_X (small blind) folded before Flop
Seat 2: dfcastro.net (big blind) folded before Flop
Seat 3: SSkrelya folded before Flop (didn't bet)
Seat 5: allinkim09 folded before Flop (didn't bet)
Seat 6: chertas3 folded before Flop (didn't bet)
Seat 7: 14129088 folded before Flop (didn't bet)
Seat 8: Victorgd764 folded on the Flop
Seat 9: Silvaa.10 (button) collected (3050)



PokerStars Hand #100388287288: Tournament #750518676, $0.23+$0.02 USD Hold'em No Limit - Level VIII (150/300) - 2013/06/21 21:30:17 BRT [2013/06/21 20:30:17 ET]
Table '750518676 2' 9-max Seat #1 is the button
Seat 1: Y_NG_X (4755 in chips) 
Seat 2: dfcastro.net (3795 in chips) 
Seat 3: SSkrelya (3445 in chips) 
Seat 5: allinkim09 (3820 in chips) 
Seat 6: chertas3 (2578 in chips) 
Seat 7: 14129088 (10696 in chips) 
Seat 8: Victorgd764 (9459 in chips) 
Seat 9: Silvaa.10 (28952 in chips) 
Y_NG_X: posts the ante 25
dfcastro.net: posts the ante 25
SSkrelya: posts the ante 25
allinkim09: posts the ante 25
chertas3: posts the ante 25
14129088: posts the ante 25
Victorgd764: posts the ante 25
Silvaa.10: posts the ante 25
dfcastro.net: posts small blind 150
SSkrelya: posts big blind 300
*** HOLE CARDS ***
Dealt to dfcastro.net [Qs 3s]
allinkim09: folds 
chertas3: folds 
14129088: folds 
Victorgd764: folds 
Silvaa.10: raises 600 to 900
Y_NG_X: folds 
dfcastro.net: folds 
SSkrelya: folds 
Uncalled bet (600) returned to Silvaa.10
Silvaa.10 collected 950 from pot
*** SUMMARY ***
Total pot 950 | Rake 0 
Seat 1: Y_NG_X (button) folded before Flop (didn't bet)
Seat 2: dfcastro.net (small blind) folded before Flop
Seat 3: SSkrelya (big blind) folded before Flop
Seat 5: allinkim09 folded before Flop (didn't bet)
Seat 6: chertas3 folded before Flop (didn't bet)
Seat 7: 14129088 folded before Flop (didn't bet)
Seat 8: Victorgd764 folded before Flop (didn't bet)
Seat 9: Silvaa.10 collected (950)



PokerStars Hand #100388301818: Tournament #750518676, $0.23+$0.02 USD Hold'em No Limit - Level VIII (150/300) - 2013/06/21 21:30:46 BRT [2013/06/21 20:30:46 ET]
Table '750518676 2' 9-max Seat #2 is the button
Seat 1: Y_NG_X (4730 in chips) 
Seat 2: dfcastro.net (3620 in chips) 
Seat 3: SSkrelya (3120 in chips) 
Seat 5: allinkim09 (3795 in chips) 
Seat 6: chertas3 (2553 in chips) 
Seat 7: 14129088 (10671 in chips) 
Seat 8: Victorgd764 (9434 in chips) 
Seat 9: Silvaa.10 (29577 in chips) 
Y_NG_X: posts the ante 25
dfcastro.net: posts the ante 25
SSkrelya: posts the ante 25
allinkim09: posts the ante 25
chertas3: posts the ante 25
14129088: posts the ante 25
Victorgd764: posts the ante 25
Silvaa.10: posts the ante 25
SSkrelya: posts small blind 150
allinkim09: posts big blind 300
*** HOLE CARDS ***
Dealt to dfcastro.net [9s 4h]
chertas3: folds 
14129088: folds 
Victorgd764: raises 600 to 900
Silvaa.10: raises 600 to 1500
Y_NG_X: folds 
dfcastro.net: folds 
SSkrelya: folds 
allinkim09: folds 
Victorgd764: raises 1500 to 3000
Silvaa.10: calls 1500
*** FLOP *** [3c 9c 2h]
Victorgd764: bets 2400
Silvaa.10: folds 
Uncalled bet (2400) returned to Victorgd764
Victorgd764 collected 6650 from pot
*** SUMMARY ***
Total pot 6650 | Rake 0 
Board [3c 9c 2h]
Seat 1: Y_NG_X folded before Flop (didn't bet)
Seat 2: dfcastro.net (button) folded before Flop (didn't bet)
Seat 3: SSkrelya (small blind) folded before Flop
Seat 5: allinkim09 (big blind) folded before Flop
Seat 6: chertas3 folded before Flop (didn't bet)
Seat 7: 14129088 folded before Flop (didn't bet)
Seat 8: Victorgd764 collected (6650)
Seat 9: Silvaa.10 folded on the Flop



PokerStars Hand #100388326249: Tournament #750518676, $0.23+$0.02 USD Hold'em No Limit - Level VIII (150/300) - 2013/06/21 21:31:34 BRT [2013/06/21 20:31:34 ET]
Table '750518676 2' 9-max Seat #3 is the button
Seat 1: Y_NG_X (4705 in chips) 
Seat 2: dfcastro.net (3595 in chips) 
Seat 3: SSkrelya (2945 in chips) 
Seat 5: allinkim09 (3470 in chips) 
Seat 6: chertas3 (2528 in chips) 
Seat 7: 14129088 (10646 in chips) 
Seat 8: Victorgd764 (13059 in chips) 
Seat 9: Silvaa.10 (26552 in chips) 
Y_NG_X: posts the ante 25
dfcastro.net: posts the ante 25
SSkrelya: posts the ante 25
allinkim09: posts the ante 25
chertas3: posts the ante 25
14129088: posts the ante 25
Victorgd764: posts the ante 25
Silvaa.10: posts the ante 25
allinkim09: posts small blind 150
chertas3: posts big blind 300
*** HOLE CARDS ***
Dealt to dfcastro.net [7d Ks]
14129088: folds 
Victorgd764: raises 365 to 665
Silvaa.10: folds 
Y_NG_X: folds 
dfcastro.net: folds 
SSkrelya: folds 
allinkim09: folds 
chertas3: folds 
Uncalled bet (365) returned to Victorgd764
Victorgd764 collected 950 from pot
*** SUMMARY ***
Total pot 950 | Rake 0 
Seat 1: Y_NG_X folded before Flop (didn't bet)
Seat 2: dfcastro.net folded before Flop (didn't bet)
Seat 3: SSkrelya (button) folded before Flop (didn't bet)
Seat 5: allinkim09 (small blind) folded before Flop
Seat 6: chertas3 (big blind) folded before Flop
Seat 7: 14129088 folded before Flop (didn't bet)
Seat 8: Victorgd764 collected (950)
Seat 9: Silvaa.10 folded before Flop (didn't bet)



PokerStars Hand #100388347335: Tournament #750518676, $0.23+$0.02 USD Hold'em No Limit - Level VIII (150/300) - 2013/06/21 21:32:16 BRT [2013/06/21 20:32:16 ET]
Table '750518676 2' 9-max Seat #5 is the button
Seat 1: Y_NG_X (4680 in chips) 
Seat 2: dfcastro.net (3570 in chips) 
Seat 3: SSkrelya (2920 in chips) 
Seat 5: allinkim09 (3295 in chips) 
Seat 6: chertas3 (2203 in chips) 
Seat 7: 14129088 (10621 in chips) 
Seat 8: Victorgd764 (13684 in chips) 
Seat 9: Silvaa.10 (26527 in chips) 
Y_NG_X: posts the ante 25
dfcastro.net: posts the ante 25
SSkrelya: posts the ante 25
allinkim09: posts the ante 25
chertas3: posts the ante 25
14129088: posts the ante 25
Victorgd764: posts the ante 25
Silvaa.10: posts the ante 25
chertas3: posts small blind 150
14129088: posts big blind 300
*** HOLE CARDS ***
Dealt to dfcastro.net [Kd Th]
Victorgd764: folds 
Silvaa.10: folds 
Y_NG_X: folds 
dfcastro.net: folds 
SSkrelya: folds 
allinkim09: folds 
chertas3: raises 1878 to 2178 and is all-in
14129088: calls 1878
*** FLOP *** [As 5c 9c]
*** TURN *** [As 5c 9c] [7h]
*** RIVER *** [As 5c 9c 7h] [4d]
*** SHOW DOWN ***
chertas3: shows [Td Ac] (a pair of Aces)
14129088: shows [Qh 2c] (high card Ace)
chertas3 collected 4556 from pot
*** SUMMARY ***
Total pot 4556 | Rake 0 
Board [As 5c 9c 7h 4d]
Seat 1: Y_NG_X folded before Flop (didn't bet)
Seat 2: dfcastro.net folded before Flop (didn't bet)
Seat 3: SSkrelya folded before Flop (didn't bet)
Seat 5: allinkim09 (button) folded before Flop (didn't bet)
Seat 6: chertas3 (small blind) showed [Td Ac] and won (4556) with a pair of Aces
Seat 7: 14129088 (big blind) showed [Qh 2c] and lost with high card Ace
Seat 8: Victorgd764 folded before Flop (didn't bet)
Seat 9: Silvaa.10 folded before Flop (didn't bet)



PokerStars Hand #100388369128: Tournament #750518676, $0.23+$0.02 USD Hold'em No Limit - Level VIII (150/300) - 2013/06/21 21:33:00 BRT [2013/06/21 20:33:00 ET]
Table '750518676 2' 9-max Seat #6 is the button
Seat 1: Y_NG_X (4655 in chips) 
Seat 2: dfcastro.net (3545 in chips) 
Seat 3: SSkrelya (2895 in chips) 
Seat 5: allinkim09 (3270 in chips) 
Seat 6: chertas3 (4556 in chips) 
Seat 7: 14129088 (8418 in chips) 
Seat 8: Victorgd764 (13659 in chips) 
Seat 9: Silvaa.10 (26502 in chips) 
Y_NG_X: posts the ante 25
dfcastro.net: posts the ante 25
SSkrelya: posts the ante 25
allinkim09: posts the ante 25
chertas3: posts the ante 25
14129088: posts the ante 25
Victorgd764: posts the ante 25
Silvaa.10: posts the ante 25
14129088: posts small blind 150
Victorgd764: posts big blind 300
*** HOLE CARDS ***
Dealt to dfcastro.net [4h Td]
Silvaa.10: folds 
Y_NG_X: folds 
dfcastro.net: folds 
SSkrelya: folds 
allinkim09: folds 
chertas3: folds 
14129088: raises 300 to 600
Victorgd764: folds 
Uncalled bet (300) returned to 14129088
14129088 collected 800 from pot
14129088: doesn't show hand 
*** SUMMARY ***
Total pot 800 | Rake 0 
Seat 1: Y_NG_X folded before Flop (didn't bet)
Seat 2: dfcastro.net folded before Flop (didn't bet)
Seat 3: SSkrelya folded before Flop (didn't bet)
Seat 5: allinkim09 folded before Flop (didn't bet)
Seat 6: chertas3 (button) folded before Flop (didn't bet)
Seat 7: 14129088 (small blind) collected (800)
Seat 8: Victorgd764 (big blind) folded before Flop
Seat 9: Silvaa.10 folded before Flop (didn't bet)



PokerStars Hand #100388380502: Tournament #750518676, $0.23+$0.02 USD Hold'em No Limit - Level VIII (150/300) - 2013/06/21 21:33:24 BRT [2013/06/21 20:33:24 ET]
Table '750518676 2' 9-max Seat #7 is the button
Seat 1: Y_NG_X (4630 in chips) 
Seat 2: dfcastro.net (3520 in chips) 
Seat 3: SSkrelya (2870 in chips) 
Seat 5: allinkim09 (3245 in chips) 
Seat 6: chertas3 (4531 in chips) 
Seat 7: 14129088 (8893 in chips) 
Seat 8: Victorgd764 (13334 in chips) 
Seat 9: Silvaa.10 (26477 in chips) 
Y_NG_X: posts the ante 25
dfcastro.net: posts the ante 25
SSkrelya: posts the ante 25
allinkim09: posts the ante 25
chertas3: posts the ante 25
14129088: posts the ante 25
Victorgd764: posts the ante 25
Silvaa.10: posts the ante 25
Victorgd764: posts small blind 150
Silvaa.10: posts big blind 300
*** HOLE CARDS ***
Dealt to dfcastro.net [Js 4c]
Y_NG_X: folds 
dfcastro.net: folds 
SSkrelya: folds 
allinkim09: folds 
chertas3: folds 
14129088: raises 300 to 600
Victorgd764: calls 450
Silvaa.10: folds 
*** FLOP *** [Qs 4h 9d]
Victorgd764: checks 
14129088: bets 1200
Victorgd764: folds 
Uncalled bet (1200) returned to 14129088
14129088 collected 1700 from pot
14129088: doesn't show hand 
*** SUMMARY ***
Total pot 1700 | Rake 0 
Board [Qs 4h 9d]
Seat 1: Y_NG_X folded before Flop (didn't bet)
Seat 2: dfcastro.net folded before Flop (didn't bet)
Seat 3: SSkrelya folded before Flop (didn't bet)
Seat 5: allinkim09 folded before Flop (didn't bet)
Seat 6: chertas3 folded before Flop (didn't bet)
Seat 7: 14129088 (button) collected (1700)
Seat 8: Victorgd764 (small blind) folded on the Flop
Seat 9: Silvaa.10 (big blind) folded before Flop



PokerStars Hand #100388416773: Tournament #750518676, $0.23+$0.02 USD Hold'em No Limit - Level VIII (150/300) - 2013/06/21 21:34:37 BRT [2013/06/21 20:34:37 ET]
Table '750518676 2' 9-max Seat #8 is the button
Seat 1: Y_NG_X (4605 in chips) 
Seat 2: dfcastro.net (3495 in chips) 
Seat 3: SSkrelya (2845 in chips) 
Seat 5: allinkim09 (3220 in chips) 
Seat 6: chertas3 (4506 in chips) 
Seat 7: 14129088 (9968 in chips) 
Seat 8: Victorgd764 (12709 in chips) 
Seat 9: Silvaa.10 (26152 in chips) 
Y_NG_X: posts the ante 25
dfcastro.net: posts the ante 25
SSkrelya: posts the ante 25
allinkim09: posts the ante 25
chertas3: posts the ante 25
14129088: posts the ante 25
Victorgd764: posts the ante 25
Silvaa.10: posts the ante 25
Silvaa.10: posts small blind 150
Y_NG_X: posts big blind 300
*** HOLE CARDS ***
Dealt to dfcastro.net [Ks Ac]
dfcastro.net: raises 3170 to 3470 and is all-in
SSkrelya: folds 
allinkim09: folds 
chertas3: folds 
14129088: folds 
Victorgd764: folds 
Silvaa.10: folds 
Y_NG_X: folds 
Uncalled bet (3170) returned to dfcastro.net
dfcastro.net collected 950 from pot
dfcastro.net: doesn't show hand 
*** SUMMARY ***
Total pot 950 | Rake 0 
Seat 1: Y_NG_X (big blind) folded before Flop
Seat 2: dfcastro.net collected (950)
Seat 3: SSkrelya folded before Flop (didn't bet)
Seat 5: allinkim09 folded before Flop (didn't bet)
Seat 6: chertas3 folded before Flop (didn't bet)
Seat 7: 14129088 folded before Flop (didn't bet)
Seat 8: Victorgd764 (button) folded before Flop (didn't bet)
Seat 9: Silvaa.10 (small blind) folded before Flop



PokerStars Hand #100388443661: Tournament #750518676, $0.23+$0.02 USD Hold'em No Limit - Level VIII (150/300) - 2013/06/21 21:35:32 BRT [2013/06/21 20:35:32 ET]
Table '750518676 2' 9-max Seat #9 is the button
Seat 1: Y_NG_X (4280 in chips) 
Seat 2: dfcastro.net (4120 in chips) 
Seat 3: SSkrelya (2820 in chips) 
Seat 5: allinkim09 (3195 in chips) 
Seat 6: chertas3 (4481 in chips) 
Seat 7: 14129088 (9943 in chips) 
Seat 8: Victorgd764 (12684 in chips) 
Seat 9: Silvaa.10 (25977 in chips) 
Y_NG_X: posts the ante 25
dfcastro.net: posts the ante 25
SSkrelya: posts the ante 25
allinkim09: posts the ante 25
chertas3: posts the ante 25
14129088: posts the ante 25
Victorgd764: posts the ante 25
Silvaa.10: posts the ante 25
Y_NG_X: posts small blind 150
dfcastro.net: posts big blind 300
*** HOLE CARDS ***
Dealt to dfcastro.net [4s Tc]
SSkrelya: folds 
allinkim09: folds 
chertas3: folds 
14129088: folds 
Victorgd764: folds 
Silvaa.10: folds 
Y_NG_X: calls 150
dfcastro.net: checks 
*** FLOP *** [6s 4d 8h]
Y_NG_X: checks 
dfcastro.net: checks 
*** TURN *** [6s 4d 8h] [8d]
Y_NG_X: checks 
dfcastro.net: checks 
*** RIVER *** [6s 4d 8h 8d] [3d]
Y_NG_X: bets 300
dfcastro.net: folds 
Uncalled bet (300) returned to Y_NG_X
Y_NG_X collected 800 from pot
*** SUMMARY ***
Total pot 800 | Rake 0 
Board [6s 4d 8h 8d 3d]
Seat 1: Y_NG_X (small blind) collected (800)
Seat 2: dfcastro.net (big blind) folded on the River
Seat 3: SSkrelya folded before Flop (didn't bet)
Seat 5: allinkim09 folded before Flop (didn't bet)
Seat 6: chertas3 folded before Flop (didn't bet)
Seat 7: 14129088 folded before Flop (didn't bet)
Seat 8: Victorgd764 folded before Flop (didn't bet)
Seat 9: Silvaa.10 (button) folded before Flop (didn't bet)



PokerStars Hand #100388468314: Tournament #750518676, $0.23+$0.02 USD Hold'em No Limit - Level VIII (150/300) - 2013/06/21 21:36:22 BRT [2013/06/21 20:36:22 ET]
Table '750518676 2' 9-max Seat #1 is the button
Seat 1: Y_NG_X (4755 in chips) 
Seat 2: dfcastro.net (3795 in chips) 
Seat 3: SSkrelya (2795 in chips) 
Seat 5: allinkim09 (3170 in chips) 
Seat 6: chertas3 (4456 in chips) 
Seat 7: 14129088 (9918 in chips) 
Seat 8: Victorgd764 (12659 in chips) 
Seat 9: Silvaa.10 (25952 in chips) 
Y_NG_X: posts the ante 25
dfcastro.net: posts the ante 25
SSkrelya: posts the ante 25
allinkim09: posts the ante 25
chertas3: posts the ante 25
14129088: posts the ante 25
Victorgd764: posts the ante 25
Silvaa.10: posts the ante 25
dfcastro.net: posts small blind 150
SSkrelya: posts big blind 300
*** HOLE CARDS ***
Dealt to dfcastro.net [9h 9d]
allinkim09: folds 
chertas3: folds 
14129088: folds 
Victorgd764: folds 
Silvaa.10: raises 900 to 1200
Y_NG_X: folds 
dfcastro.net: raises 2570 to 3770 and is all-in
SSkrelya: folds 
Silvaa.10: folds 
Uncalled bet (2570) returned to dfcastro.net
dfcastro.net collected 2900 from pot
dfcastro.net: doesn't show hand 
*** SUMMARY ***
Total pot 2900 | Rake 0 
Seat 1: Y_NG_X (button) folded before Flop (didn't bet)
Seat 2: dfcastro.net (small blind) collected (2900)
Seat 3: SSkrelya (big blind) folded before Flop
Seat 5: allinkim09 folded before Flop (didn't bet)
Seat 6: chertas3 folded before Flop (didn't bet)
Seat 7: 14129088 folded before Flop (didn't bet)
Seat 8: Victorgd764 folded before Flop (didn't bet)
Seat 9: Silvaa.10 folded before Flop



PokerStars Hand #100388492906: Tournament #750518676, $0.23+$0.02 USD Hold'em No Limit - Level VIII (150/300) - 2013/06/21 21:37:13 BRT [2013/06/21 20:37:13 ET]
Table '750518676 2' 9-max Seat #2 is the button
Seat 1: Y_NG_X (4730 in chips) 
Seat 2: dfcastro.net (5470 in chips) 
Seat 3: SSkrelya (2470 in chips) 
Seat 5: allinkim09 (3145 in chips) 
Seat 6: chertas3 (4431 in chips) 
Seat 7: 14129088 (9893 in chips) 
Seat 8: Victorgd764 (12634 in chips) 
Seat 9: Silvaa.10 (24727 in chips) 
Y_NG_X: posts the ante 25
dfcastro.net: posts the ante 25
SSkrelya: posts the ante 25
allinkim09: posts the ante 25
chertas3: posts the ante 25
14129088: posts the ante 25
Victorgd764: posts the ante 25
Silvaa.10: posts the ante 25
SSkrelya: posts small blind 150
allinkim09: posts big blind 300
*** HOLE CARDS ***
Dealt to dfcastro.net [8s Qh]
chertas3: folds 
14129088: raises 600 to 900
Victorgd764: folds 
Silvaa.10: folds 
Y_NG_X: folds 
dfcastro.net: folds 
SSkrelya: folds 
allinkim09: calls 600
*** FLOP *** [6d 4h 5s]
allinkim09: checks 
14129088: bets 1800
allinkim09: folds 
Uncalled bet (1800) returned to 14129088
14129088 collected 2150 from pot
14129088: doesn't show hand 
*** SUMMARY ***
Total pot 2150 | Rake 0 
Board [6d 4h 5s]
Seat 1: Y_NG_X folded before Flop (didn't bet)
Seat 2: dfcastro.net (button) folded before Flop (didn't bet)
Seat 3: SSkrelya (small blind) folded before Flop
Seat 5: allinkim09 (big blind) folded on the Flop
Seat 6: chertas3 folded before Flop (didn't bet)
Seat 7: 14129088 collected (2150)
Seat 8: Victorgd764 folded before Flop (didn't bet)
Seat 9: Silvaa.10 folded before Flop (didn't bet)



PokerStars Hand #100388510948: Tournament #750518676, $0.23+$0.02 USD Hold'em No Limit - Level IX (200/400) - 2013/06/21 21:37:50 BRT [2013/06/21 20:37:50 ET]
Table '750518676 2' 9-max Seat #3 is the button
Seat 1: Y_NG_X (4705 in chips) 
Seat 2: dfcastro.net (5445 in chips) 
Seat 3: SSkrelya (2295 in chips) 
Seat 5: allinkim09 (2220 in chips) 
Seat 6: chertas3 (4406 in chips) 
Seat 7: 14129088 (11118 in chips) 
Seat 8: Victorgd764 (12609 in chips) 
Seat 9: Silvaa.10 (24702 in chips) 
Y_NG_X: posts the ante 25
dfcastro.net: posts the ante 25
SSkrelya: posts the ante 25
allinkim09: posts the ante 25
chertas3: posts the ante 25
14129088: posts the ante 25
Victorgd764: posts the ante 25
Silvaa.10: posts the ante 25
allinkim09: posts small blind 200
chertas3: posts big blind 400
*** HOLE CARDS ***
Dealt to dfcastro.net [Qh Th]
14129088: folds 
Victorgd764: folds 
Silvaa.10: raises 1200 to 1600
Y_NG_X: folds 
dfcastro.net: folds 
SSkrelya: folds 
allinkim09: folds 
chertas3: folds 
Uncalled bet (1200) returned to Silvaa.10
Silvaa.10 collected 1200 from pot
*** SUMMARY ***
Total pot 1200 | Rake 0 
Seat 1: Y_NG_X folded before Flop (didn't bet)
Seat 2: dfcastro.net folded before Flop (didn't bet)
Seat 3: SSkrelya (button) folded before Flop (didn't bet)
Seat 5: allinkim09 (small blind) folded before Flop
Seat 6: chertas3 (big blind) folded before Flop
Seat 7: 14129088 folded before Flop (didn't bet)
Seat 8: Victorgd764 folded before Flop (didn't bet)
Seat 9: Silvaa.10 collected (1200)



PokerStars Hand #100388519303: Tournament #750518676, $0.23+$0.02 USD Hold'em No Limit - Level IX (200/400) - 2013/06/21 21:38:07 BRT [2013/06/21 20:38:07 ET]
Table '750518676 2' 9-max Seat #5 is the button
Seat 1: Y_NG_X (4680 in chips) 
Seat 2: dfcastro.net (5420 in chips) 
Seat 3: SSkrelya (2270 in chips) 
Seat 5: allinkim09 (1995 in chips) 
Seat 6: chertas3 (3981 in chips) 
Seat 7: 14129088 (11093 in chips) 
Seat 8: Victorgd764 (12584 in chips) 
Seat 9: Silvaa.10 (25477 in chips) 
Y_NG_X: posts the ante 25
dfcastro.net: posts the ante 25
SSkrelya: posts the ante 25
allinkim09: posts the ante 25
chertas3: posts the ante 25
14129088: posts the ante 25
Victorgd764: posts the ante 25
Silvaa.10: posts the ante 25
chertas3: posts small blind 200
14129088: posts big blind 400
*** HOLE CARDS ***
Dealt to dfcastro.net [8c 6d]
Victorgd764: folds 
Silvaa.10: folds 
Y_NG_X: folds 
dfcastro.net: folds 
SSkrelya: folds 
allinkim09: raises 1570 to 1970 and is all-in
chertas3: folds 
14129088: calls 1570
*** FLOP *** [Kc 7s 9c]
*** TURN *** [Kc 7s 9c] [6s]
*** RIVER *** [Kc 7s 9c 6s] [Ts]
*** SHOW DOWN ***
14129088: shows [3c Kh] (a pair of Kings)
allinkim09: shows [Jd Ac] (high card Ace)
14129088 collected 4340 from pot
allinkim09 finished the tournament in 8th place
*** SUMMARY ***
Total pot 4340 | Rake 0 
Board [Kc 7s 9c 6s Ts]
Seat 1: Y_NG_X folded before Flop (didn't bet)
Seat 2: dfcastro.net folded before Flop (didn't bet)
Seat 3: SSkrelya folded before Flop (didn't bet)
Seat 5: allinkim09 (button) showed [Jd Ac] and lost with high card Ace
Seat 6: chertas3 (small blind) folded before Flop
Seat 7: 14129088 (big blind) showed [3c Kh] and won (4340) with a pair of Kings
Seat 8: Victorgd764 folded before Flop (didn't bet)
Seat 9: Silvaa.10 folded before Flop (didn't bet)



PokerStars Hand #100388530266: Tournament #750518676, $0.23+$0.02 USD Hold'em No Limit - Level IX (200/400) - 2013/06/21 21:38:30 BRT [2013/06/21 20:38:30 ET]
Table '750518676 2' 9-max Seat #6 is the button
Seat 1: Y_NG_X (4655 in chips) 
Seat 2: dfcastro.net (5395 in chips) 
Seat 3: SSkrelya (2245 in chips) 
Seat 6: chertas3 (3756 in chips) 
Seat 7: 14129088 (13438 in chips) 
Seat 8: Victorgd764 (12559 in chips) 
Seat 9: Silvaa.10 (25452 in chips) 
Y_NG_X: posts the ante 25
dfcastro.net: posts the ante 25
SSkrelya: posts the ante 25
chertas3: posts the ante 25
14129088: posts the ante 25
Victorgd764: posts the ante 25
Silvaa.10: posts the ante 25
14129088: posts small blind 200
Victorgd764: posts big blind 400
*** HOLE CARDS ***
Dealt to dfcastro.net [8c 6h]
Silvaa.10: folds 
Y_NG_X: folds 
dfcastro.net: folds 
SSkrelya: folds 
chertas3: folds 
14129088: raises 400 to 800
Victorgd764: calls 400
*** FLOP *** [Td Qs 9d]
14129088: bets 1200
Victorgd764: calls 1200
*** TURN *** [Td Qs 9d] [Ah]
14129088: checks 
Victorgd764: bets 1200
14129088: folds 
Uncalled bet (1200) returned to Victorgd764
Victorgd764 collected 4175 from pot
*** SUMMARY ***
Total pot 4175 | Rake 0 
Board [Td Qs 9d Ah]
Seat 1: Y_NG_X folded before Flop (didn't bet)
Seat 2: dfcastro.net folded before Flop (didn't bet)
Seat 3: SSkrelya folded before Flop (didn't bet)
Seat 6: chertas3 (button) folded before Flop (didn't bet)
Seat 7: 14129088 (small blind) folded on the Turn
Seat 8: Victorgd764 (big blind) collected (4175)
Seat 9: Silvaa.10 folded before Flop (didn't bet)



PokerStars Hand #100388548774: Tournament #750518676, $0.23+$0.02 USD Hold'em No Limit - Level IX (200/400) - 2013/06/21 21:39:09 BRT [2013/06/21 20:39:09 ET]
Table '750518676 2' 9-max Seat #7 is the button
Seat 1: Y_NG_X (4630 in chips) 
Seat 2: dfcastro.net (5370 in chips) 
Seat 3: SSkrelya (2220 in chips) 
Seat 6: chertas3 (3731 in chips) 
Seat 7: 14129088 (11413 in chips) 
Seat 8: Victorgd764 (14709 in chips) 
Seat 9: Silvaa.10 (25427 in chips) 
Y_NG_X: posts the ante 25
dfcastro.net: posts the ante 25
SSkrelya: posts the ante 25
chertas3: posts the ante 25
14129088: posts the ante 25
Victorgd764: posts the ante 25
Silvaa.10: posts the ante 25
Victorgd764: posts small blind 200
Silvaa.10: posts big blind 400
*** HOLE CARDS ***
Dealt to dfcastro.net [9d Jc]
Y_NG_X: folds 
Victorgd764 said, "vamo brazil"
dfcastro.net: folds 
Silvaa.10 said, "vamooooooo brasil"
SSkrelya: raises 1795 to 2195 and is all-in
chertas3: folds 
14129088: folds 
Victorgd764: folds 
Silvaa.10: folds 
Uncalled bet (1795) returned to SSkrelya
SSkrelya collected 1175 from pot
*** SUMMARY ***
Total pot 1175 | Rake 0 
Seat 1: Y_NG_X folded before Flop (didn't bet)
Seat 2: dfcastro.net folded before Flop (didn't bet)
Seat 3: SSkrelya collected (1175)
Seat 6: chertas3 folded before Flop (didn't bet)
Seat 7: 14129088 (button) folded before Flop (didn't bet)
Seat 8: Victorgd764 (small blind) folded before Flop
Seat 9: Silvaa.10 (big blind) folded before Flop



PokerStars Hand #100388564900: Tournament #750518676, $0.23+$0.02 USD Hold'em No Limit - Level IX (200/400) - 2013/06/21 21:39:42 BRT [2013/06/21 20:39:42 ET]
Table '750518676 2' 9-max Seat #8 is the button
Seat 1: Y_NG_X (4605 in chips) 
Seat 2: dfcastro.net (5345 in chips) 
Seat 3: SSkrelya (2970 in chips) 
Seat 6: chertas3 (3706 in chips) 
Seat 7: 14129088 (11388 in chips) 
Seat 8: Victorgd764 (14484 in chips) 
Seat 9: Silvaa.10 (25002 in chips) 
Y_NG_X: posts the ante 25
dfcastro.net: posts the ante 25
SSkrelya: posts the ante 25
chertas3: posts the ante 25
14129088: posts the ante 25
Victorgd764: posts the ante 25
Silvaa.10: posts the ante 25
Silvaa.10: posts small blind 200
Y_NG_X: posts big blind 400
*** HOLE CARDS ***
Dealt to dfcastro.net [Js 4s]
Victorgd764 said, "vamo detona esses gringo ae"
dfcastro.net: folds 
SSkrelya: folds 
chertas3: folds 
Silvaa.10 said, "boraaaaaaa"
14129088: raises 400 to 800
Victorgd764: folds 
Silvaa.10: folds 
Y_NG_X: calls 400
*** FLOP *** [2d Ts 7d]
Y_NG_X: checks 
14129088: bets 1200
Y_NG_X: folds 
Uncalled bet (1200) returned to 14129088
14129088 collected 1975 from pot
14129088: doesn't show hand 
*** SUMMARY ***
Total pot 1975 | Rake 0 
Board [2d Ts 7d]
Seat 1: Y_NG_X (big blind) folded on the Flop
Seat 2: dfcastro.net folded before Flop (didn't bet)
Seat 3: SSkrelya folded before Flop (didn't bet)
Seat 6: chertas3 folded before Flop (didn't bet)
Seat 7: 14129088 collected (1975)
Seat 8: Victorgd764 (button) folded before Flop (didn't bet)
Seat 9: Silvaa.10 (small blind) folded before Flop



PokerStars Hand #100388580371: Tournament #750518676, $0.23+$0.02 USD Hold'em No Limit - Level IX (200/400) - 2013/06/21 21:40:14 BRT [2013/06/21 20:40:14 ET]
Table '750518676 2' 9-max Seat #9 is the button
Seat 1: Y_NG_X (3780 in chips) 
Seat 2: dfcastro.net (5320 in chips) 
Seat 3: SSkrelya (2945 in chips) 
Seat 6: chertas3 (3681 in chips) 
Seat 7: 14129088 (12538 in chips) 
Seat 8: Victorgd764 (14459 in chips) 
Seat 9: Silvaa.10 (24777 in chips) 
Y_NG_X: posts the ante 25
dfcastro.net: posts the ante 25
SSkrelya: posts the ante 25
chertas3: posts the ante 25
14129088: posts the ante 25
Victorgd764: posts the ante 25
Silvaa.10: posts the ante 25
Y_NG_X: posts small blind 200
dfcastro.net: posts big blind 400
*** HOLE CARDS ***
Dealt to dfcastro.net [2c 6d]
SSkrelya: folds 
chertas3: raises 3256 to 3656 and is all-in
14129088: folds 
Victorgd764: folds 
Silvaa.10: folds 
Y_NG_X: folds 
dfcastro.net: folds 
Uncalled bet (3256) returned to chertas3
chertas3 collected 1175 from pot
chertas3: doesn't show hand 
*** SUMMARY ***
Total pot 1175 | Rake 0 
Seat 1: Y_NG_X (small blind) folded before Flop
Seat 2: dfcastro.net (big blind) folded before Flop
Seat 3: SSkrelya folded before Flop (didn't bet)
Seat 6: chertas3 collected (1175)
Seat 7: 14129088 folded before Flop (didn't bet)
Seat 8: Victorgd764 folded before Flop (didn't bet)
Seat 9: Silvaa.10 (button) folded before Flop (didn't bet)



PokerStars Hand #100388588638: Tournament #750518676, $0.23+$0.02 USD Hold'em No Limit - Level IX (200/400) - 2013/06/21 21:40:32 BRT [2013/06/21 20:40:32 ET]
Table '750518676 2' 9-max Seat #1 is the button
Seat 1: Y_NG_X (3555 in chips) 
Seat 2: dfcastro.net (4895 in chips) 
Seat 3: SSkrelya (2920 in chips) 
Seat 6: chertas3 (4431 in chips) 
Seat 7: 14129088 (12513 in chips) 
Seat 8: Victorgd764 (14434 in chips) 
Seat 9: Silvaa.10 (24752 in chips) 
Y_NG_X: posts the ante 25
dfcastro.net: posts the ante 25
SSkrelya: posts the ante 25
chertas3: posts the ante 25
14129088: posts the ante 25
Victorgd764: posts the ante 25
Silvaa.10: posts the ante 25
dfcastro.net: posts small blind 200
SSkrelya: posts big blind 400
*** HOLE CARDS ***
Dealt to dfcastro.net [2h Js]
chertas3: folds 
14129088: folds 
Victorgd764: folds 
Silvaa.10: folds 
Y_NG_X: folds 
dfcastro.net: folds 
Uncalled bet (200) returned to SSkrelya
SSkrelya collected 575 from pot
SSkrelya: shows [Ac Ad] (a pair of Aces)
*** SUMMARY ***
Total pot 575 | Rake 0 
Seat 1: Y_NG_X (button) folded before Flop (didn't bet)
Seat 2: dfcastro.net (small blind) folded before Flop
Seat 3: SSkrelya (big blind) collected (575)
Seat 6: chertas3 folded before Flop (didn't bet)
Seat 7: 14129088 folded before Flop (didn't bet)
Seat 8: Victorgd764 folded before Flop (didn't bet)
Seat 9: Silvaa.10 folded before Flop (didn't bet)



PokerStars Hand #100388601146: Tournament #750518676, $0.23+$0.02 USD Hold'em No Limit - Level IX (200/400) - 2013/06/21 21:40:58 BRT [2013/06/21 20:40:58 ET]
Table '750518676 2' 9-max Seat #2 is the button
Seat 1: Y_NG_X (3530 in chips) 
Seat 2: dfcastro.net (4670 in chips) 
Seat 3: SSkrelya (3270 in chips) 
Seat 6: chertas3 (4406 in chips) 
Seat 7: 14129088 (12488 in chips) 
Seat 8: Victorgd764 (14409 in chips) 
Seat 9: Silvaa.10 (24727 in chips) 
Y_NG_X: posts the ante 25
dfcastro.net: posts the ante 25
SSkrelya: posts the ante 25
chertas3: posts the ante 25
14129088: posts the ante 25
Victorgd764: posts the ante 25
Silvaa.10: posts the ante 25
SSkrelya: posts small blind 200
chertas3: posts big blind 400
*** HOLE CARDS ***
Dealt to dfcastro.net [Td 2c]
14129088: folds 
Victorgd764: raises 400 to 800
Silvaa.10: folds 
Y_NG_X: folds 
dfcastro.net: folds 
SSkrelya: folds 
chertas3: folds 
Uncalled bet (400) returned to Victorgd764
Victorgd764 collected 1175 from pot
*** SUMMARY ***
Total pot 1175 | Rake 0 
Seat 1: Y_NG_X folded before Flop (didn't bet)
Seat 2: dfcastro.net (button) folded before Flop (didn't bet)
Seat 3: SSkrelya (small blind) folded before Flop
Seat 6: chertas3 (big blind) folded before Flop
Seat 7: 14129088 folded before Flop (didn't bet)
Seat 8: Victorgd764 collected (1175)
Seat 9: Silvaa.10 folded before Flop (didn't bet)



PokerStars Hand #100388617133: Tournament #750518676, $0.23+$0.02 USD Hold'em No Limit - Level IX (200/400) - 2013/06/21 21:41:32 BRT [2013/06/21 20:41:32 ET]
Table '750518676 2' 9-max Seat #3 is the button
Seat 1: Y_NG_X (3505 in chips) 
Seat 2: dfcastro.net (4645 in chips) 
Seat 3: SSkrelya (3045 in chips) 
Seat 6: chertas3 (3981 in chips) 
Seat 7: 14129088 (12463 in chips) 
Seat 8: Victorgd764 (15159 in chips) 
Seat 9: Silvaa.10 (24702 in chips) 
Y_NG_X: posts the ante 25
dfcastro.net: posts the ante 25
SSkrelya: posts the ante 25
chertas3: posts the ante 25
14129088: posts the ante 25
Victorgd764: posts the ante 25
Silvaa.10: posts the ante 25
chertas3: posts small blind 200
14129088: posts big blind 400
*** HOLE CARDS ***
Dealt to dfcastro.net [2s 4h]
Victorgd764: folds 
Silvaa.10: folds 
Y_NG_X: folds 
dfcastro.net: folds 
SSkrelya: raises 2620 to 3020 and is all-in
chertas3: folds 
14129088: folds 
Uncalled bet (2620) returned to SSkrelya
SSkrelya collected 1175 from pot
*** SUMMARY ***
Total pot 1175 | Rake 0 
Seat 1: Y_NG_X folded before Flop (didn't bet)
Seat 2: dfcastro.net folded before Flop (didn't bet)
Seat 3: SSkrelya (button) collected (1175)
Seat 6: chertas3 (small blind) folded before Flop
Seat 7: 14129088 (big blind) folded before Flop
Seat 8: Victorgd764 folded before Flop (didn't bet)
Seat 9: Silvaa.10 folded before Flop (didn't bet)



PokerStars Hand #100388627722: Tournament #750518676, $0.23+$0.02 USD Hold'em No Limit - Level IX (200/400) - 2013/06/21 21:41:54 BRT [2013/06/21 20:41:54 ET]
Table '750518676 2' 9-max Seat #6 is the button
Seat 1: Y_NG_X (3480 in chips) 
Seat 2: dfcastro.net (4620 in chips) 
Seat 3: SSkrelya (3795 in chips) 
Seat 6: chertas3 (3756 in chips) 
Seat 7: 14129088 (12038 in chips) 
Seat 8: Victorgd764 (15134 in chips) 
Seat 9: Silvaa.10 (24677 in chips) 
Y_NG_X: posts the ante 25
dfcastro.net: posts the ante 25
SSkrelya: posts the ante 25
chertas3: posts the ante 25
14129088: posts the ante 25
Victorgd764: posts the ante 25
Silvaa.10: posts the ante 25
14129088: posts small blind 200
Victorgd764: posts big blind 400
*** HOLE CARDS ***
Dealt to dfcastro.net [Td 5d]
Silvaa.10: raises 400 to 800
Y_NG_X: folds 
dfcastro.net: folds 
SSkrelya: folds 
chertas3: folds 
14129088: folds 
Victorgd764: folds 
Uncalled bet (400) returned to Silvaa.10
Silvaa.10 collected 1175 from pot
*** SUMMARY ***
Total pot 1175 | Rake 0 
Seat 1: Y_NG_X folded before Flop (didn't bet)
Seat 2: dfcastro.net folded before Flop (didn't bet)
Seat 3: SSkrelya folded before Flop (didn't bet)
Seat 6: chertas3 (button) folded before Flop (didn't bet)
Seat 7: 14129088 (small blind) folded before Flop
Seat 8: Victorgd764 (big blind) folded before Flop
Seat 9: Silvaa.10 collected (1175)



PokerStars Hand #100388637607: Tournament #750518676, $0.23+$0.02 USD Hold'em No Limit - Level IX (200/400) - 2013/06/21 21:42:15 BRT [2013/06/21 20:42:15 ET]
Table '750518676 2' 9-max Seat #7 is the button
Seat 1: Y_NG_X (3455 in chips) 
Seat 2: dfcastro.net (4595 in chips) 
Seat 3: SSkrelya (3770 in chips) 
Seat 6: chertas3 (3731 in chips) 
Seat 7: 14129088 (11813 in chips) 
Seat 8: Victorgd764 (14709 in chips) 
Seat 9: Silvaa.10 (25427 in chips) 
Y_NG_X: posts the ante 25
dfcastro.net: posts the ante 25
SSkrelya: posts the ante 25
chertas3: posts the ante 25
14129088: posts the ante 25
Victorgd764: posts the ante 25
Silvaa.10: posts the ante 25
Victorgd764: posts small blind 200
Silvaa.10: posts big blind 400
*** HOLE CARDS ***
Dealt to dfcastro.net [4s 3h]
Y_NG_X: folds 
dfcastro.net: folds 
SSkrelya: folds 
chertas3: folds 
14129088: raises 400 to 800
Victorgd764: folds 
Silvaa.10: folds 
Uncalled bet (400) returned to 14129088
14129088 collected 1175 from pot
14129088: doesn't show hand 
*** SUMMARY ***
Total pot 1175 | Rake 0 
Seat 1: Y_NG_X folded before Flop (didn't bet)
Seat 2: dfcastro.net folded before Flop (didn't bet)
Seat 3: SSkrelya folded before Flop (didn't bet)
Seat 6: chertas3 folded before Flop (didn't bet)
Seat 7: 14129088 (button) collected (1175)
Seat 8: Victorgd764 (small blind) folded before Flop
Seat 9: Silvaa.10 (big blind) folded before Flop



PokerStars Hand #100388646854: Tournament #750518676, $0.23+$0.02 USD Hold'em No Limit - Level IX (200/400) - 2013/06/21 21:42:35 BRT [2013/06/21 20:42:35 ET]
Table '750518676 2' 9-max Seat #8 is the button
Seat 1: Y_NG_X (3430 in chips) 
Seat 2: dfcastro.net (4570 in chips) 
Seat 3: SSkrelya (3745 in chips) 
Seat 6: chertas3 (3706 in chips) 
Seat 7: 14129088 (12563 in chips) 
Seat 8: Victorgd764 (14484 in chips) 
Seat 9: Silvaa.10 (25002 in chips) 
Y_NG_X: posts the ante 25
dfcastro.net: posts the ante 25
SSkrelya: posts the ante 25
chertas3: posts the ante 25
14129088: posts the ante 25
Victorgd764: posts the ante 25
Silvaa.10: posts the ante 25
Silvaa.10: posts small blind 200
Y_NG_X: posts big blind 400
*** HOLE CARDS ***
Dealt to dfcastro.net [5s 6s]
dfcastro.net: folds 
SSkrelya: raises 3320 to 3720 and is all-in
chertas3: folds 
14129088: folds 
Victorgd764: folds 
Silvaa.10: folds 
Y_NG_X: folds 
Uncalled bet (3320) returned to SSkrelya
SSkrelya collected 1175 from pot
SSkrelya: doesn't show hand 
*** SUMMARY ***
Total pot 1175 | Rake 0 
Seat 1: Y_NG_X (big blind) folded before Flop
Seat 2: dfcastro.net folded before Flop (didn't bet)
Seat 3: SSkrelya collected (1175)
Seat 6: chertas3 folded before Flop (didn't bet)
Seat 7: 14129088 folded before Flop (didn't bet)
Seat 8: Victorgd764 (button) folded before Flop (didn't bet)
Seat 9: Silvaa.10 (small blind) folded before Flop



PokerStars Hand #100388659209: Tournament #750518676, $0.23+$0.02 USD Hold'em No Limit - Level IX (200/400) - 2013/06/21 21:43:01 BRT [2013/06/21 20:43:01 ET]
Table '750518676 2' 9-max Seat #9 is the button
Seat 1: Y_NG_X (3005 in chips) 
Seat 2: dfcastro.net (4545 in chips) 
Seat 3: SSkrelya (4495 in chips) 
Seat 6: chertas3 (3681 in chips) 
Seat 7: 14129088 (12538 in chips) 
Seat 8: Victorgd764 (14459 in chips) 
Seat 9: Silvaa.10 (24777 in chips) 
Y_NG_X: posts the ante 25
dfcastro.net: posts the ante 25
SSkrelya: posts the ante 25
chertas3: posts the ante 25
14129088: posts the ante 25
Victorgd764: posts the ante 25
Silvaa.10: posts the ante 25
Y_NG_X: posts small blind 200
dfcastro.net: posts big blind 400
*** HOLE CARDS ***
Dealt to dfcastro.net [Jh 4c]
SSkrelya: folds 
chertas3: folds 
14129088: folds 
Victorgd764: folds 
Silvaa.10: calls 400
Y_NG_X: folds 
dfcastro.net: checks 
*** FLOP *** [Ah Ks 4d]
dfcastro.net: checks 
Silvaa.10: bets 800
dfcastro.net: folds 
Uncalled bet (800) returned to Silvaa.10
Silvaa.10 collected 1175 from pot
*** SUMMARY ***
Total pot 1175 | Rake 0 
Board [Ah Ks 4d]
Seat 1: Y_NG_X (small blind) folded before Flop
Seat 2: dfcastro.net (big blind) folded on the Flop
Seat 3: SSkrelya folded before Flop (didn't bet)
Seat 6: chertas3 folded before Flop (didn't bet)
Seat 7: 14129088 folded before Flop (didn't bet)
Seat 8: Victorgd764 folded before Flop (didn't bet)
Seat 9: Silvaa.10 (button) collected (1175)



PokerStars Hand #100388672902: Tournament #750518676, $0.23+$0.02 USD Hold'em No Limit - Level IX (200/400) - 2013/06/21 21:43:31 BRT [2013/06/21 20:43:31 ET]
Table '750518676 2' 9-max Seat #1 is the button
Seat 1: Y_NG_X (2780 in chips) 
Seat 2: dfcastro.net (4120 in chips) 
Seat 3: SSkrelya (4470 in chips) 
Seat 6: chertas3 (3656 in chips) 
Seat 7: 14129088 (12513 in chips) 
Seat 8: Victorgd764 (14434 in chips) 
Seat 9: Silvaa.10 (25527 in chips) 
Y_NG_X: posts the ante 25
dfcastro.net: posts the ante 25
SSkrelya: posts the ante 25
chertas3: posts the ante 25
14129088: posts the ante 25
Victorgd764: posts the ante 25
Silvaa.10: posts the ante 25
dfcastro.net: posts small blind 200
SSkrelya: posts big blind 400
*** HOLE CARDS ***
Dealt to dfcastro.net [6d As]
chertas3: folds 
14129088: folds 
Victorgd764: raises 400 to 800
Silvaa.10: folds 
Y_NG_X: folds 
dfcastro.net: calls 600
SSkrelya: folds 
*** FLOP *** [2h 8h 4h]
dfcastro.net: checks 
Victorgd764: bets 1200
dfcastro.net: folds 
Uncalled bet (1200) returned to Victorgd764
Victorgd764 collected 2175 from pot
*** SUMMARY ***
Total pot 2175 | Rake 0 
Board [2h 8h 4h]
Seat 1: Y_NG_X (button) folded before Flop (didn't bet)
Seat 2: dfcastro.net (small blind) folded on the Flop
Seat 3: SSkrelya (big blind) folded before Flop
Seat 6: chertas3 folded before Flop (didn't bet)
Seat 7: 14129088 folded before Flop (didn't bet)
Seat 8: Victorgd764 collected (2175)
Seat 9: Silvaa.10 folded before Flop (didn't bet)



PokerStars Hand #100388691043: Tournament #750518676, $0.23+$0.02 USD Hold'em No Limit - Level IX (200/400) - 2013/06/21 21:44:09 BRT [2013/06/21 20:44:09 ET]
Table '750518676 2' 9-max Seat #2 is the button
Seat 1: Y_NG_X (2755 in chips) 
Seat 2: dfcastro.net (3295 in chips) 
Seat 3: SSkrelya (4045 in chips) 
Seat 6: chertas3 (3631 in chips) 
Seat 7: 14129088 (12488 in chips) 
Seat 8: Victorgd764 (15784 in chips) 
Seat 9: Silvaa.10 (25502 in chips) 
Y_NG_X: posts the ante 25
dfcastro.net: posts the ante 25
SSkrelya: posts the ante 25
chertas3: posts the ante 25
14129088: posts the ante 25
Victorgd764: posts the ante 25
Silvaa.10: posts the ante 25
SSkrelya: posts small blind 200
chertas3: posts big blind 400
*** HOLE CARDS ***
Dealt to dfcastro.net [Kh 3s]
14129088: calls 400
Victorgd764: folds 
Silvaa.10: calls 400
Y_NG_X: folds 
dfcastro.net: folds 
SSkrelya: folds 
chertas3: checks 
*** FLOP *** [Ks 5h Tc]
chertas3: checks 
14129088: bets 1200
Silvaa.10: folds 
chertas3: folds 
Uncalled bet (1200) returned to 14129088
14129088 collected 1575 from pot
14129088: doesn't show hand 
*** SUMMARY ***
Total pot 1575 | Rake 0 
Board [Ks 5h Tc]
Seat 1: Y_NG_X folded before Flop (didn't bet)
Seat 2: dfcastro.net (button) folded before Flop (didn't bet)
Seat 3: SSkrelya (small blind) folded before Flop
Seat 6: chertas3 (big blind) folded on the Flop
Seat 7: 14129088 collected (1575)
Seat 8: Victorgd764 folded before Flop (didn't bet)
Seat 9: Silvaa.10 folded on the Flop



PokerStars Hand #100388708374: Tournament #750518676, $0.23+$0.02 USD Hold'em No Limit - Level IX (200/400) - 2013/06/21 21:44:47 BRT [2013/06/21 20:44:47 ET]
Table '750518676 2' 9-max Seat #3 is the button
Seat 1: Y_NG_X (2730 in chips) 
Seat 2: dfcastro.net (3270 in chips) 
Seat 3: SSkrelya (3820 in chips) 
Seat 6: chertas3 (3206 in chips) 
Seat 7: 14129088 (13638 in chips) 
Seat 8: Victorgd764 (15759 in chips) 
Seat 9: Silvaa.10 (25077 in chips) 
Y_NG_X: posts the ante 25
dfcastro.net: posts the ante 25
SSkrelya: posts the ante 25
chertas3: posts the ante 25
14129088: posts the ante 25
Victorgd764: posts the ante 25
Silvaa.10: posts the ante 25
chertas3: posts small blind 200
14129088: posts big blind 400
*** HOLE CARDS ***
Dealt to dfcastro.net [3c Ac]
Victorgd764: folds 
Victorgd764 said, "eta povinho duro"
Victorgd764 said, "ninguem aposta"
Victorgd764 said, "aiuhauiahia"
Silvaa.10: folds 
Y_NG_X: folds 
dfcastro.net: folds 
Silvaa.10 said, "neeeee"
SSkrelya: folds 
chertas3: raises 2781 to 3181 and is all-in
14129088: calls 2781
*** FLOP *** [4c 8h Ah]
*** TURN *** [4c 8h Ah] [Jd]
*** RIVER *** [4c 8h Ah Jd] [3s]
*** SHOW DOWN ***
chertas3: shows [8c As] (two pair, Aces and Eights)
14129088: shows [Qd 3d] (a pair of Threes)
chertas3 collected 6537 from pot
*** SUMMARY ***
Total pot 6537 | Rake 0 
Board [4c 8h Ah Jd 3s]
Seat 1: Y_NG_X folded before Flop (didn't bet)
Seat 2: dfcastro.net folded before Flop (didn't bet)
Seat 3: SSkrelya (button) folded before Flop (didn't bet)
Seat 6: chertas3 (small blind) showed [8c As] and won (6537) with two pair, Aces and Eights
Seat 7: 14129088 (big blind) showed [Qd 3d] and lost with a pair of Threes
Seat 8: Victorgd764 folded before Flop (didn't bet)
Seat 9: Silvaa.10 folded before Flop (didn't bet)



PokerStars Hand #100388734352: Tournament #750518676, $0.23+$0.02 USD Hold'em No Limit - Level IX (200/400) - 2013/06/21 21:45:43 BRT [2013/06/21 20:45:43 ET]
Table '750518676 2' 9-max Seat #6 is the button
Seat 1: Y_NG_X (2705 in chips) 
Seat 2: dfcastro.net (3245 in chips) 
Seat 3: SSkrelya (3795 in chips) 
Seat 6: chertas3 (6537 in chips) 
Seat 7: 14129088 (10432 in chips) 
Seat 8: Victorgd764 (15734 in chips) 
Seat 9: Silvaa.10 (25052 in chips) 
Y_NG_X: posts the ante 25
dfcastro.net: posts the ante 25
SSkrelya: posts the ante 25
chertas3: posts the ante 25
14129088: posts the ante 25
Victorgd764: posts the ante 25
Silvaa.10: posts the ante 25
14129088: posts small blind 200
Victorgd764: posts big blind 400
*** HOLE CARDS ***
Dealt to dfcastro.net [Kh 9d]
Silvaa.10: folds 
Y_NG_X: folds 
dfcastro.net: folds 
SSkrelya: folds 
chertas3: folds 
14129088: raises 800 to 1200
Victorgd764: raises 800 to 2000
14129088: folds 
Uncalled bet (800) returned to Victorgd764
Victorgd764 collected 2575 from pot
*** SUMMARY ***
Total pot 2575 | Rake 0 
Seat 1: Y_NG_X folded before Flop (didn't bet)
Seat 2: dfcastro.net folded before Flop (didn't bet)
Seat 3: SSkrelya folded before Flop (didn't bet)
Seat 6: chertas3 (button) folded before Flop (didn't bet)
Seat 7: 14129088 (small blind) folded before Flop
Seat 8: Victorgd764 (big blind) collected (2575)
Seat 9: Silvaa.10 folded before Flop (didn't bet)



PokerStars Hand #100388746516: Tournament #750518676, $0.23+$0.02 USD Hold'em No Limit - Level IX (200/400) - 2013/06/21 21:46:09 BRT [2013/06/21 20:46:09 ET]
Table '750518676 2' 9-max Seat #7 is the button
Seat 1: Y_NG_X (2680 in chips) 
Seat 2: dfcastro.net (3220 in chips) 
Seat 3: SSkrelya (3770 in chips) 
Seat 6: chertas3 (6512 in chips) 
Seat 7: 14129088 (9207 in chips) 
Seat 8: Victorgd764 (17084 in chips) 
Seat 9: Silvaa.10 (25027 in chips) 
Y_NG_X: posts the ante 25
dfcastro.net: posts the ante 25
SSkrelya: posts the ante 25
chertas3: posts the ante 25
14129088: posts the ante 25
Victorgd764: posts the ante 25
Silvaa.10: posts the ante 25
Victorgd764: posts small blind 200
Silvaa.10: posts big blind 400
*** HOLE CARDS ***
Dealt to dfcastro.net [Kd 9s]
Y_NG_X: folds 
dfcastro.net: folds 
SSkrelya: folds 
chertas3: folds 
14129088: folds 
Victorgd764: calls 200
Silvaa.10: checks 
*** FLOP *** [Td Ad Qh]
Victorgd764: checks 
Silvaa.10: checks 
*** TURN *** [Td Ad Qh] [7h]
Victorgd764: checks 
Silvaa.10: checks 
*** RIVER *** [Td Ad Qh 7h] [4s]
Victorgd764: checks 
Silvaa.10: checks 
*** SHOW DOWN ***
Victorgd764: shows [5s Ac] (a pair of Aces)
Silvaa.10: mucks hand 
Victorgd764 collected 975 from pot
*** SUMMARY ***
Total pot 975 | Rake 0 
Board [Td Ad Qh 7h 4s]
Seat 1: Y_NG_X folded before Flop (didn't bet)
Seat 2: dfcastro.net folded before Flop (didn't bet)
Seat 3: SSkrelya folded before Flop (didn't bet)
Seat 6: chertas3 folded before Flop (didn't bet)
Seat 7: 14129088 (button) folded before Flop (didn't bet)
Seat 8: Victorgd764 (small blind) showed [5s Ac] and won (975) with a pair of Aces
Seat 9: Silvaa.10 (big blind) mucked [5c 2d]



PokerStars Hand #100388767353: Tournament #750518676, $0.23+$0.02 USD Hold'em No Limit - Level IX (200/400) - 2013/06/21 21:46:55 BRT [2013/06/21 20:46:55 ET]
Table '750518676 2' 9-max Seat #8 is the button
Seat 1: Y_NG_X (2655 in chips) 
Seat 2: dfcastro.net (3195 in chips) 
Seat 3: SSkrelya (3745 in chips) 
Seat 6: chertas3 (6487 in chips) 
Seat 7: 14129088 (9182 in chips) 
Seat 8: Victorgd764 (17634 in chips) 
Seat 9: Silvaa.10 (24602 in chips) 
Y_NG_X: posts the ante 25
dfcastro.net: posts the ante 25
SSkrelya: posts the ante 25
chertas3: posts the ante 25
14129088: posts the ante 25
Victorgd764: posts the ante 25
Silvaa.10: posts the ante 25
Silvaa.10: posts small blind 200
Y_NG_X: posts big blind 400
*** HOLE CARDS ***
Dealt to dfcastro.net [Qh Kc]
Victorgd764 said, "n quis apostar em vc"
dfcastro.net: folds 
SSkrelya: folds 
Victorgd764 said, "vamo brasilllllllll"
chertas3: folds 
14129088: folds 
Silvaa.10 said, "kkkkkkkkkkkk"
Victorgd764: folds 
Silvaa.10: calls 200
Y_NG_X: checks 
*** FLOP *** [3d 8c 3c]
Silvaa.10: checks 
Y_NG_X: checks 
*** TURN *** [3d 8c 3c] [2s]
Silvaa.10: bets 1600
Y_NG_X: folds 
Uncalled bet (1600) returned to Silvaa.10
Silvaa.10 collected 975 from pot
*** SUMMARY ***
Total pot 975 | Rake 0 
Board [3d 8c 3c 2s]
Seat 1: Y_NG_X (big blind) folded on the Turn
Seat 2: dfcastro.net folded before Flop (didn't bet)
Seat 3: SSkrelya folded before Flop (didn't bet)
Seat 6: chertas3 folded before Flop (didn't bet)
Seat 7: 14129088 folded before Flop (didn't bet)
Seat 8: Victorgd764 (button) folded before Flop (didn't bet)
Seat 9: Silvaa.10 (small blind) collected (975)



PokerStars Hand #100388784885: Tournament #750518676, $0.23+$0.02 USD Hold'em No Limit - Level IX (200/400) - 2013/06/21 21:47:33 BRT [2013/06/21 20:47:33 ET]
Table '750518676 2' 9-max Seat #9 is the button
Seat 1: Y_NG_X (2230 in chips) 
Seat 2: dfcastro.net (3170 in chips) 
Seat 3: SSkrelya (3720 in chips) 
Seat 6: chertas3 (6462 in chips) 
Seat 7: 14129088 (9157 in chips) 
Seat 8: Victorgd764 (17609 in chips) 
Seat 9: Silvaa.10 (25152 in chips) 
Y_NG_X: posts the ante 25
dfcastro.net: posts the ante 25
SSkrelya: posts the ante 25
chertas3: posts the ante 25
14129088: posts the ante 25
Victorgd764: posts the ante 25
Silvaa.10: posts the ante 25
Y_NG_X: posts small blind 200
dfcastro.net: posts big blind 400
*** HOLE CARDS ***
Dealt to dfcastro.net [8h 9s]
SSkrelya: folds 
chertas3: folds 
14129088: raises 400 to 800
Victorgd764: folds 
Silvaa.10: folds 
Y_NG_X: folds 
dfcastro.net: calls 400
*** FLOP *** [6d 4c Jc]
dfcastro.net: checks 
14129088: bets 1200
dfcastro.net: folds 
Uncalled bet (1200) returned to 14129088
14129088 collected 1975 from pot
14129088: doesn't show hand 
*** SUMMARY ***
Total pot 1975 | Rake 0 
Board [6d 4c Jc]
Seat 1: Y_NG_X (small blind) folded before Flop
Seat 2: dfcastro.net (big blind) folded on the Flop
Seat 3: SSkrelya folded before Flop (didn't bet)
Seat 6: chertas3 folded before Flop (didn't bet)
Seat 7: 14129088 collected (1975)
Seat 8: Victorgd764 folded before Flop (didn't bet)
Seat 9: Silvaa.10 (button) folded before Flop (didn't bet)



PokerStars Hand #100388813405: Tournament #750518676, $0.23+$0.02 USD Hold'em No Limit - Level X (300/600) - 2013/06/21 21:48:36 BRT [2013/06/21 20:48:36 ET]
Table '750518676 2' 9-max Seat #1 is the button
Seat 1: Y_NG_X (2005 in chips) 
Seat 2: dfcastro.net (2345 in chips) 
Seat 3: SSkrelya (3695 in chips) 
Seat 6: chertas3 (6437 in chips) 
Seat 7: 14129088 (10307 in chips) 
Seat 8: Victorgd764 (17584 in chips) 
Seat 9: Silvaa.10 (25127 in chips) 
Y_NG_X: posts the ante 50
dfcastro.net: posts the ante 50
SSkrelya: posts the ante 50
chertas3: posts the ante 50
14129088: posts the ante 50
Victorgd764: posts the ante 50
Silvaa.10: posts the ante 50
dfcastro.net: posts small blind 300
SSkrelya: posts big blind 600
*** HOLE CARDS ***
Dealt to dfcastro.net [3h Jc]
chertas3: folds 
14129088: folds 
Victorgd764: folds 
Silvaa.10: calls 600
Y_NG_X: folds 
dfcastro.net: folds 
SSkrelya: checks 
*** FLOP *** [4c Td Kh]
SSkrelya: checks 
Silvaa.10: bets 600
SSkrelya: folds 
Uncalled bet (600) returned to Silvaa.10
Silvaa.10 collected 1850 from pot
*** SUMMARY ***
Total pot 1850 | Rake 0 
Board [4c Td Kh]
Seat 1: Y_NG_X (button) folded before Flop (didn't bet)
Seat 2: dfcastro.net (small blind) folded before Flop
Seat 3: SSkrelya (big blind) folded on the Flop
Seat 6: chertas3 folded before Flop (didn't bet)
Seat 7: 14129088 folded before Flop (didn't bet)
Seat 8: Victorgd764 folded before Flop (didn't bet)
Seat 9: Silvaa.10 collected (1850)



PokerStars Hand #100388834480: Tournament #750518676, $0.23+$0.02 USD Hold'em No Limit - Level X (300/600) - 2013/06/21 21:49:22 BRT [2013/06/21 20:49:22 ET]
Table '750518676 2' 9-max Seat #2 is the button
Seat 1: Y_NG_X (1955 in chips) 
Seat 2: dfcastro.net (1995 in chips) 
Seat 3: SSkrelya (3045 in chips) 
Seat 6: chertas3 (6387 in chips) 
Seat 7: 14129088 (10257 in chips) 
Seat 8: Victorgd764 (17534 in chips) 
Seat 9: Silvaa.10 (26327 in chips) 
Y_NG_X: posts the ante 50
dfcastro.net: posts the ante 50
SSkrelya: posts the ante 50
chertas3: posts the ante 50
14129088: posts the ante 50
Victorgd764: posts the ante 50
Silvaa.10: posts the ante 50
SSkrelya: posts small blind 300
chertas3: posts big blind 600
*** HOLE CARDS ***
Dealt to dfcastro.net [2c 6s]
14129088: folds 
Victorgd764: folds 
Silvaa.10: folds 
Y_NG_X: folds 
dfcastro.net: folds 
SSkrelya: raises 2395 to 2995 and is all-in
chertas3: folds 
Uncalled bet (2395) returned to SSkrelya
SSkrelya collected 1550 from pot
SSkrelya: doesn't show hand 
*** SUMMARY ***
Total pot 1550 | Rake 0 
Seat 1: Y_NG_X folded before Flop (didn't bet)
Seat 2: dfcastro.net (button) folded before Flop (didn't bet)
Seat 3: SSkrelya (small blind) collected (1550)
Seat 6: chertas3 (big blind) folded before Flop
Seat 7: 14129088 folded before Flop (didn't bet)
Seat 8: Victorgd764 folded before Flop (didn't bet)
Seat 9: Silvaa.10 folded before Flop (didn't bet)



PokerStars Hand #100388846875: Tournament #750518676, $0.23+$0.02 USD Hold'em No Limit - Level X (300/600) - 2013/06/21 21:49:50 BRT [2013/06/21 20:49:50 ET]
Table '750518676 2' 9-max Seat #3 is the button
Seat 1: Y_NG_X (1905 in chips) 
Seat 2: dfcastro.net (1945 in chips) 
Seat 3: SSkrelya (3945 in chips) 
Seat 6: chertas3 (5737 in chips) 
Seat 7: 14129088 (10207 in chips) 
Seat 8: Victorgd764 (17484 in chips) 
Seat 9: Silvaa.10 (26277 in chips) 
Y_NG_X: posts the ante 50
dfcastro.net: posts the ante 50
SSkrelya: posts the ante 50
chertas3: posts the ante 50
14129088: posts the ante 50
Victorgd764: posts the ante 50
Silvaa.10: posts the ante 50
chertas3: posts small blind 300
14129088: posts big blind 600
*** HOLE CARDS ***
Dealt to dfcastro.net [Kh 3s]
Victorgd764: raises 600 to 1200
Silvaa.10: folds 
Y_NG_X: folds 
dfcastro.net: folds 
SSkrelya: folds 
chertas3: folds 
14129088: folds 
Uncalled bet (600) returned to Victorgd764
Victorgd764 collected 1850 from pot
Victorgd764: shows [8c 8s]
*** SUMMARY ***
Total pot 1850 | Rake 0 
Seat 1: Y_NG_X folded before Flop (didn't bet)
Seat 2: dfcastro.net folded before Flop (didn't bet)
Seat 3: SSkrelya (button) folded before Flop (didn't bet)
Seat 6: chertas3 (small blind) folded before Flop
Seat 7: 14129088 (big blind) folded before Flop
Seat 8: Victorgd764 collected (1850)
Seat 9: Silvaa.10 folded before Flop (didn't bet)



PokerStars Hand #100388861196: Tournament #750518676, $0.23+$0.02 USD Hold'em No Limit - Level X (300/600) - 2013/06/21 21:50:21 BRT [2013/06/21 20:50:21 ET]
Table '750518676 2' 9-max Seat #6 is the button
Seat 1: Y_NG_X (1855 in chips) 
Seat 2: dfcastro.net (1895 in chips) 
Seat 3: SSkrelya (3895 in chips) 
Seat 6: chertas3 (5387 in chips) 
Seat 7: 14129088 (9557 in chips) 
Seat 8: Victorgd764 (18684 in chips) 
Seat 9: Silvaa.10 (26227 in chips) 
Y_NG_X: posts the ante 50
dfcastro.net: posts the ante 50
SSkrelya: posts the ante 50
chertas3: posts the ante 50
14129088: posts the ante 50
Victorgd764: posts the ante 50
Silvaa.10: posts the ante 50
14129088: posts small blind 300
Victorgd764: posts big blind 600
*** HOLE CARDS ***
Dealt to dfcastro.net [Qh Td]
Silvaa.10: folds 
Y_NG_X: raises 1205 to 1805 and is all-in
dfcastro.net: folds 
SSkrelya: folds 
chertas3: folds 
14129088: folds 
Victorgd764: folds 
Uncalled bet (1205) returned to Y_NG_X
Y_NG_X collected 1850 from pot
*** SUMMARY ***
Total pot 1850 | Rake 0 
Seat 1: Y_NG_X collected (1850)
Seat 2: dfcastro.net folded before Flop (didn't bet)
Seat 3: SSkrelya folded before Flop (didn't bet)
Seat 6: chertas3 (button) folded before Flop (didn't bet)
Seat 7: 14129088 (small blind) folded before Flop
Seat 8: Victorgd764 (big blind) folded before Flop
Seat 9: Silvaa.10 folded before Flop (didn't bet)



PokerStars Hand #100388873030: Tournament #750518676, $0.23+$0.02 USD Hold'em No Limit - Level X (300/600) - 2013/06/21 21:50:47 BRT [2013/06/21 20:50:47 ET]
Table '750518676 2' 9-max Seat #7 is the button
Seat 1: Y_NG_X (3055 in chips) 
Seat 2: dfcastro.net (1845 in chips) 
Seat 3: SSkrelya (3845 in chips) 
Seat 6: chertas3 (5337 in chips) 
Seat 7: 14129088 (9207 in chips) 
Seat 8: Victorgd764 (18034 in chips) 
Seat 9: Silvaa.10 (26177 in chips) 
Y_NG_X: posts the ante 50
dfcastro.net: posts the ante 50
SSkrelya: posts the ante 50
chertas3: posts the ante 50
14129088: posts the ante 50
Victorgd764: posts the ante 50
Silvaa.10: posts the ante 50
Victorgd764: posts small blind 300
Silvaa.10: posts big blind 600
*** HOLE CARDS ***
Dealt to dfcastro.net [8c Qc]
Y_NG_X: folds 
dfcastro.net: folds 
SSkrelya: folds 
chertas3: folds 
14129088: raises 600 to 1200
Victorgd764: folds 
Silvaa.10: calls 600
*** FLOP *** [Jc Jd Jh]
Silvaa.10: checks 
14129088: bets 1800
Silvaa.10: folds 
Uncalled bet (1800) returned to 14129088
14129088 collected 3050 from pot
14129088: doesn't show hand 
*** SUMMARY ***
Total pot 3050 | Rake 0 
Board [Jc Jd Jh]
Seat 1: Y_NG_X folded before Flop (didn't bet)
Seat 2: dfcastro.net folded before Flop (didn't bet)
Seat 3: SSkrelya folded before Flop (didn't bet)
Seat 6: chertas3 folded before Flop (didn't bet)
Seat 7: 14129088 (button) collected (3050)
Seat 8: Victorgd764 (small blind) folded before Flop
Seat 9: Silvaa.10 (big blind) folded on the Flop



PokerStars Hand #100388892164: Tournament #750518676, $0.23+$0.02 USD Hold'em No Limit - Level X (300/600) - 2013/06/21 21:51:30 BRT [2013/06/21 20:51:30 ET]
Table '750518676 2' 9-max Seat #8 is the button
Seat 1: Y_NG_X (3005 in chips) 
Seat 2: dfcastro.net (1795 in chips) 
Seat 3: SSkrelya (3795 in chips) 
Seat 6: chertas3 (5287 in chips) 
Seat 7: 14129088 (11007 in chips) 
Seat 8: Victorgd764 (17684 in chips) 
Seat 9: Silvaa.10 (24927 in chips) 
Y_NG_X: posts the ante 50
dfcastro.net: posts the ante 50
SSkrelya: posts the ante 50
chertas3: posts the ante 50
14129088: posts the ante 50
Victorgd764: posts the ante 50
Silvaa.10: posts the ante 50
Silvaa.10: posts small blind 300
Y_NG_X: posts big blind 600
*** HOLE CARDS ***
Dealt to dfcastro.net [Js Jh]
dfcastro.net: raises 1145 to 1745 and is all-in
SSkrelya: folds 
chertas3: folds 
14129088: raises 1145 to 2890
Victorgd764: folds 
Silvaa.10: folds 
Y_NG_X: folds 
Uncalled bet (1145) returned to 14129088
*** FLOP *** [8d 9h Jc]
*** TURN *** [8d 9h Jc] [8h]
*** RIVER *** [8d 9h Jc 8h] [5c]
*** SHOW DOWN ***
dfcastro.net: shows [Js Jh] (a full house, Jacks full of Eights)
14129088: shows [7s 7d] (two pair, Eights and Sevens)
dfcastro.net collected 4740 from pot
*** SUMMARY ***
Total pot 4740 | Rake 0 
Board [8d 9h Jc 8h 5c]
Seat 1: Y_NG_X (big blind) folded before Flop
Seat 2: dfcastro.net showed [Js Jh] and won (4740) with a full house, Jacks full of Eights
Seat 3: SSkrelya folded before Flop (didn't bet)
Seat 6: chertas3 folded before Flop (didn't bet)
Seat 7: 14129088 showed [7s 7d] and lost with two pair, Eights and Sevens
Seat 8: Victorgd764 (button) folded before Flop (didn't bet)
Seat 9: Silvaa.10 (small blind) folded before Flop



PokerStars Hand #100388906542: Tournament #750518676, $0.23+$0.02 USD Hold'em No Limit - Level X (300/600) - 2013/06/21 21:52:02 BRT [2013/06/21 20:52:02 ET]
Table '750518676 2' 9-max Seat #9 is the button
Seat 1: Y_NG_X (2355 in chips) 
Seat 2: dfcastro.net (4740 in chips) 
Seat 3: SSkrelya (3745 in chips) 
Seat 6: chertas3 (5237 in chips) 
Seat 7: 14129088 (9212 in chips) 
Seat 8: Victorgd764 (17634 in chips) 
Seat 9: Silvaa.10 (24577 in chips) 
Y_NG_X: posts the ante 50
dfcastro.net: posts the ante 50
SSkrelya: posts the ante 50
chertas3: posts the ante 50
14129088: posts the ante 50
Victorgd764: posts the ante 50
Silvaa.10: posts the ante 50
Y_NG_X: posts small blind 300
dfcastro.net: posts big blind 600
*** HOLE CARDS ***
Dealt to dfcastro.net [Ac 7h]
SSkrelya: folds 
chertas3: folds 
14129088: folds 
Victorgd764: folds 
Silvaa.10: folds 
Y_NG_X: raises 1705 to 2305 and is all-in
dfcastro.net: calls 1705
*** FLOP *** [6c 2s 7s]
*** TURN *** [6c 2s 7s] [Kh]
*** RIVER *** [6c 2s 7s Kh] [7d]
*** SHOW DOWN ***
Y_NG_X: shows [Kc 8s] (two pair, Kings and Sevens)
dfcastro.net: shows [Ac 7h] (three of a kind, Sevens)
dfcastro.net collected 4960 from pot
Y_NG_X finished the tournament in 7th place and received $0.36.
*** SUMMARY ***
Total pot 4960 | Rake 0 
Board [6c 2s 7s Kh 7d]
Seat 1: Y_NG_X (small blind) showed [Kc 8s] and lost with two pair, Kings and Sevens
Seat 2: dfcastro.net (big blind) showed [Ac 7h] and won (4960) with three of a kind, Sevens
Seat 3: SSkrelya folded before Flop (didn't bet)
Seat 6: chertas3 folded before Flop (didn't bet)
Seat 7: 14129088 folded before Flop (didn't bet)
Seat 8: Victorgd764 folded before Flop (didn't bet)
Seat 9: Silvaa.10 (button) folded before Flop (didn't bet)



PokerStars Hand #100388918971: Tournament #750518676, $0.23+$0.02 USD Hold'em No Limit - Level X (300/600) - 2013/06/21 21:52:30 BRT [2013/06/21 20:52:30 ET]
Table '750518676 2' 9-max Seat #2 is the button
Seat 2: dfcastro.net (7345 in chips) 
Seat 3: SSkrelya (3695 in chips) 
Seat 6: chertas3 (5187 in chips) 
Seat 7: 14129088 (9162 in chips) 
Seat 8: Victorgd764 (17584 in chips) 
Seat 9: Silvaa.10 (24527 in chips) 
dfcastro.net: posts the ante 50
SSkrelya: posts the ante 50
chertas3: posts the ante 50
14129088: posts the ante 50
Victorgd764: posts the ante 50
Silvaa.10: posts the ante 50
SSkrelya: posts small blind 300
chertas3: posts big blind 600
*** HOLE CARDS ***
Dealt to dfcastro.net [7h Ac]
14129088: folds 
Victorgd764: folds 
Silvaa.10: folds 
dfcastro.net said, "one more!"
dfcastro.net: raises 1200 to 1800
SSkrelya: folds 
chertas3: folds 
Uncalled bet (1200) returned to dfcastro.net
dfcastro.net collected 1800 from pot
dfcastro.net: doesn't show hand 
*** SUMMARY ***
Total pot 1800 | Rake 0 
Seat 2: dfcastro.net (button) collected (1800)
Seat 3: SSkrelya (small blind) folded before Flop
Seat 6: chertas3 (big blind) folded before Flop
Seat 7: 14129088 folded before Flop (didn't bet)
Seat 8: Victorgd764 folded before Flop (didn't bet)
Seat 9: Silvaa.10 folded before Flop (didn't bet)



PokerStars Hand #100388928626: Tournament #750518676, $0.23+$0.02 USD Hold'em No Limit - Level X (300/600) - 2013/06/21 21:52:52 BRT [2013/06/21 20:52:52 ET]
Table '750518676 2' 9-max Seat #3 is the button
Seat 2: dfcastro.net (8495 in chips) 
Seat 3: SSkrelya (3345 in chips) 
Seat 6: chertas3 (4537 in chips) 
Seat 7: 14129088 (9112 in chips) 
Seat 8: Victorgd764 (17534 in chips) 
Seat 9: Silvaa.10 (24477 in chips) 
dfcastro.net: posts the ante 50
SSkrelya: posts the ante 50
chertas3: posts the ante 50
14129088: posts the ante 50
Victorgd764: posts the ante 50
Silvaa.10: posts the ante 50
chertas3: posts small blind 300
14129088: posts big blind 600
*** HOLE CARDS ***
Dealt to dfcastro.net [Ad 6d]
Victorgd764: raises 696 to 1296
Silvaa.10: folds 
dfcastro.net: calls 1296
SSkrelya: folds 
chertas3: folds 
Silvaa.10 said, "vai cum tudoo"
14129088: calls 696
*** FLOP *** [Qh Qs 8c]
14129088: checks 
Victorgd764: checks 
dfcastro.net: checks 
*** TURN *** [Qh Qs 8c] [3s]
14129088: bets 1200
Victorgd764 said, "vamos ver q q da"
Victorgd764: calls 1200
dfcastro.net: folds 
*** RIVER *** [Qh Qs 8c 3s] [9h]
14129088: bets 6000
Victorgd764 said, "é arriscar d+"
Victorgd764: folds [6h 6c]
Uncalled bet (6000) returned to 14129088
14129088 collected 6888 from pot
14129088: doesn't show hand 
*** SUMMARY ***
Total pot 6888 | Rake 0 
Board [Qh Qs 8c 3s 9h]
Seat 2: dfcastro.net folded on the Turn
Seat 3: SSkrelya (button) folded before Flop (didn't bet)
Seat 6: chertas3 (small blind) folded before Flop
Seat 7: 14129088 (big blind) collected (6888)
Seat 8: Victorgd764 folded on the River
Seat 9: Silvaa.10 folded before Flop (didn't bet)



PokerStars Hand #100388956909: Tournament #750518676, $0.23+$0.02 USD Hold'em No Limit - Level X (300/600) - 2013/06/21 21:53:57 BRT [2013/06/21 20:53:57 ET]
Table '750518676 2' 9-max Seat #6 is the button
Seat 2: dfcastro.net (7149 in chips) 
Seat 3: SSkrelya (3295 in chips) 
Seat 6: chertas3 (4187 in chips) 
Seat 7: 14129088 (13454 in chips) 
Seat 8: Victorgd764 (14988 in chips) 
Seat 9: Silvaa.10 (24427 in chips) 
dfcastro.net: posts the ante 50
SSkrelya: posts the ante 50
chertas3: posts the ante 50
14129088: posts the ante 50
Victorgd764: posts the ante 50
Silvaa.10: posts the ante 50
14129088: posts small blind 300
Victorgd764: posts big blind 600
*** HOLE CARDS ***
Dealt to dfcastro.net [4s Ks]
14129088 said, "english donk\"
Silvaa.10: folds 
dfcastro.net: folds 
SSkrelya: folds 
Victorgd764 said, "n to falando com vc otario"
Victorgd764 said, "entao cala bok ae"
chertas3: folds 
14129088: raises 600 to 1200
Victorgd764: folds 
Uncalled bet (600) returned to 14129088
14129088 collected 1500 from pot
14129088: doesn't show hand 
*** SUMMARY ***
Total pot 1500 | Rake 0 
Seat 2: dfcastro.net folded before Flop (didn't bet)
Seat 3: SSkrelya folded before Flop (didn't bet)
Seat 6: chertas3 (button) folded before Flop (didn't bet)
Seat 7: 14129088 (small blind) collected (1500)
Seat 8: Victorgd764 (big blind) folded before Flop
Seat 9: Silvaa.10 folded before Flop (didn't bet)



PokerStars Hand #100388973056: Tournament #750518676, $0.23+$0.02 USD Hold'em No Limit - Level X (300/600) - 2013/06/21 21:54:34 BRT [2013/06/21 20:54:34 ET]
Table '750518676 2' 9-max Seat #7 is the button
Seat 2: dfcastro.net (7099 in chips) 
Seat 3: SSkrelya (3245 in chips) 
Seat 6: chertas3 (4137 in chips) 
Seat 7: 14129088 (14304 in chips) 
Seat 8: Victorgd764 (14338 in chips) 
Seat 9: Silvaa.10 (24377 in chips) 
dfcastro.net: posts the ante 50
SSkrelya: posts the ante 50
chertas3: posts the ante 50
14129088: posts the ante 50
Victorgd764: posts the ante 50
Silvaa.10: posts the ante 50
Victorgd764: posts small blind 300
Silvaa.10: posts big blind 600
*** HOLE CARDS ***
Dealt to dfcastro.net [Ac Ks]
dfcastro.net: raises 1200 to 1800
SSkrelya: folds 
chertas3: folds 
14129088: folds 
Victorgd764: calls 1500
Silvaa.10: folds 
*** FLOP *** [3s 4d 6c]
Victorgd764: checks 
dfcastro.net: bets 4200
Victorgd764: calls 4200
*** TURN *** [3s 4d 6c] [5s]
Victorgd764: bets 600
dfcastro.net: raises 449 to 1049 and is all-in
Victorgd764: calls 449
*** RIVER *** [3s 4d 6c 5s] [9h]
*** SHOW DOWN ***
Victorgd764: shows [Ad Qh] (high card Ace)
dfcastro.net: shows [Ac Ks] (high card Ace - King kicker)
dfcastro.net collected 14998 from pot
*** SUMMARY ***
Total pot 14998 | Rake 0 
Board [3s 4d 6c 5s 9h]
Seat 2: dfcastro.net showed [Ac Ks] and won (14998) with high card Ace
Seat 3: SSkrelya folded before Flop (didn't bet)
Seat 6: chertas3 folded before Flop (didn't bet)
Seat 7: 14129088 (button) folded before Flop (didn't bet)
Seat 8: Victorgd764 (small blind) showed [Ad Qh] and lost with high card Ace
Seat 9: Silvaa.10 (big blind) folded before Flop



PokerStars Hand #100389094306: Tournament #750518676, $0.23+$0.02 USD Hold'em No Limit - Level X (300/600) - 2013/06/21 22:00:13 BRT [2013/06/21 21:00:13 ET]
Table '750518676 2' 9-max Seat #8 is the button
Seat 2: dfcastro.net (14998 in chips) 
Seat 3: SSkrelya (3195 in chips) 
Seat 6: chertas3 (4087 in chips) 
Seat 7: 14129088 (14254 in chips) 
Seat 8: Victorgd764 (7239 in chips) 
Seat 9: Silvaa.10 (23727 in chips) 
dfcastro.net: posts the ante 50
SSkrelya: posts the ante 50
chertas3: posts the ante 50
14129088: posts the ante 50
Victorgd764: posts the ante 50
Silvaa.10: posts the ante 50
Silvaa.10: posts small blind 300
dfcastro.net: posts big blind 600
*** HOLE CARDS ***
Dealt to dfcastro.net [2c Jh]
SSkrelya: folds 
chertas3: raises 3437 to 4037 and is all-in
14129088: calls 4037
Victorgd764: folds 
Silvaa.10: folds 
dfcastro.net: folds 
*** FLOP *** [Ac 3d Ks]
*** TURN *** [Ac 3d Ks] [Th]
*** RIVER *** [Ac 3d Ks Th] [6d]
*** SHOW DOWN ***
chertas3: shows [As Jc] (a pair of Aces)
14129088: shows [9c Ah] (a pair of Aces - lower kicker)
chertas3 collected 9274 from pot
*** SUMMARY ***
Total pot 9274 | Rake 0 
Board [Ac 3d Ks Th 6d]
Seat 2: dfcastro.net (big blind) folded before Flop
Seat 3: SSkrelya folded before Flop (didn't bet)
Seat 6: chertas3 showed [As Jc] and won (9274) with a pair of Aces
Seat 7: 14129088 showed [9c Ah] and lost with a pair of Aces
Seat 8: Victorgd764 (button) folded before Flop (didn't bet)
Seat 9: Silvaa.10 (small blind) folded before Flop



PokerStars Hand #100389106370: Tournament #750518676, $0.23+$0.02 USD Hold'em No Limit - Level X (300/600) - 2013/06/21 22:00:45 BRT [2013/06/21 21:00:45 ET]
Table '750518676 2' 9-max Seat #9 is the button
Seat 2: dfcastro.net (14348 in chips) 
Seat 3: SSkrelya (3145 in chips) 
Seat 6: chertas3 (9274 in chips) 
Seat 7: 14129088 (10167 in chips) 
Seat 8: Victorgd764 (7189 in chips) 
Seat 9: Silvaa.10 (23377 in chips) 
dfcastro.net: posts the ante 50
SSkrelya: posts the ante 50
chertas3: posts the ante 50
14129088: posts the ante 50
Victorgd764: posts the ante 50
Silvaa.10: posts the ante 50
dfcastro.net: posts small blind 300
SSkrelya: posts big blind 600
*** HOLE CARDS ***
Dealt to dfcastro.net [Jc Ts]
chertas3: folds 
14129088: folds 
Victorgd764: raises 1200 to 1800
Silvaa.10: raises 1200 to 3000
dfcastro.net: folds 
SSkrelya: folds 
Victorgd764: raises 4139 to 7139 and is all-in
Silvaa.10: calls 4139
*** FLOP *** [Jh Kc 5h]
*** TURN *** [Jh Kc 5h] [3s]
*** RIVER *** [Jh Kc 5h 3s] [4s]
*** SHOW DOWN ***
Victorgd764: shows [Qc Qs] (a pair of Queens)
Silvaa.10: shows [Ks Ad] (a pair of Kings)
Silvaa.10 collected 15478 from pot
Victorgd764 finished the tournament in 6th place and received $0.62.
*** SUMMARY ***
Total pot 15478 | Rake 0 
Board [Jh Kc 5h 3s 4s]
Seat 2: dfcastro.net (small blind) folded before Flop
Seat 3: SSkrelya (big blind) folded before Flop
Seat 6: chertas3 folded before Flop (didn't bet)
Seat 7: 14129088 folded before Flop (didn't bet)
Seat 8: Victorgd764 showed [Qc Qs] and lost with a pair of Queens
Seat 9: Silvaa.10 (button) showed [Ks Ad] and won (15478) with a pair of Kings



PokerStars Hand #100389119897: Tournament #750518676, $0.23+$0.02 USD Hold'em No Limit - Level X (300/600) - 2013/06/21 22:01:17 BRT [2013/06/21 21:01:17 ET]
Table '750518676 2' 9-max Seat #2 is the button
Seat 2: dfcastro.net (13998 in chips) 
Seat 3: SSkrelya (2495 in chips) 
Seat 6: chertas3 (9224 in chips) 
Seat 7: 14129088 (10117 in chips) 
Seat 9: Silvaa.10 (31666 in chips) 
dfcastro.net: posts the ante 50
SSkrelya: posts the ante 50
chertas3: posts the ante 50
14129088: posts the ante 50
Silvaa.10: posts the ante 50
SSkrelya: posts small blind 300
chertas3: posts big blind 600
*** HOLE CARDS ***
Dealt to dfcastro.net [4h Qs]
14129088: raises 600 to 1200
Silvaa.10: folds 
dfcastro.net: folds 
SSkrelya: folds 
chertas3: folds 
Uncalled bet (600) returned to 14129088
14129088 collected 1750 from pot
14129088: doesn't show hand 
*** SUMMARY ***
Total pot 1750 | Rake 0 
Seat 2: dfcastro.net (button) folded before Flop (didn't bet)
Seat 3: SSkrelya (small blind) folded before Flop
Seat 6: chertas3 (big blind) folded before Flop
Seat 7: 14129088 collected (1750)
Seat 9: Silvaa.10 folded before Flop (didn't bet)



PokerStars Hand #100389131094: Tournament #750518676, $0.23+$0.02 USD Hold'em No Limit - Level X (300/600) - 2013/06/21 22:01:43 BRT [2013/06/21 21:01:43 ET]
Table '750518676 2' 9-max Seat #3 is the button
Seat 2: dfcastro.net (13948 in chips) 
Seat 3: SSkrelya (2145 in chips) 
Seat 6: chertas3 (8574 in chips) 
Seat 7: 14129088 (11217 in chips) 
Seat 9: Silvaa.10 (31616 in chips) 
dfcastro.net: posts the ante 50
SSkrelya: posts the ante 50
chertas3: posts the ante 50
14129088: posts the ante 50
Silvaa.10: posts the ante 50
chertas3: posts small blind 300
14129088: posts big blind 600
*** HOLE CARDS ***
Dealt to dfcastro.net [Ac Ad]
Silvaa.10: folds 
dfcastro.net: raises 1200 to 1800
SSkrelya: folds 
chertas3: folds 
14129088: folds 
Uncalled bet (1200) returned to dfcastro.net
dfcastro.net collected 1750 from pot
dfcastro.net: doesn't show hand 
*** SUMMARY ***
Total pot 1750 | Rake 0 
Seat 2: dfcastro.net collected (1750)
Seat 3: SSkrelya (button) folded before Flop (didn't bet)
Seat 6: chertas3 (small blind) folded before Flop
Seat 7: 14129088 (big blind) folded before Flop
Seat 9: Silvaa.10 folded before Flop (didn't bet)



PokerStars Hand #100389144593: Tournament #750518676, $0.23+$0.02 USD Hold'em No Limit - Level X (300/600) - 2013/06/21 22:02:13 BRT [2013/06/21 21:02:13 ET]
Table '750518676 2' 9-max Seat #6 is the button
Seat 2: dfcastro.net (15048 in chips) 
Seat 3: SSkrelya (2095 in chips) 
Seat 6: chertas3 (8224 in chips) 
Seat 7: 14129088 (10567 in chips) 
Seat 9: Silvaa.10 (31566 in chips) 
dfcastro.net: posts the ante 50
SSkrelya: posts the ante 50
chertas3: posts the ante 50
14129088: posts the ante 50
Silvaa.10: posts the ante 50
14129088: posts small blind 300
Silvaa.10: posts big blind 600
*** HOLE CARDS ***
Dealt to dfcastro.net [6h 5h]
dfcastro.net: folds 
SSkrelya: raises 1445 to 2045 and is all-in
chertas3: folds 
14129088: folds 
Silvaa.10: calls 1445
*** FLOP *** [8c Qd 4c]
*** TURN *** [8c Qd 4c] [4d]
*** RIVER *** [8c Qd 4c 4d] [Jc]
*** SHOW DOWN ***
Silvaa.10: shows [3h Kh] (a pair of Fours)
SSkrelya: shows [5d Ah] (a pair of Fours - Ace kicker)
SSkrelya collected 4640 from pot
*** SUMMARY ***
Total pot 4640 | Rake 0 
Board [8c Qd 4c 4d Jc]
Seat 2: dfcastro.net folded before Flop (didn't bet)
Seat 3: SSkrelya showed [5d Ah] and won (4640) with a pair of Fours
Seat 6: chertas3 (button) folded before Flop (didn't bet)
Seat 7: 14129088 (small blind) folded before Flop
Seat 9: Silvaa.10 (big blind) showed [3h Kh] and lost with a pair of Fours



PokerStars Hand #100389159815: Tournament #750518676, $0.23+$0.02 USD Hold'em No Limit - Level XI (400/800) - 2013/06/21 22:02:46 BRT [2013/06/21 21:02:46 ET]
Table '750518676 2' 9-max Seat #7 is the button
Seat 2: dfcastro.net (14998 in chips) 
Seat 3: SSkrelya (4640 in chips) 
Seat 6: chertas3 (8174 in chips) 
Seat 7: 14129088 (10217 in chips) 
Seat 9: Silvaa.10 (29471 in chips) 
dfcastro.net: posts the ante 50
SSkrelya: posts the ante 50
chertas3: posts the ante 50
14129088: posts the ante 50
Silvaa.10: posts the ante 50
Silvaa.10: posts small blind 400
dfcastro.net: posts big blind 800
*** HOLE CARDS ***
Dealt to dfcastro.net [4s 8s]
SSkrelya: folds 
chertas3: folds 
14129088: raises 800 to 1600
Silvaa.10: folds 
dfcastro.net: folds 
Uncalled bet (800) returned to 14129088
14129088 collected 2250 from pot
14129088: doesn't show hand 
*** SUMMARY ***
Total pot 2250 | Rake 0 
Seat 2: dfcastro.net (big blind) folded before Flop
Seat 3: SSkrelya folded before Flop (didn't bet)
Seat 6: chertas3 folded before Flop (didn't bet)
Seat 7: 14129088 (button) collected (2250)
Seat 9: Silvaa.10 (small blind) folded before Flop



PokerStars Hand #100389169647: Tournament #750518676, $0.23+$0.02 USD Hold'em No Limit - Level XI (400/800) - 2013/06/21 22:03:07 BRT [2013/06/21 21:03:07 ET]
Table '750518676 2' 9-max Seat #9 is the button
Seat 2: dfcastro.net (14148 in chips) 
Seat 3: SSkrelya (4590 in chips) 
Seat 6: chertas3 (8124 in chips) 
Seat 7: 14129088 (11617 in chips) 
Seat 9: Silvaa.10 (29021 in chips) 
dfcastro.net: posts the ante 50
SSkrelya: posts the ante 50
chertas3: posts the ante 50
14129088: posts the ante 50
Silvaa.10: posts the ante 50
dfcastro.net: posts small blind 400
SSkrelya: posts big blind 800
*** HOLE CARDS ***
Dealt to dfcastro.net [5h 5d]
chertas3: folds 
14129088: calls 800
Silvaa.10: folds 
dfcastro.net: raises 1600 to 2400
SSkrelya: folds 
14129088: calls 1600
*** FLOP *** [3d Jd Kh]
dfcastro.net: checks 
14129088: bets 4000
dfcastro.net: folds 
Uncalled bet (4000) returned to 14129088
14129088 collected 5850 from pot
14129088: doesn't show hand 
*** SUMMARY ***
Total pot 5850 | Rake 0 
Board [3d Jd Kh]
Seat 2: dfcastro.net (small blind) folded on the Flop
Seat 3: SSkrelya (big blind) folded before Flop
Seat 6: chertas3 folded before Flop (didn't bet)
Seat 7: 14129088 collected (5850)
Seat 9: Silvaa.10 (button) folded before Flop (didn't bet)



PokerStars Hand #100389194289: Tournament #750518676, $0.23+$0.02 USD Hold'em No Limit - Level XI (400/800) - 2013/06/21 22:04:01 BRT [2013/06/21 21:04:01 ET]
Table '750518676 2' 9-max Seat #2 is the button
Seat 2: dfcastro.net (11698 in chips) 
Seat 3: SSkrelya (3740 in chips) 
Seat 6: chertas3 (8074 in chips) 
Seat 7: 14129088 (15017 in chips) 
Seat 9: Silvaa.10 (28971 in chips) 
dfcastro.net: posts the ante 50
SSkrelya: posts the ante 50
chertas3: posts the ante 50
14129088: posts the ante 50
Silvaa.10: posts the ante 50
SSkrelya: posts small blind 400
chertas3: posts big blind 800
*** HOLE CARDS ***
Dealt to dfcastro.net [Tc 7h]
14129088: folds 
Silvaa.10: folds 
dfcastro.net: folds 
SSkrelya: raises 2890 to 3690 and is all-in
chertas3: calls 2890
*** FLOP *** [Kd 6d 2d]
*** TURN *** [Kd 6d 2d] [9s]
*** RIVER *** [Kd 6d 2d 9s] [Kh]
*** SHOW DOWN ***
SSkrelya: shows [4s 4h] (two pair, Kings and Fours)
chertas3: shows [6h Qs] (two pair, Kings and Sixes)
chertas3 collected 7630 from pot
SSkrelya finished the tournament in 5th place and received $0.93.
*** SUMMARY ***
Total pot 7630 | Rake 0 
Board [Kd 6d 2d 9s Kh]
Seat 2: dfcastro.net (button) folded before Flop (didn't bet)
Seat 3: SSkrelya (small blind) showed [4s 4h] and lost with two pair, Kings and Fours
Seat 6: chertas3 (big blind) showed [6h Qs] and won (7630) with two pair, Kings and Sixes
Seat 7: 14129088 folded before Flop (didn't bet)
Seat 9: Silvaa.10 folded before Flop (didn't bet)



PokerStars Hand #100389213013: Tournament #750518676, $0.23+$0.02 USD Hold'em No Limit - Level XI (400/800) - 2013/06/21 22:04:41 BRT [2013/06/21 21:04:41 ET]
Table '750518676 2' 9-max Seat #6 is the button
Seat 2: dfcastro.net (11648 in chips) 
Seat 6: chertas3 (11964 in chips) 
Seat 7: 14129088 (14967 in chips) 
Seat 9: Silvaa.10 (28921 in chips) 
dfcastro.net: posts the ante 50
chertas3: posts the ante 50
14129088: posts the ante 50
Silvaa.10: posts the ante 50
14129088: posts small blind 400
Silvaa.10: posts big blind 800
*** HOLE CARDS ***
Dealt to dfcastro.net [Ah 3d]
dfcastro.net: folds 
chertas3: folds 
14129088: raises 800 to 1600
Silvaa.10: calls 800
*** FLOP *** [2c Kc 7h]
14129088: bets 2400
Silvaa.10: folds 
Uncalled bet (2400) returned to 14129088
14129088 collected 3400 from pot
14129088: doesn't show hand 
*** SUMMARY ***
Total pot 3400 | Rake 0 
Board [2c Kc 7h]
Seat 2: dfcastro.net folded before Flop (didn't bet)
Seat 6: chertas3 (button) folded before Flop (didn't bet)
Seat 7: 14129088 (small blind) collected (3400)
Seat 9: Silvaa.10 (big blind) folded on the Flop



PokerStars Hand #100389228074: Tournament #750518676, $0.23+$0.02 USD Hold'em No Limit - Level XI (400/800) - 2013/06/21 22:05:13 BRT [2013/06/21 21:05:13 ET]
Table '750518676 2' 9-max Seat #7 is the button
Seat 2: dfcastro.net (11598 in chips) 
Seat 6: chertas3 (11914 in chips) 
Seat 7: 14129088 (16717 in chips) 
Seat 9: Silvaa.10 (27271 in chips) 
dfcastro.net: posts the ante 50
chertas3: posts the ante 50
14129088: posts the ante 50
Silvaa.10: posts the ante 50
Silvaa.10: posts small blind 400
dfcastro.net: posts big blind 800
*** HOLE CARDS ***
Dealt to dfcastro.net [9c Js]
chertas3: folds 
14129088: raises 15867 to 16667 and is all-in
Silvaa.10: folds 
dfcastro.net: folds 
Uncalled bet (15867) returned to 14129088
14129088 collected 2200 from pot
14129088: doesn't show hand 
*** SUMMARY ***
Total pot 2200 | Rake 0 
Seat 2: dfcastro.net (big blind) folded before Flop
Seat 6: chertas3 folded before Flop (didn't bet)
Seat 7: 14129088 (button) collected (2200)
Seat 9: Silvaa.10 (small blind) folded before Flop



PokerStars Hand #100389237811: Tournament #750518676, $0.23+$0.02 USD Hold'em No Limit - Level XI (400/800) - 2013/06/21 22:05:35 BRT [2013/06/21 21:05:35 ET]
Table '750518676 2' 9-max Seat #9 is the button
Seat 2: dfcastro.net (10748 in chips) 
Seat 6: chertas3 (11864 in chips) 
Seat 7: 14129088 (18067 in chips) 
Seat 9: Silvaa.10 (26821 in chips) 
dfcastro.net: posts the ante 50
chertas3: posts the ante 50
14129088: posts the ante 50
Silvaa.10: posts the ante 50
dfcastro.net: posts small blind 400
chertas3: posts big blind 800
*** HOLE CARDS ***
Dealt to dfcastro.net [Ac 8s]
14129088: folds 
Silvaa.10: raises 800 to 1600
dfcastro.net: folds 
chertas3: folds 
Uncalled bet (800) returned to Silvaa.10
Silvaa.10 collected 2200 from pot
*** SUMMARY ***
Total pot 2200 | Rake 0 
Seat 2: dfcastro.net (small blind) folded before Flop
Seat 6: chertas3 (big blind) folded before Flop
Seat 7: 14129088 folded before Flop (didn't bet)
Seat 9: Silvaa.10 (button) collected (2200)



PokerStars Hand #100389249496: Tournament #750518676, $0.23+$0.02 USD Hold'em No Limit - Level XI (400/800) - 2013/06/21 22:06:00 BRT [2013/06/21 21:06:00 ET]
Table '750518676 2' 9-max Seat #2 is the button
Seat 2: dfcastro.net (10298 in chips) 
Seat 6: chertas3 (11014 in chips) 
Seat 7: 14129088 (18017 in chips) 
Seat 9: Silvaa.10 (28171 in chips) 
dfcastro.net: posts the ante 50
chertas3: posts the ante 50
14129088: posts the ante 50
Silvaa.10: posts the ante 50
chertas3: posts small blind 400
14129088: posts big blind 800
*** HOLE CARDS ***
Dealt to dfcastro.net [8d 9h]
Silvaa.10: folds 
dfcastro.net: folds 
chertas3: raises 10164 to 10964 and is all-in
14129088: folds 
Uncalled bet (10164) returned to chertas3
chertas3 collected 1800 from pot
chertas3: doesn't show hand 
*** SUMMARY ***
Total pot 1800 | Rake 0 
Seat 2: dfcastro.net (button) folded before Flop (didn't bet)
Seat 6: chertas3 (small blind) collected (1800)
Seat 7: 14129088 (big blind) folded before Flop
Seat 9: Silvaa.10 folded before Flop (didn't bet)



PokerStars Hand #100389256872: Tournament #750518676, $0.23+$0.02 USD Hold'em No Limit - Level XI (400/800) - 2013/06/21 22:06:15 BRT [2013/06/21 21:06:15 ET]
Table '750518676 2' 9-max Seat #6 is the button
Seat 2: dfcastro.net (10248 in chips) 
Seat 6: chertas3 (11964 in chips) 
Seat 7: 14129088 (17167 in chips) 
Seat 9: Silvaa.10 (28121 in chips) 
dfcastro.net: posts the ante 50
chertas3: posts the ante 50
14129088: posts the ante 50
Silvaa.10: posts the ante 50
14129088: posts small blind 400
Silvaa.10: posts big blind 800
*** HOLE CARDS ***
Dealt to dfcastro.net [8d 4s]
dfcastro.net: folds 
chertas3: folds 
14129088: folds 
Uncalled bet (400) returned to Silvaa.10
Silvaa.10 collected 1000 from pot
*** SUMMARY ***
Total pot 1000 | Rake 0 
Seat 2: dfcastro.net folded before Flop (didn't bet)
Seat 6: chertas3 (button) folded before Flop (didn't bet)
Seat 7: 14129088 (small blind) folded before Flop
Seat 9: Silvaa.10 (big blind) collected (1000)



PokerStars Hand #100389268589: Tournament #750518676, $0.23+$0.02 USD Hold'em No Limit - Level XI (400/800) - 2013/06/21 22:06:41 BRT [2013/06/21 21:06:41 ET]
Table '750518676 2' 9-max Seat #7 is the button
Seat 2: dfcastro.net (10198 in chips) 
Seat 6: chertas3 (11914 in chips) 
Seat 7: 14129088 (16717 in chips) 
Seat 9: Silvaa.10 (28671 in chips) 
dfcastro.net: posts the ante 50
chertas3: posts the ante 50
14129088: posts the ante 50
Silvaa.10: posts the ante 50
Silvaa.10: posts small blind 400
dfcastro.net: posts big blind 800
*** HOLE CARDS ***
Dealt to dfcastro.net [Qc Qs]
chertas3: folds 
14129088: raises 800 to 1600
Silvaa.10: folds 
dfcastro.net: raises 2000 to 3600
14129088: calls 2000
*** FLOP *** [Ad Kh 3d]
dfcastro.net: bets 6548 and is all-in
14129088: folds 
Uncalled bet (6548) returned to dfcastro.net
dfcastro.net collected 7800 from pot
dfcastro.net: doesn't show hand 
*** SUMMARY ***
Total pot 7800 | Rake 0 
Board [Ad Kh 3d]
Seat 2: dfcastro.net (big blind) collected (7800)
Seat 6: chertas3 folded before Flop (didn't bet)
Seat 7: 14129088 (button) folded on the Flop
Seat 9: Silvaa.10 (small blind) folded before Flop



PokerStars Hand #100389289236: Tournament #750518676, $0.23+$0.02 USD Hold'em No Limit - Level XI (400/800) - 2013/06/21 22:07:26 BRT [2013/06/21 21:07:26 ET]
Table '750518676 2' 9-max Seat #9 is the button
Seat 2: dfcastro.net (14348 in chips) 
Seat 6: chertas3 (11864 in chips) 
Seat 7: 14129088 (13067 in chips) 
Seat 9: Silvaa.10 (28221 in chips) 
dfcastro.net: posts the ante 50
chertas3: posts the ante 50
14129088: posts the ante 50
Silvaa.10: posts the ante 50
dfcastro.net: posts small blind 400
chertas3: posts big blind 800
*** HOLE CARDS ***
Dealt to dfcastro.net [6h 5s]
14129088: folds 
Silvaa.10: folds 
dfcastro.net: folds 
Uncalled bet (400) returned to chertas3
chertas3 collected 1000 from pot
chertas3: doesn't show hand 
*** SUMMARY ***
Total pot 1000 | Rake 0 
Seat 2: dfcastro.net (small blind) folded before Flop
Seat 6: chertas3 (big blind) collected (1000)
Seat 7: 14129088 folded before Flop (didn't bet)
Seat 9: Silvaa.10 (button) folded before Flop (didn't bet)



PokerStars Hand #100389297866: Tournament #750518676, $0.23+$0.02 USD Hold'em No Limit - Level XI (400/800) - 2013/06/21 22:07:44 BRT [2013/06/21 21:07:44 ET]
Table '750518676 2' 9-max Seat #2 is the button
Seat 2: dfcastro.net (13898 in chips) 
Seat 6: chertas3 (12414 in chips) 
Seat 7: 14129088 (13017 in chips) 
Seat 9: Silvaa.10 (28171 in chips) 
dfcastro.net: posts the ante 50
chertas3: posts the ante 50
14129088: posts the ante 50
Silvaa.10: posts the ante 50
chertas3: posts small blind 400
14129088: posts big blind 800
*** HOLE CARDS ***
Dealt to dfcastro.net [6c Ts]
Silvaa.10: folds 
dfcastro.net: folds 
chertas3: folds 
Uncalled bet (400) returned to 14129088
14129088 collected 1000 from pot
14129088: doesn't show hand 
*** SUMMARY ***
Total pot 1000 | Rake 0 
Seat 2: dfcastro.net (button) folded before Flop (didn't bet)
Seat 6: chertas3 (small blind) folded before Flop
Seat 7: 14129088 (big blind) collected (1000)
Seat 9: Silvaa.10 folded before Flop (didn't bet)



PokerStars Hand #100389314765: Tournament #750518676, $0.23+$0.02 USD Hold'em No Limit - Level XI (400/800) - 2013/06/21 22:08:22 BRT [2013/06/21 21:08:22 ET]
Table '750518676 2' 9-max Seat #6 is the button
Seat 2: dfcastro.net (13848 in chips) 
Seat 6: chertas3 (11964 in chips) 
Seat 7: 14129088 (13567 in chips) 
Seat 9: Silvaa.10 (28121 in chips) 
dfcastro.net: posts the ante 50
chertas3: posts the ante 50
14129088: posts the ante 50
Silvaa.10: posts the ante 50
14129088: posts small blind 400
Silvaa.10: posts big blind 800
*** HOLE CARDS ***
Dealt to dfcastro.net [4d 2d]
dfcastro.net: folds 
chertas3: raises 880 to 1680
14129088: folds 
Silvaa.10: calls 880
*** FLOP *** [Th Js 2h]
Silvaa.10: checks 
chertas3: checks 
*** TURN *** [Th Js 2h] [Jd]
Silvaa.10: checks 
chertas3: bets 1600
Silvaa.10: folds 
Uncalled bet (1600) returned to chertas3
chertas3 collected 3960 from pot
chertas3: doesn't show hand 
*** SUMMARY ***
Total pot 3960 | Rake 0 
Board [Th Js 2h Jd]
Seat 2: dfcastro.net folded before Flop (didn't bet)
Seat 6: chertas3 (button) collected (3960)
Seat 7: 14129088 (small blind) folded before Flop
Seat 9: Silvaa.10 (big blind) folded on the Turn



PokerStars Hand #100389330980: Tournament #750518676, $0.23+$0.02 USD Hold'em No Limit - Level XI (400/800) - 2013/06/21 22:08:57 BRT [2013/06/21 21:08:57 ET]
Table '750518676 2' 9-max Seat #7 is the button
Seat 2: dfcastro.net (13798 in chips) 
Seat 6: chertas3 (14194 in chips) 
Seat 7: 14129088 (13117 in chips) 
Seat 9: Silvaa.10 (26391 in chips) 
dfcastro.net: posts the ante 50
chertas3: posts the ante 50
14129088: posts the ante 50
Silvaa.10: posts the ante 50
Silvaa.10: posts small blind 400
dfcastro.net: posts big blind 800
*** HOLE CARDS ***
Dealt to dfcastro.net [Ks 5c]
chertas3: folds 
14129088: raises 800 to 1600
Silvaa.10: folds 
dfcastro.net: calls 800
*** FLOP *** [6c 5d 4c]
dfcastro.net: checks 
14129088: bets 2400
dfcastro.net: calls 2400
*** TURN *** [6c 5d 4c] [4d]
dfcastro.net: checks 
14129088: checks 
*** RIVER *** [6c 5d 4c 4d] [Kh]
dfcastro.net: bets 4000
14129088: calls 4000
*** SHOW DOWN ***
dfcastro.net: shows [Ks 5c] (two pair, Kings and Fives)
14129088: mucks hand 
dfcastro.net collected 16600 from pot
*** SUMMARY ***
Total pot 16600 | Rake 0 
Board [6c 5d 4c 4d Kh]
Seat 2: dfcastro.net (big blind) showed [Ks 5c] and won (16600) with two pair, Kings and Fives
Seat 6: chertas3 folded before Flop (didn't bet)
Seat 7: 14129088 (button) mucked [8d Kd]
Seat 9: Silvaa.10 (small blind) folded before Flop



PokerStars Hand #100389359777: Tournament #750518676, $0.23+$0.02 USD Hold'em No Limit - Level XI (400/800) - 2013/06/21 22:10:01 BRT [2013/06/21 21:10:01 ET]
Table '750518676 2' 9-max Seat #9 is the button
Seat 2: dfcastro.net (22348 in chips) 
Seat 6: chertas3 (14144 in chips) 
Seat 7: 14129088 (5067 in chips) 
Seat 9: Silvaa.10 (25941 in chips) 
dfcastro.net: posts the ante 50
chertas3: posts the ante 50
14129088: posts the ante 50
Silvaa.10: posts the ante 50
dfcastro.net: posts small blind 400
chertas3: posts big blind 800
*** HOLE CARDS ***
Dealt to dfcastro.net [8s As]
14129088: folds 
Silvaa.10: calls 800
dfcastro.net: calls 400
chertas3: checks 
*** FLOP *** [Jd 7h 9s]
dfcastro.net: checks 
chertas3: checks 
Silvaa.10: bets 1600
dfcastro.net: folds 
chertas3: folds 
Uncalled bet (1600) returned to Silvaa.10
Silvaa.10 collected 2600 from pot
*** SUMMARY ***
Total pot 2600 | Rake 0 
Board [Jd 7h 9s]
Seat 2: dfcastro.net (small blind) folded on the Flop
Seat 6: chertas3 (big blind) folded on the Flop
Seat 7: 14129088 folded before Flop (didn't bet)
Seat 9: Silvaa.10 (button) collected (2600)



PokerStars Hand #100389373733: Tournament #750518676, $0.23+$0.02 USD Hold'em No Limit - Level XI (400/800) - 2013/06/21 22:10:32 BRT [2013/06/21 21:10:32 ET]
Table '750518676 2' 9-max Seat #2 is the button
Seat 2: dfcastro.net (21498 in chips) 
Seat 6: chertas3 (13294 in chips) 
Seat 7: 14129088 (5017 in chips) 
Seat 9: Silvaa.10 (27691 in chips) 
dfcastro.net: posts the ante 50
chertas3: posts the ante 50
14129088: posts the ante 50
Silvaa.10: posts the ante 50
chertas3: posts small blind 400
14129088: posts big blind 800
*** HOLE CARDS ***
Dealt to dfcastro.net [Qh Kd]
Silvaa.10: folds 
dfcastro.net: raises 1600 to 2400
chertas3: folds 
14129088: folds 
Uncalled bet (1600) returned to dfcastro.net
dfcastro.net collected 2200 from pot
dfcastro.net: doesn't show hand 
*** SUMMARY ***
Total pot 2200 | Rake 0 
Seat 2: dfcastro.net (button) collected (2200)
Seat 6: chertas3 (small blind) folded before Flop
Seat 7: 14129088 (big blind) folded before Flop
Seat 9: Silvaa.10 folded before Flop (didn't bet)



PokerStars Hand #100389380531: Tournament #750518676, $0.23+$0.02 USD Hold'em No Limit - Level XI (400/800) - 2013/06/21 22:10:47 BRT [2013/06/21 21:10:47 ET]
Table '750518676 2' 9-max Seat #6 is the button
Seat 2: dfcastro.net (22848 in chips) 
Seat 6: chertas3 (12844 in chips) 
Seat 7: 14129088 (4167 in chips) 
Seat 9: Silvaa.10 (27641 in chips) 
dfcastro.net: posts the ante 50
chertas3: posts the ante 50
14129088: posts the ante 50
Silvaa.10: posts the ante 50
14129088: posts small blind 400
Silvaa.10: posts big blind 800
*** HOLE CARDS ***
Dealt to dfcastro.net [9h 5s]
dfcastro.net: folds 
chertas3: folds 
14129088: raises 3317 to 4117 and is all-in
Silvaa.10: folds 
Uncalled bet (3317) returned to 14129088
14129088 collected 1800 from pot
14129088: doesn't show hand 
*** SUMMARY ***
Total pot 1800 | Rake 0 
Seat 2: dfcastro.net folded before Flop (didn't bet)
Seat 6: chertas3 (button) folded before Flop (didn't bet)
Seat 7: 14129088 (small blind) collected (1800)
Seat 9: Silvaa.10 (big blind) folded before Flop



PokerStars Hand #100389389425: Tournament #750518676, $0.23+$0.02 USD Hold'em No Limit - Level XI (400/800) - 2013/06/21 22:11:06 BRT [2013/06/21 21:11:06 ET]
Table '750518676 2' 9-max Seat #7 is the button
Seat 2: dfcastro.net (22798 in chips) 
Seat 6: chertas3 (12794 in chips) 
Seat 7: 14129088 (5117 in chips) 
Seat 9: Silvaa.10 (26791 in chips) 
dfcastro.net: posts the ante 50
chertas3: posts the ante 50
14129088: posts the ante 50
Silvaa.10: posts the ante 50
Silvaa.10: posts small blind 400
dfcastro.net: posts big blind 800
*** HOLE CARDS ***
Dealt to dfcastro.net [7h Kd]
chertas3: folds 
14129088: raises 4267 to 5067 and is all-in
Silvaa.10: folds 
dfcastro.net: folds 
Uncalled bet (4267) returned to 14129088
14129088 collected 2200 from pot
14129088: doesn't show hand 
*** SUMMARY ***
Total pot 2200 | Rake 0 
Seat 2: dfcastro.net (big blind) folded before Flop
Seat 6: chertas3 folded before Flop (didn't bet)
Seat 7: 14129088 (button) collected (2200)
Seat 9: Silvaa.10 (small blind) folded before Flop



PokerStars Hand #100389395182: Tournament #750518676, $0.23+$0.02 USD Hold'em No Limit - Level XI (400/800) - 2013/06/21 22:11:19 BRT [2013/06/21 21:11:19 ET]
Table '750518676 2' 9-max Seat #9 is the button
Seat 2: dfcastro.net (21948 in chips) 
Seat 6: chertas3 (12744 in chips) 
Seat 7: 14129088 (6467 in chips) 
Seat 9: Silvaa.10 (26341 in chips) 
dfcastro.net: posts the ante 50
chertas3: posts the ante 50
14129088: posts the ante 50
Silvaa.10: posts the ante 50
dfcastro.net: posts small blind 400
chertas3: posts big blind 800
*** HOLE CARDS ***
Dealt to dfcastro.net [Qc Ac]
14129088: folds 
Silvaa.10: folds 
dfcastro.net: raises 1600 to 2400
chertas3: folds 
Uncalled bet (1600) returned to dfcastro.net
dfcastro.net collected 1800 from pot
dfcastro.net: doesn't show hand 
*** SUMMARY ***
Total pot 1800 | Rake 0 
Seat 2: dfcastro.net (small blind) collected (1800)
Seat 6: chertas3 (big blind) folded before Flop
Seat 7: 14129088 folded before Flop (didn't bet)
Seat 9: Silvaa.10 (button) folded before Flop (didn't bet)



PokerStars Hand #100389404713: Tournament #750518676, $0.23+$0.02 USD Hold'em No Limit - Level XI (400/800) - 2013/06/21 22:11:40 BRT [2013/06/21 21:11:40 ET]
Table '750518676 2' 9-max Seat #2 is the button
Seat 2: dfcastro.net (22898 in chips) 
Seat 6: chertas3 (11894 in chips) 
Seat 7: 14129088 (6417 in chips) 
Seat 9: Silvaa.10 (26291 in chips) 
dfcastro.net: posts the ante 50
chertas3: posts the ante 50
14129088: posts the ante 50
Silvaa.10: posts the ante 50
chertas3: posts small blind 400
14129088: posts big blind 800
*** HOLE CARDS ***
Dealt to dfcastro.net [4c 2h]
Silvaa.10: folds 
dfcastro.net: folds 
chertas3: raises 7200 to 8000
14129088: calls 5567 and is all-in
Uncalled bet (1633) returned to chertas3
*** FLOP *** [9c Ks 8h]
*** TURN *** [9c Ks 8h] [3h]
*** RIVER *** [9c Ks 8h 3h] [Ad]
*** SHOW DOWN ***
chertas3: shows [5h Qd] (high card Ace)
14129088: shows [9s 8d] (two pair, Nines and Eights)
14129088 collected 12934 from pot
*** SUMMARY ***
Total pot 12934 | Rake 0 
Board [9c Ks 8h 3h Ad]
Seat 2: dfcastro.net (button) folded before Flop (didn't bet)
Seat 6: chertas3 (small blind) showed [5h Qd] and lost with high card Ace
Seat 7: 14129088 (big blind) showed [9s 8d] and won (12934) with two pair, Nines and Eights
Seat 9: Silvaa.10 folded before Flop (didn't bet)



PokerStars Hand #100389420120: Tournament #750518676, $0.23+$0.02 USD Hold'em No Limit - Level XI (400/800) - 2013/06/21 22:12:15 BRT [2013/06/21 21:12:15 ET]
Table '750518676 2' 9-max Seat #6 is the button
Seat 2: dfcastro.net (22848 in chips) 
Seat 6: chertas3 (5477 in chips) 
Seat 7: 14129088 (12934 in chips) 
Seat 9: Silvaa.10 (26241 in chips) 
dfcastro.net: posts the ante 50
chertas3: posts the ante 50
14129088: posts the ante 50
Silvaa.10: posts the ante 50
14129088: posts small blind 400
Silvaa.10: posts big blind 800
*** HOLE CARDS ***
Dealt to dfcastro.net [6s 4d]
dfcastro.net: folds 
chertas3: folds 
14129088: raises 800 to 1600
Silvaa.10: folds 
Uncalled bet (800) returned to 14129088
14129088 collected 1800 from pot
14129088: doesn't show hand 
*** SUMMARY ***
Total pot 1800 | Rake 0 
Seat 2: dfcastro.net folded before Flop (didn't bet)
Seat 6: chertas3 (button) folded before Flop (didn't bet)
Seat 7: 14129088 (small blind) collected (1800)
Seat 9: Silvaa.10 (big blind) folded before Flop



PokerStars Hand #100389426903: Tournament #750518676, $0.23+$0.02 USD Hold'em No Limit - Level XI (400/800) - 2013/06/21 22:12:30 BRT [2013/06/21 21:12:30 ET]
Table '750518676 2' 9-max Seat #7 is the button
Seat 2: dfcastro.net (22798 in chips) 
Seat 6: chertas3 (5427 in chips) 
Seat 7: 14129088 (13884 in chips) 
Seat 9: Silvaa.10 (25391 in chips) 
dfcastro.net: posts the ante 50
chertas3: posts the ante 50
14129088: posts the ante 50
Silvaa.10: posts the ante 50
Silvaa.10: posts small blind 400
dfcastro.net: posts big blind 800
*** HOLE CARDS ***
Dealt to dfcastro.net [Jh 6s]
chertas3: raises 4577 to 5377 and is all-in
14129088: folds 
Silvaa.10: folds 
dfcastro.net: folds 
Uncalled bet (4577) returned to chertas3
chertas3 collected 2200 from pot
chertas3: doesn't show hand 
*** SUMMARY ***
Total pot 2200 | Rake 0 
Seat 2: dfcastro.net (big blind) folded before Flop
Seat 6: chertas3 collected (2200)
Seat 7: 14129088 (button) folded before Flop (didn't bet)
Seat 9: Silvaa.10 (small blind) folded before Flop



PokerStars Hand #100389444819: Tournament #750518676, $0.23+$0.02 USD Hold'em No Limit - Level XII (500/1000) - 2013/06/21 22:13:09 BRT [2013/06/21 21:13:09 ET]
Table '750518676 2' 9-max Seat #9 is the button
Seat 2: dfcastro.net (21948 in chips) 
Seat 6: chertas3 (6777 in chips) 
Seat 7: 14129088 (13834 in chips) 
Seat 9: Silvaa.10 (24941 in chips) 
dfcastro.net: posts the ante 60
chertas3: posts the ante 60
14129088: posts the ante 60
Silvaa.10: posts the ante 60
dfcastro.net: posts small blind 500
chertas3: posts big blind 1000
*** HOLE CARDS ***
Dealt to dfcastro.net [Qd 2s]
14129088: folds 
Silvaa.10: folds 
dfcastro.net: folds 
Uncalled bet (500) returned to chertas3
chertas3 collected 1240 from pot
chertas3: doesn't show hand 
*** SUMMARY ***
Total pot 1240 | Rake 0 
Seat 2: dfcastro.net (small blind) folded before Flop
Seat 6: chertas3 (big blind) collected (1240)
Seat 7: 14129088 folded before Flop (didn't bet)
Seat 9: Silvaa.10 (button) folded before Flop (didn't bet)



PokerStars Hand #100389450955: Tournament #750518676, $0.23+$0.02 USD Hold'em No Limit - Level XII (500/1000) - 2013/06/21 22:13:23 BRT [2013/06/21 21:13:23 ET]
Table '750518676 2' 9-max Seat #2 is the button
Seat 2: dfcastro.net (21388 in chips) 
Seat 6: chertas3 (7457 in chips) 
Seat 7: 14129088 (13774 in chips) 
Seat 9: Silvaa.10 (24881 in chips) 
dfcastro.net: posts the ante 60
chertas3: posts the ante 60
14129088: posts the ante 60
Silvaa.10: posts the ante 60
chertas3: posts small blind 500
14129088: posts big blind 1000
*** HOLE CARDS ***
Dealt to dfcastro.net [2s Kd]
Silvaa.10: folds 
dfcastro.net: folds 
chertas3: folds 
Uncalled bet (500) returned to 14129088
14129088 collected 1240 from pot
14129088: doesn't show hand 
*** SUMMARY ***
Total pot 1240 | Rake 0 
Seat 2: dfcastro.net (button) folded before Flop (didn't bet)
Seat 6: chertas3 (small blind) folded before Flop
Seat 7: 14129088 (big blind) collected (1240)
Seat 9: Silvaa.10 folded before Flop (didn't bet)



PokerStars Hand #100389462151: Tournament #750518676, $0.23+$0.02 USD Hold'em No Limit - Level XII (500/1000) - 2013/06/21 22:13:48 BRT [2013/06/21 21:13:48 ET]
Table '750518676 2' 9-max Seat #6 is the button
Seat 2: dfcastro.net (21328 in chips) 
Seat 6: chertas3 (6897 in chips) 
Seat 7: 14129088 (14454 in chips) 
Seat 9: Silvaa.10 (24821 in chips) 
dfcastro.net: posts the ante 60
chertas3: posts the ante 60
14129088: posts the ante 60
Silvaa.10: posts the ante 60
14129088: posts small blind 500
Silvaa.10: posts big blind 1000
*** HOLE CARDS ***
Dealt to dfcastro.net [Qc Ac]
dfcastro.net: raises 2000 to 3000
chertas3: folds 
14129088: folds 
Silvaa.10: folds 
Uncalled bet (2000) returned to dfcastro.net
dfcastro.net collected 2740 from pot
dfcastro.net: doesn't show hand 
*** SUMMARY ***
Total pot 2740 | Rake 0 
Seat 2: dfcastro.net collected (2740)
Seat 6: chertas3 (button) folded before Flop (didn't bet)
Seat 7: 14129088 (small blind) folded before Flop
Seat 9: Silvaa.10 (big blind) folded before Flop



PokerStars Hand #100389469405: Tournament #750518676, $0.23+$0.02 USD Hold'em No Limit - Level XII (500/1000) - 2013/06/21 22:14:04 BRT [2013/06/21 21:14:04 ET]
Table '750518676 2' 9-max Seat #7 is the button
Seat 2: dfcastro.net (23008 in chips) 
Seat 6: chertas3 (6837 in chips) 
Seat 7: 14129088 (13894 in chips) 
Seat 9: Silvaa.10 (23761 in chips) 
dfcastro.net: posts the ante 60
chertas3: posts the ante 60
14129088: posts the ante 60
Silvaa.10: posts the ante 60
Silvaa.10: posts small blind 500
dfcastro.net: posts big blind 1000
*** HOLE CARDS ***
Dealt to dfcastro.net [6c Jh]
chertas3: raises 5777 to 6777 and is all-in
14129088: folds 
Silvaa.10: folds 
dfcastro.net: folds 
Uncalled bet (5777) returned to chertas3
chertas3 collected 2740 from pot
chertas3: doesn't show hand 
*** SUMMARY ***
Total pot 2740 | Rake 0 
Seat 2: dfcastro.net (big blind) folded before Flop
Seat 6: chertas3 collected (2740)
Seat 7: 14129088 (button) folded before Flop (didn't bet)
Seat 9: Silvaa.10 (small blind) folded before Flop



PokerStars Hand #100389476708: Tournament #750518676, $0.23+$0.02 USD Hold'em No Limit - Level XII (500/1000) - 2013/06/21 22:14:20 BRT [2013/06/21 21:14:20 ET]
Table '750518676 2' 9-max Seat #9 is the button
Seat 2: dfcastro.net (21948 in chips) 
Seat 6: chertas3 (8517 in chips) 
Seat 7: 14129088 (13834 in chips) 
Seat 9: Silvaa.10 (23201 in chips) 
dfcastro.net: posts the ante 60
chertas3: posts the ante 60
14129088: posts the ante 60
Silvaa.10: posts the ante 60
dfcastro.net: posts small blind 500
chertas3: posts big blind 1000
*** HOLE CARDS ***
Dealt to dfcastro.net [9h 6c]
14129088: raises 12774 to 13774 and is all-in
Silvaa.10: folds 
dfcastro.net: folds 
chertas3: folds 
Uncalled bet (12774) returned to 14129088
14129088 collected 2740 from pot
14129088: doesn't show hand 
*** SUMMARY ***
Total pot 2740 | Rake 0 
Seat 2: dfcastro.net (small blind) folded before Flop
Seat 6: chertas3 (big blind) folded before Flop
Seat 7: 14129088 collected (2740)
Seat 9: Silvaa.10 (button) folded before Flop (didn't bet)



PokerStars Hand #100389490016: Tournament #750518676, $0.23+$0.02 USD Hold'em No Limit - Level XII (500/1000) - 2013/06/21 22:14:50 BRT [2013/06/21 21:14:50 ET]
Table '750518676 2' 9-max Seat #2 is the button
Seat 2: dfcastro.net (21388 in chips) 
Seat 6: chertas3 (7457 in chips) 
Seat 7: 14129088 (15514 in chips) 
Seat 9: Silvaa.10 (23141 in chips) 
dfcastro.net: posts the ante 60
chertas3: posts the ante 60
14129088: posts the ante 60
Silvaa.10: posts the ante 60
chertas3: posts small blind 500
14129088: posts big blind 1000
*** HOLE CARDS ***
Dealt to dfcastro.net [Th 2s]
Silvaa.10: folds 
dfcastro.net: folds 
chertas3: folds 
Uncalled bet (500) returned to 14129088
14129088 collected 1240 from pot
14129088: doesn't show hand 
*** SUMMARY ***
Total pot 1240 | Rake 0 
Seat 2: dfcastro.net (button) folded before Flop (didn't bet)
Seat 6: chertas3 (small blind) folded before Flop
Seat 7: 14129088 (big blind) collected (1240)
Seat 9: Silvaa.10 folded before Flop (didn't bet)



PokerStars Hand #100389495145: Tournament #750518676, $0.23+$0.02 USD Hold'em No Limit - Level XII (500/1000) - 2013/06/21 22:15:01 BRT [2013/06/21 21:15:01 ET]
Table '750518676 2' 9-max Seat #6 is the button
Seat 2: dfcastro.net (21328 in chips) 
Seat 6: chertas3 (6897 in chips) 
Seat 7: 14129088 (16194 in chips) 
Seat 9: Silvaa.10 (23081 in chips) 
dfcastro.net: posts the ante 60
chertas3: posts the ante 60
14129088: posts the ante 60
Silvaa.10: posts the ante 60
14129088: posts small blind 500
Silvaa.10: posts big blind 1000
*** HOLE CARDS ***
Dealt to dfcastro.net [Kd 7s]
dfcastro.net: folds 
chertas3: raises 5837 to 6837 and is all-in
14129088: folds 
Silvaa.10: folds 
Uncalled bet (5837) returned to chertas3
chertas3 collected 2740 from pot
chertas3: doesn't show hand 
*** SUMMARY ***
Total pot 2740 | Rake 0 
Seat 2: dfcastro.net folded before Flop (didn't bet)
Seat 6: chertas3 (button) collected (2740)
Seat 7: 14129088 (small blind) folded before Flop
Seat 9: Silvaa.10 (big blind) folded before Flop



PokerStars Hand #100389501119: Tournament #750518676, $0.23+$0.02 USD Hold'em No Limit - Level XII (500/1000) - 2013/06/21 22:15:14 BRT [2013/06/21 21:15:14 ET]
Table '750518676 2' 9-max Seat #7 is the button
Seat 2: dfcastro.net (21268 in chips) 
Seat 6: chertas3 (8577 in chips) 
Seat 7: 14129088 (15634 in chips) 
Seat 9: Silvaa.10 (22021 in chips) 
dfcastro.net: posts the ante 60
chertas3: posts the ante 60
14129088: posts the ante 60
Silvaa.10: posts the ante 60
Silvaa.10: posts small blind 500
dfcastro.net: posts big blind 1000
*** HOLE CARDS ***
Dealt to dfcastro.net [6h 2d]
chertas3: raises 7517 to 8517 and is all-in
14129088: folds 
Silvaa.10: folds 
dfcastro.net: folds 
Uncalled bet (7517) returned to chertas3
chertas3 collected 2740 from pot
chertas3: doesn't show hand 
*** SUMMARY ***
Total pot 2740 | Rake 0 
Seat 2: dfcastro.net (big blind) folded before Flop
Seat 6: chertas3 collected (2740)
Seat 7: 14129088 (button) folded before Flop (didn't bet)
Seat 9: Silvaa.10 (small blind) folded before Flop



PokerStars Hand #100389509611: Tournament #750518676, $0.23+$0.02 USD Hold'em No Limit - Level XII (500/1000) - 2013/06/21 22:15:33 BRT [2013/06/21 21:15:33 ET]
Table '750518676 2' 9-max Seat #9 is the button
Seat 2: dfcastro.net (20208 in chips) 
Seat 6: chertas3 (10257 in chips) 
Seat 7: 14129088 (15574 in chips) 
Seat 9: Silvaa.10 (21461 in chips) 
dfcastro.net: posts the ante 60
chertas3: posts the ante 60
14129088: posts the ante 60
Silvaa.10: posts the ante 60
dfcastro.net: posts small blind 500
chertas3: posts big blind 1000
*** HOLE CARDS ***
Dealt to dfcastro.net [Ad 3h]
14129088: folds 
Silvaa.10: folds 
dfcastro.net: raises 2000 to 3000
chertas3: raises 7197 to 10197 and is all-in
dfcastro.net: folds 
Uncalled bet (7197) returned to chertas3
chertas3 collected 6240 from pot
chertas3: doesn't show hand 
*** SUMMARY ***
Total pot 6240 | Rake 0 
Seat 2: dfcastro.net (small blind) folded before Flop
Seat 6: chertas3 (big blind) collected (6240)
Seat 7: 14129088 folded before Flop (didn't bet)
Seat 9: Silvaa.10 (button) folded before Flop (didn't bet)



PokerStars Hand #100389518871: Tournament #750518676, $0.23+$0.02 USD Hold'em No Limit - Level XII (500/1000) - 2013/06/21 22:15:54 BRT [2013/06/21 21:15:54 ET]
Table '750518676 2' 9-max Seat #2 is the button
Seat 2: dfcastro.net (17148 in chips) 
Seat 6: chertas3 (13437 in chips) 
Seat 7: 14129088 (15514 in chips) 
Seat 9: Silvaa.10 (21401 in chips) 
dfcastro.net: posts the ante 60
chertas3: posts the ante 60
14129088: posts the ante 60
Silvaa.10: posts the ante 60
chertas3: posts small blind 500
14129088: posts big blind 1000
*** HOLE CARDS ***
Dealt to dfcastro.net [Td 4s]
Silvaa.10: folds 
dfcastro.net: folds 
chertas3: folds 
Uncalled bet (500) returned to 14129088
14129088 collected 1240 from pot
14129088: doesn't show hand 
*** SUMMARY ***
Total pot 1240 | Rake 0 
Seat 2: dfcastro.net (button) folded before Flop (didn't bet)
Seat 6: chertas3 (small blind) folded before Flop
Seat 7: 14129088 (big blind) collected (1240)
Seat 9: Silvaa.10 folded before Flop (didn't bet)



PokerStars Hand #100389524785: Tournament #750518676, $0.23+$0.02 USD Hold'em No Limit - Level XII (500/1000) - 2013/06/21 22:16:07 BRT [2013/06/21 21:16:07 ET]
Table '750518676 2' 9-max Seat #6 is the button
Seat 2: dfcastro.net (17088 in chips) 
Seat 6: chertas3 (12877 in chips) 
Seat 7: 14129088 (16194 in chips) 
Seat 9: Silvaa.10 (21341 in chips) 
dfcastro.net: posts the ante 60
chertas3: posts the ante 60
14129088: posts the ante 60
Silvaa.10: posts the ante 60
14129088: posts small blind 500
Silvaa.10: posts big blind 1000
*** HOLE CARDS ***
Dealt to dfcastro.net [Tc As]
dfcastro.net: raises 2000 to 3000
chertas3: folds 
14129088: folds 
Silvaa.10: folds 
Uncalled bet (2000) returned to dfcastro.net
dfcastro.net collected 2740 from pot
dfcastro.net: doesn't show hand 
*** SUMMARY ***
Total pot 2740 | Rake 0 
Seat 2: dfcastro.net collected (2740)
Seat 6: chertas3 (button) folded before Flop (didn't bet)
Seat 7: 14129088 (small blind) folded before Flop
Seat 9: Silvaa.10 (big blind) folded before Flop



PokerStars Hand #100389532023: Tournament #750518676, $0.23+$0.02 USD Hold'em No Limit - Level XII (500/1000) - 2013/06/21 22:16:23 BRT [2013/06/21 21:16:23 ET]
Table '750518676 2' 9-max Seat #7 is the button
Seat 2: dfcastro.net (18768 in chips) 
Seat 6: chertas3 (12817 in chips) 
Seat 7: 14129088 (15634 in chips) 
Seat 9: Silvaa.10 (20281 in chips) 
dfcastro.net: posts the ante 60
chertas3: posts the ante 60
14129088: posts the ante 60
Silvaa.10: posts the ante 60
Silvaa.10: posts small blind 500
dfcastro.net: posts big blind 1000
*** HOLE CARDS ***
Dealt to dfcastro.net [Ac Ks]
chertas3: folds 
14129088: folds 
Silvaa.10: calls 500
dfcastro.net: raises 3000 to 4000
Silvaa.10: folds 
Uncalled bet (3000) returned to dfcastro.net
dfcastro.net collected 2240 from pot
dfcastro.net: doesn't show hand 
*** SUMMARY ***
Total pot 2240 | Rake 0 
Seat 2: dfcastro.net (big blind) collected (2240)
Seat 6: chertas3 folded before Flop (didn't bet)
Seat 7: 14129088 (button) folded before Flop (didn't bet)
Seat 9: Silvaa.10 (small blind) folded before Flop



PokerStars Hand #100389543433: Tournament #750518676, $0.23+$0.02 USD Hold'em No Limit - Level XII (500/1000) - 2013/06/21 22:16:48 BRT [2013/06/21 21:16:48 ET]
Table '750518676 2' 9-max Seat #9 is the button
Seat 2: dfcastro.net (19948 in chips) 
Seat 6: chertas3 (12757 in chips) 
Seat 7: 14129088 (15574 in chips) 
Seat 9: Silvaa.10 (19221 in chips) 
dfcastro.net: posts the ante 60
chertas3: posts the ante 60
14129088: posts the ante 60
Silvaa.10: posts the ante 60
dfcastro.net: posts small blind 500
chertas3: posts big blind 1000
*** HOLE CARDS ***
Dealt to dfcastro.net [Jd 3s]
14129088: folds 
Silvaa.10: folds 
dfcastro.net: folds 
Uncalled bet (500) returned to chertas3
chertas3 collected 1240 from pot
chertas3: doesn't show hand 
*** SUMMARY ***
Total pot 1240 | Rake 0 
Seat 2: dfcastro.net (small blind) folded before Flop
Seat 6: chertas3 (big blind) collected (1240)
Seat 7: 14129088 folded before Flop (didn't bet)
Seat 9: Silvaa.10 (button) folded before Flop (didn't bet)



PokerStars Hand #100389548027: Tournament #750518676, $0.23+$0.02 USD Hold'em No Limit - Level XII (500/1000) - 2013/06/21 22:16:59 BRT [2013/06/21 21:16:59 ET]
Table '750518676 2' 9-max Seat #2 is the button
Seat 2: dfcastro.net (19388 in chips) 
Seat 6: chertas3 (13437 in chips) 
Seat 7: 14129088 (15514 in chips) 
Seat 9: Silvaa.10 (19161 in chips) 
dfcastro.net: posts the ante 60
chertas3: posts the ante 60
14129088: posts the ante 60
Silvaa.10: posts the ante 60
chertas3: posts small blind 500
14129088: posts big blind 1000
*** HOLE CARDS ***
Dealt to dfcastro.net [8s Ts]
Silvaa.10: folds 
dfcastro.net: folds 
chertas3: folds 
Uncalled bet (500) returned to 14129088
14129088 collected 1240 from pot
14129088: doesn't show hand 
*** SUMMARY ***
Total pot 1240 | Rake 0 
Seat 2: dfcastro.net (button) folded before Flop (didn't bet)
Seat 6: chertas3 (small blind) folded before Flop
Seat 7: 14129088 (big blind) collected (1240)
Seat 9: Silvaa.10 folded before Flop (didn't bet)



PokerStars Hand #100389557547: Tournament #750518676, $0.23+$0.02 USD Hold'em No Limit - Level XII (500/1000) - 2013/06/21 22:17:20 BRT [2013/06/21 21:17:20 ET]
Table '750518676 2' 9-max Seat #6 is the button
Seat 2: dfcastro.net (19328 in chips) 
Seat 6: chertas3 (12877 in chips) 
Seat 7: 14129088 (16194 in chips) 
Seat 9: Silvaa.10 (19101 in chips) 
dfcastro.net: posts the ante 60
chertas3: posts the ante 60
14129088: posts the ante 60
Silvaa.10: posts the ante 60
14129088: posts small blind 500
Silvaa.10: posts big blind 1000
*** HOLE CARDS ***
Dealt to dfcastro.net [6s 2h]
dfcastro.net: folds 
chertas3: folds 
14129088: raises 1000 to 2000
Silvaa.10: calls 1000
*** FLOP *** [Kc 5s Qd]
14129088: bets 3000
Silvaa.10: folds 
Uncalled bet (3000) returned to 14129088
14129088 collected 4240 from pot
14129088: doesn't show hand 
*** SUMMARY ***
Total pot 4240 | Rake 0 
Board [Kc 5s Qd]
Seat 2: dfcastro.net folded before Flop (didn't bet)
Seat 6: chertas3 (button) folded before Flop (didn't bet)
Seat 7: 14129088 (small blind) collected (4240)
Seat 9: Silvaa.10 (big blind) folded on the Flop



PokerStars Hand #100389568904: Tournament #750518676, $0.23+$0.02 USD Hold'em No Limit - Level XII (500/1000) - 2013/06/21 22:17:45 BRT [2013/06/21 21:17:45 ET]
Table '750518676 2' 9-max Seat #7 is the button
Seat 2: dfcastro.net (19268 in chips) 
Seat 6: chertas3 (12817 in chips) 
Seat 7: 14129088 (18374 in chips) 
Seat 9: Silvaa.10 (17041 in chips) 
dfcastro.net: posts the ante 60
chertas3: posts the ante 60
14129088: posts the ante 60
Silvaa.10: posts the ante 60
Silvaa.10: posts small blind 500
dfcastro.net: posts big blind 1000
*** HOLE CARDS ***
Dealt to dfcastro.net [2d 7h]
chertas3: folds 
14129088: folds 
Silvaa.10: folds 
Uncalled bet (500) returned to dfcastro.net
dfcastro.net collected 1240 from pot
dfcastro.net: doesn't show hand 
*** SUMMARY ***
Total pot 1240 | Rake 0 
Seat 2: dfcastro.net (big blind) collected (1240)
Seat 6: chertas3 folded before Flop (didn't bet)
Seat 7: 14129088 (button) folded before Flop (didn't bet)
Seat 9: Silvaa.10 (small blind) folded before Flop



PokerStars Hand #100389573195: Tournament #750518676, $0.23+$0.02 USD Hold'em No Limit - Level XII (500/1000) - 2013/06/21 22:17:55 BRT [2013/06/21 21:17:55 ET]
Table '750518676 2' 9-max Seat #9 is the button
Seat 2: dfcastro.net (19948 in chips) 
Seat 6: chertas3 (12757 in chips) 
Seat 7: 14129088 (18314 in chips) 
Seat 9: Silvaa.10 (16481 in chips) 
dfcastro.net: posts the ante 60
chertas3: posts the ante 60
14129088: posts the ante 60
Silvaa.10: posts the ante 60
dfcastro.net: posts small blind 500
chertas3: posts big blind 1000
*** HOLE CARDS ***
Dealt to dfcastro.net [Ks 5d]
14129088: folds 
Silvaa.10: folds 
dfcastro.net: folds 
Uncalled bet (500) returned to chertas3
chertas3 collected 1240 from pot
chertas3: doesn't show hand 
*** SUMMARY ***
Total pot 1240 | Rake 0 
Seat 2: dfcastro.net (small blind) folded before Flop
Seat 6: chertas3 (big blind) collected (1240)
Seat 7: 14129088 folded before Flop (didn't bet)
Seat 9: Silvaa.10 (button) folded before Flop (didn't bet)



PokerStars Hand #100389578552: Tournament #750518676, $0.23+$0.02 USD Hold'em No Limit - Level XII (500/1000) - 2013/06/21 22:18:07 BRT [2013/06/21 21:18:07 ET]
Table '750518676 2' 9-max Seat #2 is the button
Seat 2: dfcastro.net (19388 in chips) 
Seat 6: chertas3 (13437 in chips) 
Seat 7: 14129088 (18254 in chips) 
Seat 9: Silvaa.10 (16421 in chips) 
dfcastro.net: posts the ante 60
chertas3: posts the ante 60
14129088: posts the ante 60
Silvaa.10: posts the ante 60
chertas3: posts small blind 500
14129088: posts big blind 1000
*** HOLE CARDS ***
Dealt to dfcastro.net [5d 2s]
Silvaa.10: raises 1000 to 2000
dfcastro.net: folds 
chertas3: folds 
14129088: raises 16194 to 18194 and is all-in
Silvaa.10: calls 14361 and is all-in
Uncalled bet (1833) returned to 14129088
*** FLOP *** [Ad 5h 4h]
*** TURN *** [Ad 5h 4h] [8h]
*** RIVER *** [Ad 5h 4h 8h] [Kc]
*** SHOW DOWN ***
14129088: shows [Qh Kh] (a flush, King high)
Silvaa.10: shows [Jc Js] (a pair of Jacks)
14129088 collected 33462 from pot
Silvaa.10 finished the tournament in 4th place and received $1.29.
*** SUMMARY ***
Total pot 33462 | Rake 0 
Board [Ad 5h 4h 8h Kc]
Seat 2: dfcastro.net (button) folded before Flop (didn't bet)
Seat 6: chertas3 (small blind) folded before Flop
Seat 7: 14129088 (big blind) showed [Qh Kh] and won (33462) with a flush, King high
Seat 9: Silvaa.10 showed [Jc Js] and lost with a pair of Jacks



PokerStars Hand #100389591440: Tournament #750518676, $0.23+$0.02 USD Hold'em No Limit - Level XII (500/1000) - 2013/06/21 22:18:36 BRT [2013/06/21 21:18:36 ET]
Table '750518676 2' 9-max Seat #6 is the button
Seat 2: dfcastro.net (19328 in chips) 
Seat 6: chertas3 (12877 in chips) 
Seat 7: 14129088 (35295 in chips) 
dfcastro.net: posts the ante 60
chertas3: posts the ante 60
14129088: posts the ante 60
14129088: posts small blind 500
dfcastro.net: posts big blind 1000
*** HOLE CARDS ***
Dealt to dfcastro.net [5c 6s]
chertas3: raises 11817 to 12817 and is all-in
14129088: folds 
dfcastro.net: folds 
Uncalled bet (11817) returned to chertas3
chertas3 collected 2680 from pot
chertas3: doesn't show hand 
*** SUMMARY ***
Total pot 2680 | Rake 0 
Seat 2: dfcastro.net (big blind) folded before Flop
Seat 6: chertas3 (button) collected (2680)
Seat 7: 14129088 (small blind) folded before Flop



PokerStars Hand #100389597101: Tournament #750518676, $0.23+$0.02 USD Hold'em No Limit - Level XII (500/1000) - 2013/06/21 22:18:48 BRT [2013/06/21 21:18:48 ET]
Table '750518676 2' 9-max Seat #7 is the button
Seat 2: dfcastro.net (18268 in chips) 
Seat 6: chertas3 (14497 in chips) 
Seat 7: 14129088 (34735 in chips) 
dfcastro.net: posts the ante 60
chertas3: posts the ante 60
14129088: posts the ante 60
dfcastro.net: posts small blind 500
chertas3: posts big blind 1000
*** HOLE CARDS ***
Dealt to dfcastro.net [5h 8s]
14129088: folds 
dfcastro.net: folds 
Uncalled bet (500) returned to chertas3
chertas3 collected 1180 from pot
chertas3: doesn't show hand 
*** SUMMARY ***
Total pot 1180 | Rake 0 
Seat 2: dfcastro.net (small blind) folded before Flop
Seat 6: chertas3 (big blind) collected (1180)
Seat 7: 14129088 (button) folded before Flop (didn't bet)



PokerStars Hand #100389601169: Tournament #750518676, $0.23+$0.02 USD Hold'em No Limit - Level XII (500/1000) - 2013/06/21 22:18:58 BRT [2013/06/21 21:18:58 ET]
Table '750518676 2' 9-max Seat #2 is the button
Seat 2: dfcastro.net (17708 in chips) 
Seat 6: chertas3 (15117 in chips) 
Seat 7: 14129088 (34675 in chips) 
dfcastro.net: posts the ante 60
chertas3: posts the ante 60
14129088: posts the ante 60
chertas3: posts small blind 500
14129088: posts big blind 1000
*** HOLE CARDS ***
Dealt to dfcastro.net [7h Qc]
dfcastro.net: folds 
chertas3: folds 
Uncalled bet (500) returned to 14129088
14129088 collected 1180 from pot
14129088: doesn't show hand 
*** SUMMARY ***
Total pot 1180 | Rake 0 
Seat 2: dfcastro.net (button) folded before Flop (didn't bet)
Seat 6: chertas3 (small blind) folded before Flop
Seat 7: 14129088 (big blind) collected (1180)



PokerStars Hand #100389604909: Tournament #750518676, $0.23+$0.02 USD Hold'em No Limit - Level XII (500/1000) - 2013/06/21 22:19:06 BRT [2013/06/21 21:19:06 ET]
Table '750518676 2' 9-max Seat #6 is the button
Seat 2: dfcastro.net (17648 in chips) 
Seat 6: chertas3 (14557 in chips) 
Seat 7: 14129088 (35295 in chips) 
dfcastro.net: posts the ante 60
chertas3: posts the ante 60
14129088: posts the ante 60
14129088: posts small blind 500
dfcastro.net: posts big blind 1000
*** HOLE CARDS ***
Dealt to dfcastro.net [2d Ks]
chertas3: folds 
14129088: raises 1000 to 2000
dfcastro.net: folds 
Uncalled bet (1000) returned to 14129088
14129088 collected 2180 from pot
14129088: doesn't show hand 
*** SUMMARY ***
Total pot 2180 | Rake 0 
Seat 2: dfcastro.net (big blind) folded before Flop
Seat 6: chertas3 (button) folded before Flop (didn't bet)
Seat 7: 14129088 (small blind) collected (2180)



PokerStars Hand #100389610730: Tournament #750518676, $0.23+$0.02 USD Hold'em No Limit - Level XII (500/1000) - 2013/06/21 22:19:20 BRT [2013/06/21 21:19:20 ET]
Table '750518676 2' 9-max Seat #7 is the button
Seat 2: dfcastro.net (16588 in chips) 
Seat 6: chertas3 (14497 in chips) 
Seat 7: 14129088 (36415 in chips) 
dfcastro.net: posts the ante 60
chertas3: posts the ante 60
14129088: posts the ante 60
dfcastro.net: posts small blind 500
chertas3: posts big blind 1000
*** HOLE CARDS ***
Dealt to dfcastro.net [5c 8s]
14129088: folds 
dfcastro.net: folds 
Uncalled bet (500) returned to chertas3
chertas3 collected 1180 from pot
chertas3: doesn't show hand 
*** SUMMARY ***
Total pot 1180 | Rake 0 
Seat 2: dfcastro.net (small blind) folded before Flop
Seat 6: chertas3 (big blind) collected (1180)
Seat 7: 14129088 (button) folded before Flop (didn't bet)



PokerStars Hand #100389614507: Tournament #750518676, $0.23+$0.02 USD Hold'em No Limit - Level XII (500/1000) - 2013/06/21 22:19:28 BRT [2013/06/21 21:19:28 ET]
Table '750518676 2' 9-max Seat #2 is the button
Seat 2: dfcastro.net (16028 in chips) 
Seat 6: chertas3 (15117 in chips) 
Seat 7: 14129088 (36355 in chips) 
dfcastro.net: posts the ante 60
chertas3: posts the ante 60
14129088: posts the ante 60
chertas3: posts small blind 500
14129088: posts big blind 1000
*** HOLE CARDS ***
Dealt to dfcastro.net [Tc Ks]
dfcastro.net: raises 2000 to 3000
chertas3: folds 
14129088: folds 
Uncalled bet (2000) returned to dfcastro.net
dfcastro.net collected 2680 from pot
dfcastro.net: doesn't show hand 
*** SUMMARY ***
Total pot 2680 | Rake 0 
Seat 2: dfcastro.net (button) collected (2680)
Seat 6: chertas3 (small blind) folded before Flop
Seat 7: 14129088 (big blind) folded before Flop



PokerStars Hand #100389621780: Tournament #750518676, $0.23+$0.02 USD Hold'em No Limit - Level XII (500/1000) - 2013/06/21 22:19:45 BRT [2013/06/21 21:19:45 ET]
Table '750518676 2' 9-max Seat #6 is the button
Seat 2: dfcastro.net (17648 in chips) 
Seat 6: chertas3 (14557 in chips) 
Seat 7: 14129088 (35295 in chips) 
dfcastro.net: posts the ante 60
chertas3: posts the ante 60
14129088: posts the ante 60
14129088: posts small blind 500
dfcastro.net: posts big blind 1000
*** HOLE CARDS ***
Dealt to dfcastro.net [2h Ts]
chertas3: raises 1100 to 2100
14129088: folds 
dfcastro.net: folds 
Uncalled bet (1100) returned to chertas3
chertas3 collected 2680 from pot
chertas3: doesn't show hand 
*** SUMMARY ***
Total pot 2680 | Rake 0 
Seat 2: dfcastro.net (big blind) folded before Flop
Seat 6: chertas3 (button) collected (2680)
Seat 7: 14129088 (small blind) folded before Flop



PokerStars Hand #100389626427: Tournament #750518676, $0.23+$0.02 USD Hold'em No Limit - Level XII (500/1000) - 2013/06/21 22:19:55 BRT [2013/06/21 21:19:55 ET]
Table '750518676 2' 9-max Seat #7 is the button
Seat 2: dfcastro.net (16588 in chips) 
Seat 6: chertas3 (16177 in chips) 
Seat 7: 14129088 (34735 in chips) 
dfcastro.net: posts the ante 60
chertas3: posts the ante 60
14129088: posts the ante 60
dfcastro.net: posts small blind 500
chertas3: posts big blind 1000
*** HOLE CARDS ***
Dealt to dfcastro.net [7d 3h]
14129088: folds 
dfcastro.net: folds 
Uncalled bet (500) returned to chertas3
chertas3 collected 1180 from pot
chertas3: doesn't show hand 
*** SUMMARY ***
Total pot 1180 | Rake 0 
Seat 2: dfcastro.net (small blind) folded before Flop
Seat 6: chertas3 (big blind) collected (1180)
Seat 7: 14129088 (button) folded before Flop (didn't bet)



PokerStars Hand #100389630353: Tournament #750518676, $0.23+$0.02 USD Hold'em No Limit - Level XII (500/1000) - 2013/06/21 22:20:04 BRT [2013/06/21 21:20:04 ET]
Table '750518676 2' 9-max Seat #2 is the button
Seat 2: dfcastro.net (16028 in chips) 
Seat 6: chertas3 (16797 in chips) 
Seat 7: 14129088 (34675 in chips) 
dfcastro.net: posts the ante 60
chertas3: posts the ante 60
14129088: posts the ante 60
chertas3: posts small blind 500
14129088: posts big blind 1000
*** HOLE CARDS ***
Dealt to dfcastro.net [Qd 3c]
dfcastro.net: folds 
chertas3: raises 1100 to 2100
14129088: folds 
Uncalled bet (1100) returned to chertas3
chertas3 collected 2180 from pot
chertas3: doesn't show hand 
*** SUMMARY ***
Total pot 2180 | Rake 0 
Seat 2: dfcastro.net (button) folded before Flop (didn't bet)
Seat 6: chertas3 (small blind) collected (2180)
Seat 7: 14129088 (big blind) folded before Flop



PokerStars Hand #100389638864: Tournament #750518676, $0.23+$0.02 USD Hold'em No Limit - Level XII (500/1000) - 2013/06/21 22:20:24 BRT [2013/06/21 21:20:24 ET]
Table '750518676 2' 9-max Seat #6 is the button
Seat 2: dfcastro.net (15968 in chips) 
Seat 6: chertas3 (17917 in chips) 
Seat 7: 14129088 (33615 in chips) 
dfcastro.net: posts the ante 60
chertas3: posts the ante 60
14129088: posts the ante 60
14129088: posts small blind 500
dfcastro.net: posts big blind 1000
*** HOLE CARDS ***
Dealt to dfcastro.net [Jh Ad]
chertas3: folds 
14129088: folds 
Uncalled bet (500) returned to dfcastro.net
dfcastro.net collected 1180 from pot
dfcastro.net: doesn't show hand 
*** SUMMARY ***
Total pot 1180 | Rake 0 
Seat 2: dfcastro.net (big blind) collected (1180)
Seat 6: chertas3 (button) folded before Flop (didn't bet)
Seat 7: 14129088 (small blind) folded before Flop



PokerStars Hand #100389643302: Tournament #750518676, $0.23+$0.02 USD Hold'em No Limit - Level XII (500/1000) - 2013/06/21 22:20:34 BRT [2013/06/21 21:20:34 ET]
Table '750518676 2' 9-max Seat #7 is the button
Seat 2: dfcastro.net (16588 in chips) 
Seat 6: chertas3 (17857 in chips) 
Seat 7: 14129088 (33055 in chips) 
dfcastro.net: posts the ante 60
chertas3: posts the ante 60
14129088: posts the ante 60
dfcastro.net: posts small blind 500
chertas3: posts big blind 1000
*** HOLE CARDS ***
Dealt to dfcastro.net [Ac 6d]
14129088: folds 
dfcastro.net: raises 2000 to 3000
chertas3: folds 
Uncalled bet (2000) returned to dfcastro.net
dfcastro.net collected 2180 from pot
dfcastro.net: doesn't show hand 
*** SUMMARY ***
Total pot 2180 | Rake 0 
Seat 2: dfcastro.net (small blind) collected (2180)
Seat 6: chertas3 (big blind) folded before Flop
Seat 7: 14129088 (button) folded before Flop (didn't bet)



PokerStars Hand #100389649033: Tournament #750518676, $0.23+$0.02 USD Hold'em No Limit - Level XII (500/1000) - 2013/06/21 22:20:47 BRT [2013/06/21 21:20:47 ET]
Table '750518676 2' 9-max Seat #2 is the button
Seat 2: dfcastro.net (17708 in chips) 
Seat 6: chertas3 (16797 in chips) 
Seat 7: 14129088 (32995 in chips) 
dfcastro.net: posts the ante 60
chertas3: posts the ante 60
14129088: posts the ante 60
chertas3: posts small blind 500
14129088: posts big blind 1000
*** HOLE CARDS ***
Dealt to dfcastro.net [8s 8c]
dfcastro.net: raises 2000 to 3000
chertas3: folds 
14129088: folds 
Uncalled bet (2000) returned to dfcastro.net
dfcastro.net collected 2680 from pot
dfcastro.net: doesn't show hand 
*** SUMMARY ***
Total pot 2680 | Rake 0 
Seat 2: dfcastro.net (button) collected (2680)
Seat 6: chertas3 (small blind) folded before Flop
Seat 7: 14129088 (big blind) folded before Flop



PokerStars Hand #100389654265: Tournament #750518676, $0.23+$0.02 USD Hold'em No Limit - Level XII (500/1000) - 2013/06/21 22:20:58 BRT [2013/06/21 21:20:58 ET]
Table '750518676 2' 9-max Seat #6 is the button
Seat 2: dfcastro.net (19328 in chips) 
Seat 6: chertas3 (16237 in chips) 
Seat 7: 14129088 (31935 in chips) 
dfcastro.net: posts the ante 60
chertas3: posts the ante 60
14129088: posts the ante 60
14129088: posts small blind 500
dfcastro.net: posts big blind 1000
*** HOLE CARDS ***
Dealt to dfcastro.net [Jh Qd]
chertas3: raises 1100 to 2100
14129088: raises 29775 to 31875 and is all-in
dfcastro.net: folds 
chertas3: folds 
Uncalled bet (29775) returned to 14129088
14129088 collected 5380 from pot
14129088: doesn't show hand 
*** SUMMARY ***
Total pot 5380 | Rake 0 
Seat 2: dfcastro.net (big blind) folded before Flop
Seat 6: chertas3 (button) folded before Flop
Seat 7: 14129088 (small blind) collected (5380)



PokerStars Hand #100389659846: Tournament #750518676, $0.23+$0.02 USD Hold'em No Limit - Level XII (500/1000) - 2013/06/21 22:21:11 BRT [2013/06/21 21:21:11 ET]
Table '750518676 2' 9-max Seat #7 is the button
Seat 2: dfcastro.net (18268 in chips) 
Seat 6: chertas3 (14077 in chips) 
Seat 7: 14129088 (35155 in chips) 
dfcastro.net: posts the ante 60
chertas3: posts the ante 60
14129088: posts the ante 60
dfcastro.net: posts small blind 500
chertas3: posts big blind 1000
*** HOLE CARDS ***
Dealt to dfcastro.net [7d Ac]
14129088: raises 1000 to 2000
dfcastro.net: calls 1500
chertas3: folds 
*** FLOP *** [7c 5s 8c]
dfcastro.net: bets 5000
14129088: raises 28095 to 33095 and is all-in
dfcastro.net: calls 11208 and is all-in
Uncalled bet (16887) returned to 14129088
*** TURN *** [7c 5s 8c] [Tc]
*** RIVER *** [7c 5s 8c Tc] [Qc]
*** SHOW DOWN ***
dfcastro.net: shows [7d Ac] (a flush, Ace high)
14129088: shows [Qd Ah] (a pair of Queens)
dfcastro.net collected 37596 from pot
*** SUMMARY ***
Total pot 37596 | Rake 0 
Board [7c 5s 8c Tc Qc]
Seat 2: dfcastro.net (small blind) showed [7d Ac] and won (37596) with a flush, Ace high
Seat 6: chertas3 (big blind) folded before Flop
Seat 7: 14129088 (button) showed [Qd Ah] and lost with a pair of Queens



PokerStars Hand #100389675355: Tournament #750518676, $0.23+$0.02 USD Hold'em No Limit - Level XII (500/1000) - 2013/06/21 22:21:47 BRT [2013/06/21 21:21:47 ET]
Table '750518676 2' 9-max Seat #2 is the button
Seat 2: dfcastro.net (37596 in chips) 
Seat 6: chertas3 (13017 in chips) 
Seat 7: 14129088 (16887 in chips) 
dfcastro.net: posts the ante 60
chertas3: posts the ante 60
14129088: posts the ante 60
chertas3: posts small blind 500
14129088: posts big blind 1000
*** HOLE CARDS ***
Dealt to dfcastro.net [9d Jc]
dfcastro.net: folds 
chertas3: folds 
Uncalled bet (500) returned to 14129088
14129088 collected 1180 from pot
14129088: doesn't show hand 
*** SUMMARY ***
Total pot 1180 | Rake 0 
Seat 2: dfcastro.net (button) folded before Flop (didn't bet)
Seat 6: chertas3 (small blind) folded before Flop
Seat 7: 14129088 (big blind) collected (1180)



PokerStars Hand #100389678964: Tournament #750518676, $0.23+$0.02 USD Hold'em No Limit - Level XII (500/1000) - 2013/06/21 22:21:56 BRT [2013/06/21 21:21:56 ET]
Table '750518676 2' 9-max Seat #6 is the button
Seat 2: dfcastro.net (37536 in chips) 
Seat 6: chertas3 (12457 in chips) 
Seat 7: 14129088 (17507 in chips) 
dfcastro.net: posts the ante 60
chertas3: posts the ante 60
14129088: posts the ante 60
14129088: posts small blind 500
dfcastro.net: posts big blind 1000
*** HOLE CARDS ***
Dealt to dfcastro.net [3h Th]
chertas3: folds 
14129088: raises 16447 to 17447 and is all-in
dfcastro.net: folds 
Uncalled bet (16447) returned to 14129088
14129088 collected 2180 from pot
14129088: doesn't show hand 
*** SUMMARY ***
Total pot 2180 | Rake 0 
Seat 2: dfcastro.net (big blind) folded before Flop
Seat 6: chertas3 (button) folded before Flop (didn't bet)
Seat 7: 14129088 (small blind) collected (2180)



PokerStars Hand #100389683935: Tournament #750518676, $0.23+$0.02 USD Hold'em No Limit - Level XII (500/1000) - 2013/06/21 22:22:07 BRT [2013/06/21 21:22:07 ET]
Table '750518676 2' 9-max Seat #7 is the button
Seat 2: dfcastro.net (36476 in chips) 
Seat 6: chertas3 (12397 in chips) 
Seat 7: 14129088 (18627 in chips) 
dfcastro.net: posts the ante 60
chertas3: posts the ante 60
14129088: posts the ante 60
dfcastro.net: posts small blind 500
chertas3: posts big blind 1000
*** HOLE CARDS ***
Dealt to dfcastro.net [Qc Ks]
14129088: folds 
dfcastro.net: raises 2000 to 3000
chertas3: folds 
Uncalled bet (2000) returned to dfcastro.net
dfcastro.net collected 2180 from pot
dfcastro.net: doesn't show hand 
*** SUMMARY ***
Total pot 2180 | Rake 0 
Seat 2: dfcastro.net (small blind) collected (2180)
Seat 6: chertas3 (big blind) folded before Flop
Seat 7: 14129088 (button) folded before Flop (didn't bet)



PokerStars Hand #100389689085: Tournament #750518676, $0.23+$0.02 USD Hold'em No Limit - Level XII (500/1000) - 2013/06/21 22:22:19 BRT [2013/06/21 21:22:19 ET]
Table '750518676 2' 9-max Seat #2 is the button
Seat 2: dfcastro.net (37596 in chips) 
Seat 6: chertas3 (11337 in chips) 
Seat 7: 14129088 (18567 in chips) 
dfcastro.net: posts the ante 60
chertas3: posts the ante 60
14129088: posts the ante 60
chertas3: posts small blind 500
14129088: posts big blind 1000
*** HOLE CARDS ***
Dealt to dfcastro.net [9d 5c]
dfcastro.net: folds 
chertas3: raises 10277 to 11277 and is all-in
14129088: calls 10277
*** FLOP *** [2s 8h Ks]
*** TURN *** [2s 8h Ks] [Ts]
*** RIVER *** [2s 8h Ks Ts] [Kc]
*** SHOW DOWN ***
chertas3: shows [6c Kh] (three of a kind, Kings)
14129088: shows [Ac Ad] (two pair, Aces and Kings)
chertas3 collected 22734 from pot
*** SUMMARY ***
Total pot 22734 | Rake 0 
Board [2s 8h Ks Ts Kc]
Seat 2: dfcastro.net (button) folded before Flop (didn't bet)
Seat 6: chertas3 (small blind) showed [6c Kh] and won (22734) with three of a kind, Kings
Seat 7: 14129088 (big blind) showed [Ac Ad] and lost with two pair, Aces and Kings



PokerStars Hand #100389696442: Tournament #750518676, $0.23+$0.02 USD Hold'em No Limit - Level XII (500/1000) - 2013/06/21 22:22:36 BRT [2013/06/21 21:22:36 ET]
Table '750518676 2' 9-max Seat #6 is the button
Seat 2: dfcastro.net (37536 in chips) 
Seat 6: chertas3 (22734 in chips) 
Seat 7: 14129088 (7230 in chips) 
dfcastro.net: posts the ante 60
chertas3: posts the ante 60
14129088: posts the ante 60
14129088: posts small blind 500
dfcastro.net: posts big blind 1000
*** HOLE CARDS ***
Dealt to dfcastro.net [9c 7c]
chertas3: folds 
14129088: raises 6170 to 7170 and is all-in
dfcastro.net: folds 
Uncalled bet (6170) returned to 14129088
14129088 collected 2180 from pot
14129088: doesn't show hand 
*** SUMMARY ***
Total pot 2180 | Rake 0 
Seat 2: dfcastro.net (big blind) folded before Flop
Seat 6: chertas3 (button) folded before Flop (didn't bet)
Seat 7: 14129088 (small blind) collected (2180)



PokerStars Hand #100389704127: Tournament #750518676, $0.23+$0.02 USD Hold'em No Limit - Level XIII (600/1200) - 2013/06/21 22:22:53 BRT [2013/06/21 21:22:53 ET]
Table '750518676 2' 9-max Seat #7 is the button
Seat 2: dfcastro.net (36476 in chips) 
Seat 6: chertas3 (22674 in chips) 
Seat 7: 14129088 (8350 in chips) 
dfcastro.net: posts the ante 75
chertas3: posts the ante 75
14129088: posts the ante 75
dfcastro.net: posts small blind 600
chertas3: posts big blind 1200
*** HOLE CARDS ***
Dealt to dfcastro.net [5c 7c]
14129088: raises 7075 to 8275 and is all-in
dfcastro.net: folds 
chertas3: folds 
Uncalled bet (7075) returned to 14129088
14129088 collected 3225 from pot
14129088: doesn't show hand 
*** SUMMARY ***
Total pot 3225 | Rake 0 
Seat 2: dfcastro.net (small blind) folded before Flop
Seat 6: chertas3 (big blind) folded before Flop
Seat 7: 14129088 (button) collected (3225)



PokerStars Hand #100389709233: Tournament #750518676, $0.23+$0.02 USD Hold'em No Limit - Level XIII (600/1200) - 2013/06/21 22:23:05 BRT [2013/06/21 21:23:05 ET]
Table '750518676 2' 9-max Seat #2 is the button
Seat 2: dfcastro.net (35801 in chips) 
Seat 6: chertas3 (21399 in chips) 
Seat 7: 14129088 (10300 in chips) 
dfcastro.net: posts the ante 75
chertas3: posts the ante 75
14129088: posts the ante 75
chertas3: posts small blind 600
14129088: posts big blind 1200
*** HOLE CARDS ***
Dealt to dfcastro.net [Qh Jd]
dfcastro.net: calls 1200
chertas3: folds 
14129088: checks 
*** FLOP *** [5s Jh 8s]
14129088: checks 
dfcastro.net: checks 
*** TURN *** [5s Jh 8s] [4h]
14129088: checks 
dfcastro.net: checks 
*** RIVER *** [5s Jh 8s 4h] [6h]
14129088: checks 
dfcastro.net: bets 2400
14129088: folds 
Uncalled bet (2400) returned to dfcastro.net
dfcastro.net collected 3225 from pot
dfcastro.net: doesn't show hand 
*** SUMMARY ***
Total pot 3225 | Rake 0 
Board [5s Jh 8s 4h 6h]
Seat 2: dfcastro.net (button) collected (3225)
Seat 6: chertas3 (small blind) folded before Flop
Seat 7: 14129088 (big blind) folded on the River



PokerStars Hand #100389726665: Tournament #750518676, $0.23+$0.02 USD Hold'em No Limit - Level XIII (600/1200) - 2013/06/21 22:23:45 BRT [2013/06/21 21:23:45 ET]
Table '750518676 2' 9-max Seat #6 is the button
Seat 2: dfcastro.net (37751 in chips) 
Seat 6: chertas3 (20724 in chips) 
Seat 7: 14129088 (9025 in chips) 
dfcastro.net: posts the ante 75
chertas3: posts the ante 75
14129088: posts the ante 75
14129088: posts small blind 600
dfcastro.net: posts big blind 1200
*** HOLE CARDS ***
Dealt to dfcastro.net [4s 3h]
chertas3: folds 
14129088: folds 
Uncalled bet (600) returned to dfcastro.net
dfcastro.net collected 1425 from pot
dfcastro.net: doesn't show hand 
*** SUMMARY ***
Total pot 1425 | Rake 0 
Seat 2: dfcastro.net (big blind) collected (1425)
Seat 6: chertas3 (button) folded before Flop (didn't bet)
Seat 7: 14129088 (small blind) folded before Flop



PokerStars Hand #100389729908: Tournament #750518676, $0.23+$0.02 USD Hold'em No Limit - Level XIII (600/1200) - 2013/06/21 22:23:53 BRT [2013/06/21 21:23:53 ET]
Table '750518676 2' 9-max Seat #7 is the button
Seat 2: dfcastro.net (38501 in chips) 
Seat 6: chertas3 (20649 in chips) 
Seat 7: 14129088 (8350 in chips) 
dfcastro.net: posts the ante 75
chertas3: posts the ante 75
14129088: posts the ante 75
dfcastro.net: posts small blind 600
chertas3: posts big blind 1200
*** HOLE CARDS ***
Dealt to dfcastro.net [2s Tc]
14129088: raises 7075 to 8275 and is all-in
dfcastro.net: folds 
chertas3: calls 7075
*** FLOP *** [8c 8s 4h]
*** TURN *** [8c 8s 4h] [Td]
*** RIVER *** [8c 8s 4h Td] [7h]
*** SHOW DOWN ***
chertas3: shows [Jh Th] (two pair, Tens and Eights)
14129088: shows [Kc Ad] (a pair of Eights)
chertas3 collected 17375 from pot
14129088 finished the tournament in 3rd place and received $1.70.
*** SUMMARY ***
Total pot 17375 | Rake 0 
Board [8c 8s 4h Td 7h]
Seat 2: dfcastro.net (small blind) folded before Flop
Seat 6: chertas3 (big blind) showed [Jh Th] and won (17375) with two pair, Tens and Eights
Seat 7: 14129088 (button) showed [Kc Ad] and lost with a pair of Eights



PokerStars Hand #100389740943: Tournament #750518676, $0.23+$0.02 USD Hold'em No Limit - Level XIII (600/1200) - 2013/06/21 22:24:19 BRT [2013/06/21 21:24:19 ET]
Table '750518676 2' 9-max Seat #2 is the button
Seat 2: dfcastro.net (37826 in chips) 
Seat 6: chertas3 (29674 in chips) 
dfcastro.net: posts the ante 75
chertas3: posts the ante 75
dfcastro.net: posts small blind 600
chertas3: posts big blind 1200
*** HOLE CARDS ***
Dealt to dfcastro.net [9d 4c]
dfcastro.net: folds 
Uncalled bet (600) returned to chertas3
chertas3 collected 1350 from pot
chertas3: doesn't show hand 
*** SUMMARY ***
Total pot 1350 | Rake 0 
Seat 2: dfcastro.net (button) (small blind) folded before Flop
Seat 6: chertas3 (big blind) collected (1350)



PokerStars Hand #100389744482: Tournament #750518676, $0.23+$0.02 USD Hold'em No Limit - Level XIII (600/1200) - 2013/06/21 22:24:27 BRT [2013/06/21 21:24:27 ET]
Table '750518676 2' 9-max Seat #6 is the button
Seat 2: dfcastro.net (37151 in chips) 
Seat 6: chertas3 (30349 in chips) 
dfcastro.net: posts the ante 75
chertas3: posts the ante 75
chertas3: posts small blind 600
dfcastro.net: posts big blind 1200
*** HOLE CARDS ***
Dealt to dfcastro.net [4c Jh]
chertas3: raises 1320 to 2520
dfcastro.net: folds 
Uncalled bet (1320) returned to chertas3
chertas3 collected 2550 from pot
chertas3: doesn't show hand 
*** SUMMARY ***
Total pot 2550 | Rake 0 
Seat 2: dfcastro.net (big blind) folded before Flop
Seat 6: chertas3 (button) (small blind) collected (2550)



PokerStars Hand #100389748251: Tournament #750518676, $0.23+$0.02 USD Hold'em No Limit - Level XIII (600/1200) - 2013/06/21 22:24:36 BRT [2013/06/21 21:24:36 ET]
Table '750518676 2' 9-max Seat #2 is the button
Seat 2: dfcastro.net (35876 in chips) 
Seat 6: chertas3 (31624 in chips) 
dfcastro.net: posts the ante 75
chertas3: posts the ante 75
dfcastro.net: posts small blind 600
chertas3: posts big blind 1200
*** HOLE CARDS ***
Dealt to dfcastro.net [8h 9d]
dfcastro.net: folds 
Uncalled bet (600) returned to chertas3
chertas3 collected 1350 from pot
chertas3: doesn't show hand 
*** SUMMARY ***
Total pot 1350 | Rake 0 
Seat 2: dfcastro.net (button) (small blind) folded before Flop
Seat 6: chertas3 (big blind) collected (1350)



PokerStars Hand #100389751273: Tournament #750518676, $0.23+$0.02 USD Hold'em No Limit - Level XIII (600/1200) - 2013/06/21 22:24:43 BRT [2013/06/21 21:24:43 ET]
Table '750518676 2' 9-max Seat #6 is the button
Seat 2: dfcastro.net (35201 in chips) 
Seat 6: chertas3 (32299 in chips) 
dfcastro.net: posts the ante 75
chertas3: posts the ante 75
chertas3: posts small blind 600
dfcastro.net: posts big blind 1200
*** HOLE CARDS ***
Dealt to dfcastro.net [3s 8h]
chertas3: raises 1320 to 2520
dfcastro.net: folds 
Uncalled bet (1320) returned to chertas3
chertas3 collected 2550 from pot
chertas3: doesn't show hand 
*** SUMMARY ***
Total pot 2550 | Rake 0 
Seat 2: dfcastro.net (big blind) folded before Flop
Seat 6: chertas3 (button) (small blind) collected (2550)



PokerStars Hand #100389755206: Tournament #750518676, $0.23+$0.02 USD Hold'em No Limit - Level XIII (600/1200) - 2013/06/21 22:24:52 BRT [2013/06/21 21:24:52 ET]
Table '750518676 2' 9-max Seat #2 is the button
Seat 2: dfcastro.net (33926 in chips) 
Seat 6: chertas3 (33574 in chips) 
dfcastro.net: posts the ante 75
chertas3: posts the ante 75
dfcastro.net: posts small blind 600
chertas3: posts big blind 1200
*** HOLE CARDS ***
Dealt to dfcastro.net [4s Kc]
dfcastro.net: folds 
Uncalled bet (600) returned to chertas3
chertas3 collected 1350 from pot
chertas3: doesn't show hand 
*** SUMMARY ***
Total pot 1350 | Rake 0 
Seat 2: dfcastro.net (button) (small blind) folded before Flop
Seat 6: chertas3 (big blind) collected (1350)



PokerStars Hand #100389758581: Tournament #750518676, $0.23+$0.02 USD Hold'em No Limit - Level XIII (600/1200) - 2013/06/21 22:24:59 BRT [2013/06/21 21:24:59 ET]
Table '750518676 2' 9-max Seat #6 is the button
Seat 2: dfcastro.net (33251 in chips) 
Seat 6: chertas3 (34249 in chips) 
dfcastro.net: posts the ante 75
chertas3: posts the ante 75
chertas3: posts small blind 600
dfcastro.net: posts big blind 1200
*** HOLE CARDS ***
Dealt to dfcastro.net [4c Jh]
chertas3: raises 1320 to 2520
dfcastro.net: calls 1320
*** FLOP *** [3s Kc 7h]
dfcastro.net: checks 
chertas3: bets 3892
dfcastro.net: folds 
Uncalled bet (3892) returned to chertas3
chertas3 collected 5190 from pot
chertas3: doesn't show hand 
*** SUMMARY ***
Total pot 5190 | Rake 0 
Board [3s Kc 7h]
Seat 2: dfcastro.net (big blind) folded on the Flop
Seat 6: chertas3 (button) (small blind) collected (5190)



PokerStars Hand #100389765694: Tournament #750518676, $0.23+$0.02 USD Hold'em No Limit - Level XIII (600/1200) - 2013/06/21 22:25:16 BRT [2013/06/21 21:25:16 ET]
Table '750518676 2' 9-max Seat #2 is the button
Seat 2: dfcastro.net (30656 in chips) 
Seat 6: chertas3 (36844 in chips) 
dfcastro.net: posts the ante 75
chertas3: posts the ante 75
dfcastro.net: posts small blind 600
chertas3: posts big blind 1200
*** HOLE CARDS ***
Dealt to dfcastro.net [8d Ac]
dfcastro.net: calls 600
chertas3: raises 2640 to 3840
dfcastro.net: raises 5760 to 9600
chertas3: calls 5760
*** FLOP *** [Ah 5d 8c]
chertas3: checks 
dfcastro.net: bets 19200
chertas3: folds 
Uncalled bet (19200) returned to dfcastro.net
dfcastro.net collected 19350 from pot
dfcastro.net: doesn't show hand 
*** SUMMARY ***
Total pot 19350 | Rake 0 
Board [Ah 5d 8c]
Seat 2: dfcastro.net (button) (small blind) collected (19350)
Seat 6: chertas3 (big blind) folded on the Flop



PokerStars Hand #100389775939: Tournament #750518676, $0.23+$0.02 USD Hold'em No Limit - Level XIII (600/1200) - 2013/06/21 22:25:40 BRT [2013/06/21 21:25:40 ET]
Table '750518676 2' 9-max Seat #6 is the button
Seat 2: dfcastro.net (40331 in chips) 
Seat 6: chertas3 (27169 in chips) 
dfcastro.net: posts the ante 75
chertas3: posts the ante 75
chertas3: posts small blind 600
dfcastro.net: posts big blind 1200
*** HOLE CARDS ***
Dealt to dfcastro.net [6s Qc]
chertas3: raises 1320 to 2520
dfcastro.net: calls 1320
*** FLOP *** [4h Jc 7s]
dfcastro.net: checks 
chertas3: checks 
*** TURN *** [4h Jc 7s] [9h]
dfcastro.net: checks 
chertas3: bets 3892
dfcastro.net: raises 3892 to 7784
chertas3: folds 
Uncalled bet (3892) returned to dfcastro.net
dfcastro.net collected 12974 from pot
dfcastro.net: doesn't show hand 
*** SUMMARY ***
Total pot 12974 | Rake 0 
Board [4h Jc 7s 9h]
Seat 2: dfcastro.net (big blind) collected (12974)
Seat 6: chertas3 (button) (small blind) folded on the Turn



PokerStars Hand #100389787203: Tournament #750518676, $0.23+$0.02 USD Hold'em No Limit - Level XIII (600/1200) - 2013/06/21 22:26:06 BRT [2013/06/21 21:26:06 ET]
Table '750518676 2' 9-max Seat #2 is the button
Seat 2: dfcastro.net (46818 in chips) 
Seat 6: chertas3 (20682 in chips) 
dfcastro.net: posts the ante 75
chertas3: posts the ante 75
dfcastro.net: posts small blind 600
chertas3: posts big blind 1200
*** HOLE CARDS ***
Dealt to dfcastro.net [Js 2h]
dfcastro.net: folds 
Uncalled bet (600) returned to chertas3
chertas3 collected 1350 from pot
chertas3: doesn't show hand 
*** SUMMARY ***
Total pot 1350 | Rake 0 
Seat 2: dfcastro.net (button) (small blind) folded before Flop
Seat 6: chertas3 (big blind) collected (1350)



PokerStars Hand #100389790913: Tournament #750518676, $0.23+$0.02 USD Hold'em No Limit - Level XIII (600/1200) - 2013/06/21 22:26:15 BRT [2013/06/21 21:26:15 ET]
Table '750518676 2' 9-max Seat #6 is the button
Seat 2: dfcastro.net (46143 in chips) 
Seat 6: chertas3 (21357 in chips) 
dfcastro.net: posts the ante 75
chertas3: posts the ante 75
chertas3: posts small blind 600
dfcastro.net: posts big blind 1200
*** HOLE CARDS ***
Dealt to dfcastro.net [5d 4c]
chertas3: raises 1320 to 2520
dfcastro.net: calls 1320
*** FLOP *** [2h 2c 8d]
dfcastro.net: checks 
chertas3: bets 3892
dfcastro.net: folds 
Uncalled bet (3892) returned to chertas3
chertas3 collected 5190 from pot
chertas3: doesn't show hand 
*** SUMMARY ***
Total pot 5190 | Rake 0 
Board [2h 2c 8d]
Seat 2: dfcastro.net (big blind) folded on the Flop
Seat 6: chertas3 (button) (small blind) collected (5190)



PokerStars Hand #100389797765: Tournament #750518676, $0.23+$0.02 USD Hold'em No Limit - Level XIII (600/1200) - 2013/06/21 22:26:31 BRT [2013/06/21 21:26:31 ET]
Table '750518676 2' 9-max Seat #2 is the button
Seat 2: dfcastro.net (43548 in chips) 
Seat 6: chertas3 (23952 in chips) 
dfcastro.net: posts the ante 75
chertas3: posts the ante 75
dfcastro.net: posts small blind 600
chertas3: posts big blind 1200
*** HOLE CARDS ***
Dealt to dfcastro.net [3d Qs]
dfcastro.net: folds 
Uncalled bet (600) returned to chertas3
chertas3 collected 1350 from pot
chertas3: doesn't show hand 
*** SUMMARY ***
Total pot 1350 | Rake 0 
Seat 2: dfcastro.net (button) (small blind) folded before Flop
Seat 6: chertas3 (big blind) collected (1350)



PokerStars Hand #100389801050: Tournament #750518676, $0.23+$0.02 USD Hold'em No Limit - Level XIII (600/1200) - 2013/06/21 22:26:39 BRT [2013/06/21 21:26:39 ET]
Table '750518676 2' 9-max Seat #6 is the button
Seat 2: dfcastro.net (42873 in chips) 
Seat 6: chertas3 (24627 in chips) 
dfcastro.net: posts the ante 75
chertas3: posts the ante 75
chertas3: posts small blind 600
dfcastro.net: posts big blind 1200
*** HOLE CARDS ***
Dealt to dfcastro.net [Ks Jc]
chertas3: raises 1320 to 2520
dfcastro.net: raises 1320 to 3840
chertas3: calls 1320
*** FLOP *** [Jd Kc 9d]
dfcastro.net: checks 
chertas3: checks 
*** TURN *** [Jd Kc 9d] [Qd]
dfcastro.net: checks 
chertas3: bets 3915
dfcastro.net: calls 3915
*** RIVER *** [Jd Kc 9d Qd] [Th]
dfcastro.net: checks 
chertas3: checks 
*** SHOW DOWN ***
dfcastro.net: shows [Ks Jc] (a straight, Nine to King)
chertas3: shows [Tc 3h] (a straight, Nine to King)
dfcastro.net collected 7830 from pot
chertas3 collected 7830 from pot
*** SUMMARY ***
Total pot 15660 | Rake 0 
Board [Jd Kc 9d Qd Th]
Seat 2: dfcastro.net (big blind) showed [Ks Jc] and won (7830) with a straight, Nine to King
Seat 6: chertas3 (button) (small blind) showed [Tc 3h] and won (7830) with a straight, Nine to King



PokerStars Hand #100389814220: Tournament #750518676, $0.23+$0.02 USD Hold'em No Limit - Level XIII (600/1200) - 2013/06/21 22:27:10 BRT [2013/06/21 21:27:10 ET]
Table '750518676 2' 9-max Seat #2 is the button
Seat 2: dfcastro.net (42873 in chips) 
Seat 6: chertas3 (24627 in chips) 
dfcastro.net: posts the ante 75
chertas3: posts the ante 75
dfcastro.net: posts small blind 600
chertas3: posts big blind 1200
*** HOLE CARDS ***
Dealt to dfcastro.net [8c 6c]
dfcastro.net: folds 
Uncalled bet (600) returned to chertas3
chertas3 collected 1350 from pot
chertas3: doesn't show hand 
*** SUMMARY ***
Total pot 1350 | Rake 0 
Seat 2: dfcastro.net (button) (small blind) folded before Flop
Seat 6: chertas3 (big blind) collected (1350)



PokerStars Hand #100389817121: Tournament #750518676, $0.23+$0.02 USD Hold'em No Limit - Level XIII (600/1200) - 2013/06/21 22:27:17 BRT [2013/06/21 21:27:17 ET]
Table '750518676 2' 9-max Seat #6 is the button
Seat 2: dfcastro.net (42198 in chips) 
Seat 6: chertas3 (25302 in chips) 
dfcastro.net: posts the ante 75
chertas3: posts the ante 75
chertas3: posts small blind 600
dfcastro.net: posts big blind 1200
*** HOLE CARDS ***
Dealt to dfcastro.net [6c Ac]
chertas3: raises 1320 to 2520
dfcastro.net: raises 1320 to 3840
chertas3: raises 4560 to 8400
dfcastro.net: raises 33723 to 42123 and is all-in
chertas3: calls 16827 and is all-in
Uncalled bet (16896) returned to dfcastro.net
*** FLOP *** [5s 8s 3h]
*** TURN *** [5s 8s 3h] [Qd]
*** RIVER *** [5s 8s 3h Qd] [Kh]
*** SHOW DOWN ***
dfcastro.net: shows [6c Ac] (high card Ace)
chertas3: shows [Ad Kd] (a pair of Kings)
chertas3 collected 50604 from pot
*** SUMMARY ***
Total pot 50604 | Rake 0 
Board [5s 8s 3h Qd Kh]
Seat 2: dfcastro.net (big blind) showed [6c Ac] and lost with high card Ace
Seat 6: chertas3 (button) (small blind) showed [Ad Kd] and won (50604) with a pair of Kings



PokerStars Hand #100389827038: Tournament #750518676, $0.23+$0.02 USD Hold'em No Limit - Level XIII (600/1200) - 2013/06/21 22:27:40 BRT [2013/06/21 21:27:40 ET]
Table '750518676 2' 9-max Seat #2 is the button
Seat 2: dfcastro.net (16896 in chips) 
Seat 6: chertas3 (50604 in chips) 
dfcastro.net: posts the ante 75
chertas3: posts the ante 75
dfcastro.net: posts small blind 600
chertas3: posts big blind 1200
*** HOLE CARDS ***
Dealt to dfcastro.net [9d 2c]
dfcastro.net: folds 
Uncalled bet (600) returned to chertas3
chertas3 collected 1350 from pot
chertas3: doesn't show hand 
*** SUMMARY ***
Total pot 1350 | Rake 0 
Seat 2: dfcastro.net (button) (small blind) folded before Flop
Seat 6: chertas3 (big blind) collected (1350)



PokerStars Hand #100389830260: Tournament #750518676, $0.23+$0.02 USD Hold'em No Limit - Level XIII (600/1200) - 2013/06/21 22:27:48 BRT [2013/06/21 21:27:48 ET]
Table '750518676 2' 9-max Seat #6 is the button
Seat 2: dfcastro.net (16221 in chips) 
Seat 6: chertas3 (51279 in chips) 
dfcastro.net: posts the ante 75
chertas3: posts the ante 75
chertas3: posts small blind 600
dfcastro.net: posts big blind 1200
*** HOLE CARDS ***
Dealt to dfcastro.net [8s 2h]
chertas3: raises 37200 to 38400
dfcastro.net: folds 
Uncalled bet (37200) returned to chertas3
chertas3 collected 2550 from pot
chertas3: doesn't show hand 
*** SUMMARY ***
Total pot 2550 | Rake 0 
Seat 2: dfcastro.net (big blind) folded before Flop
Seat 6: chertas3 (button) (small blind) collected (2550)



PokerStars Hand #100389834419: Tournament #750518676, $0.23+$0.02 USD Hold'em No Limit - Level XIII (600/1200) - 2013/06/21 22:27:58 BRT [2013/06/21 21:27:58 ET]
Table '750518676 2' 9-max Seat #2 is the button
Seat 2: dfcastro.net (14946 in chips) 
Seat 6: chertas3 (52554 in chips) 
dfcastro.net: posts the ante 75
chertas3: posts the ante 75
dfcastro.net: posts small blind 600
chertas3: posts big blind 1200
*** HOLE CARDS ***
Dealt to dfcastro.net [9h 4s]
dfcastro.net: folds 
Uncalled bet (600) returned to chertas3
chertas3 collected 1350 from pot
chertas3: doesn't show hand 
*** SUMMARY ***
Total pot 1350 | Rake 0 
Seat 2: dfcastro.net (button) (small blind) folded before Flop
Seat 6: chertas3 (big blind) collected (1350)



PokerStars Hand #100389836912: Tournament #750518676, $0.23+$0.02 USD Hold'em No Limit - Level XIII (600/1200) - 2013/06/21 22:28:04 BRT [2013/06/21 21:28:04 ET]
Table '750518676 2' 9-max Seat #6 is the button
Seat 2: dfcastro.net (14271 in chips) 
Seat 6: chertas3 (53229 in chips) 
dfcastro.net: posts the ante 75
chertas3: posts the ante 75
chertas3: posts small blind 600
dfcastro.net: posts big blind 1200
*** HOLE CARDS ***
Dealt to dfcastro.net [Js 7s]
chertas3: raises 1320 to 2520
dfcastro.net: raises 11676 to 14196 and is all-in
chertas3: folds 
Uncalled bet (11676) returned to dfcastro.net
dfcastro.net collected 5190 from pot
dfcastro.net: doesn't show hand 
*** SUMMARY ***
Total pot 5190 | Rake 0 
Seat 2: dfcastro.net (big blind) collected (5190)
Seat 6: chertas3 (button) (small blind) folded before Flop



PokerStars Hand #100389841761: Tournament #750518676, $0.23+$0.02 USD Hold'em No Limit - Level XIII (600/1200) - 2013/06/21 22:28:15 BRT [2013/06/21 21:28:15 ET]
Table '750518676 2' 9-max Seat #2 is the button
Seat 2: dfcastro.net (16866 in chips) 
Seat 6: chertas3 (50634 in chips) 
dfcastro.net: posts the ante 75
chertas3: posts the ante 75
dfcastro.net: posts small blind 600
chertas3: posts big blind 1200
*** HOLE CARDS ***
Dealt to dfcastro.net [4h Ah]
dfcastro.net: calls 600
chertas3: checks 
*** FLOP *** [2h 3d 2c]
chertas3: checks 
dfcastro.net: checks 
*** TURN *** [2h 3d 2c] [Jh]
chertas3: bets 1912
dfcastro.net: calls 1912
*** RIVER *** [2h 3d 2c Jh] [8s]
chertas3: checks 
dfcastro.net: bets 13679 and is all-in
chertas3: folds 
Uncalled bet (13679) returned to dfcastro.net
dfcastro.net collected 6374 from pot
dfcastro.net: doesn't show hand 
*** SUMMARY ***
Total pot 6374 | Rake 0 
Board [2h 3d 2c Jh 8s]
Seat 2: dfcastro.net (button) (small blind) collected (6374)
Seat 6: chertas3 (big blind) folded on the River



PokerStars Hand #100389852803: Tournament #750518676, $0.23+$0.02 USD Hold'em No Limit - Level XIII (600/1200) - 2013/06/21 22:28:41 BRT [2013/06/21 21:28:41 ET]
Table '750518676 2' 9-max Seat #6 is the button
Seat 2: dfcastro.net (20053 in chips) 
Seat 6: chertas3 (47447 in chips) 
dfcastro.net: posts the ante 75
chertas3: posts the ante 75
chertas3: posts small blind 600
dfcastro.net: posts big blind 1200
*** HOLE CARDS ***
Dealt to dfcastro.net [7c 2h]
chertas3: raises 1320 to 2520
dfcastro.net: folds 
Uncalled bet (1320) returned to chertas3
chertas3 collected 2550 from pot
chertas3: doesn't show hand 
*** SUMMARY ***
Total pot 2550 | Rake 0 
Seat 2: dfcastro.net (big blind) folded before Flop
Seat 6: chertas3 (button) (small blind) collected (2550)



PokerStars Hand #100389856479: Tournament #750518676, $0.23+$0.02 USD Hold'em No Limit - Level XIII (600/1200) - 2013/06/21 22:28:50 BRT [2013/06/21 21:28:50 ET]
Table '750518676 2' 9-max Seat #2 is the button
Seat 2: dfcastro.net (18778 in chips) 
Seat 6: chertas3 (48722 in chips) 
dfcastro.net: posts the ante 75
chertas3: posts the ante 75
dfcastro.net: posts small blind 600
chertas3: posts big blind 1200
*** HOLE CARDS ***
Dealt to dfcastro.net [Qh 9d]
dfcastro.net: calls 600
chertas3: raises 2640 to 3840
dfcastro.net: raises 14863 to 18703 and is all-in
chertas3: folds 
Uncalled bet (14863) returned to dfcastro.net
dfcastro.net collected 7830 from pot
dfcastro.net: doesn't show hand 
*** SUMMARY ***
Total pot 7830 | Rake 0 
Seat 2: dfcastro.net (button) (small blind) collected (7830)
Seat 6: chertas3 (big blind) folded before Flop



PokerStars Hand #100389863365: Tournament #750518676, $0.23+$0.02 USD Hold'em No Limit - Level XIII (600/1200) - 2013/06/21 22:29:07 BRT [2013/06/21 21:29:07 ET]
Table '750518676 2' 9-max Seat #6 is the button
Seat 2: dfcastro.net (22693 in chips) 
Seat 6: chertas3 (44807 in chips) 
dfcastro.net: posts the ante 75
chertas3: posts the ante 75
chertas3: posts small blind 600
dfcastro.net: posts big blind 1200
*** HOLE CARDS ***
Dealt to dfcastro.net [Kc Td]
chertas3: raises 1320 to 2520
dfcastro.net: raises 20098 to 22618 and is all-in
chertas3: folds 
Uncalled bet (20098) returned to dfcastro.net
dfcastro.net collected 5190 from pot
dfcastro.net: doesn't show hand 
*** SUMMARY ***
Total pot 5190 | Rake 0 
Seat 2: dfcastro.net (big blind) collected (5190)
Seat 6: chertas3 (button) (small blind) folded before Flop



PokerStars Hand #100389868548: Tournament #750518676, $0.23+$0.02 USD Hold'em No Limit - Level XIII (600/1200) - 2013/06/21 22:29:19 BRT [2013/06/21 21:29:19 ET]
Table '750518676 2' 9-max Seat #2 is the button
Seat 2: dfcastro.net (25288 in chips) 
Seat 6: chertas3 (42212 in chips) 
dfcastro.net: posts the ante 75
chertas3: posts the ante 75
dfcastro.net: posts small blind 600
chertas3: posts big blind 1200
*** HOLE CARDS ***
Dealt to dfcastro.net [Qh 3h]
dfcastro.net: calls 600
chertas3: raises 2640 to 3840
dfcastro.net: raises 21373 to 25213 and is all-in
chertas3: folds 
Uncalled bet (21373) returned to dfcastro.net
dfcastro.net collected 7830 from pot
dfcastro.net: doesn't show hand 
*** SUMMARY ***
Total pot 7830 | Rake 0 
Seat 2: dfcastro.net (button) (small blind) collected (7830)
Seat 6: chertas3 (big blind) folded before Flop



PokerStars Hand #100389873410: Tournament #750518676, $0.23+$0.02 USD Hold'em No Limit - Level XIII (600/1200) - 2013/06/21 22:29:31 BRT [2013/06/21 21:29:31 ET]
Table '750518676 2' 9-max Seat #6 is the button
Seat 2: dfcastro.net (29203 in chips) 
Seat 6: chertas3 (38297 in chips) 
dfcastro.net: posts the ante 75
chertas3: posts the ante 75
chertas3: posts small blind 600
dfcastro.net: posts big blind 1200
*** HOLE CARDS ***
Dealt to dfcastro.net [9c 2c]
chertas3: raises 1320 to 2520
dfcastro.net: folds 
Uncalled bet (1320) returned to chertas3
chertas3 collected 2550 from pot
chertas3: doesn't show hand 
*** SUMMARY ***
Total pot 2550 | Rake 0 
Seat 2: dfcastro.net (big blind) folded before Flop
Seat 6: chertas3 (button) (small blind) collected (2550)



PokerStars Hand #100389878054: Tournament #750518676, $0.23+$0.02 USD Hold'em No Limit - Level XIII (600/1200) - 2013/06/21 22:29:42 BRT [2013/06/21 21:29:42 ET]
Table '750518676 2' 9-max Seat #2 is the button
Seat 2: dfcastro.net (27928 in chips) 
Seat 6: chertas3 (39572 in chips) 
dfcastro.net: posts the ante 75
chertas3: posts the ante 75
dfcastro.net: posts small blind 600
chertas3: posts big blind 1200
*** HOLE CARDS ***
Dealt to dfcastro.net [Ks Td]
dfcastro.net: calls 600
chertas3: checks 
*** FLOP *** [Ad 5s 2s]
chertas3: checks 
dfcastro.net: checks 
*** TURN *** [Ad 5s 2s] [7d]
chertas3: checks 
dfcastro.net: checks 
*** RIVER *** [Ad 5s 2s 7d] [8c]
chertas3: checks 
dfcastro.net: checks 
*** SHOW DOWN ***
chertas3: shows [Qc 4d] (high card Ace)
dfcastro.net: shows [Ks Td] (high card Ace - King kicker)
dfcastro.net collected 2550 from pot
*** SUMMARY ***
Total pot 2550 | Rake 0 
Board [Ad 5s 2s 7d 8c]
Seat 2: dfcastro.net (button) (small blind) showed [Ks Td] and won (2550) with high card Ace
Seat 6: chertas3 (big blind) showed [Qc 4d] and lost with high card Ace



PokerStars Hand #100389885794: Tournament #750518676, $0.23+$0.02 USD Hold'em No Limit - Level XIII (600/1200) - 2013/06/21 22:30:00 BRT [2013/06/21 21:30:00 ET]
Table '750518676 2' 9-max Seat #6 is the button
Seat 2: dfcastro.net (29203 in chips) 
Seat 6: chertas3 (38297 in chips) 
dfcastro.net: posts the ante 75
chertas3: posts the ante 75
chertas3: posts small blind 600
dfcastro.net: posts big blind 1200
*** HOLE CARDS ***
Dealt to dfcastro.net [6h 5s]
chertas3: raises 1320 to 2520
dfcastro.net: folds 
Uncalled bet (1320) returned to chertas3
chertas3 collected 2550 from pot
chertas3: doesn't show hand 
*** SUMMARY ***
Total pot 2550 | Rake 0 
Seat 2: dfcastro.net (big blind) folded before Flop
Seat 6: chertas3 (button) (small blind) collected (2550)



PokerStars Hand #100389889992: Tournament #750518676, $0.23+$0.02 USD Hold'em No Limit - Level XIII (600/1200) - 2013/06/21 22:30:10 BRT [2013/06/21 21:30:10 ET]
Table '750518676 2' 9-max Seat #2 is the button
Seat 2: dfcastro.net (27928 in chips) 
Seat 6: chertas3 (39572 in chips) 
dfcastro.net: posts the ante 75
chertas3: posts the ante 75
dfcastro.net: posts small blind 600
chertas3: posts big blind 1200
*** HOLE CARDS ***
Dealt to dfcastro.net [Ah 9c]
dfcastro.net: calls 600
chertas3: raises 38297 to 39497 and is all-in
dfcastro.net: calls 26653 and is all-in
Uncalled bet (11644) returned to chertas3
*** FLOP *** [2h As Th]
*** TURN *** [2h As Th] [3h]
*** RIVER *** [2h As Th 3h] [Qs]
*** SHOW DOWN ***
chertas3: shows [4d Ac] (a pair of Aces)
dfcastro.net: shows [Ah 9c] (a pair of Aces - Queen+Ten+Nine kicker)
dfcastro.net collected 55856 from pot
*** SUMMARY ***
Total pot 55856 | Rake 0 
Board [2h As Th 3h Qs]
Seat 2: dfcastro.net (button) (small blind) showed [Ah 9c] and won (55856) with a pair of Aces
Seat 6: chertas3 (big blind) showed [4d Ac] and lost with a pair of Aces



PokerStars Hand #100389897807: Tournament #750518676, $0.23+$0.02 USD Hold'em No Limit - Level XIII (600/1200) - 2013/06/21 22:30:29 BRT [2013/06/21 21:30:29 ET]
Table '750518676 2' 9-max Seat #6 is the button
Seat 2: dfcastro.net (55856 in chips) 
Seat 6: chertas3 (11644 in chips) 
dfcastro.net: posts the ante 75
chertas3: posts the ante 75
chertas3: posts small blind 600
dfcastro.net: posts big blind 1200
*** HOLE CARDS ***
Dealt to dfcastro.net [Qs 4c]
chertas3: raises 10369 to 11569 and is all-in
dfcastro.net: folds 
Uncalled bet (10369) returned to chertas3
chertas3 collected 2550 from pot
chertas3: doesn't show hand 
*** SUMMARY ***
Total pot 2550 | Rake 0 
Seat 2: dfcastro.net (big blind) folded before Flop
Seat 6: chertas3 (button) (small blind) collected (2550)



PokerStars Hand #100389901243: Tournament #750518676, $0.23+$0.02 USD Hold'em No Limit - Level XIII (600/1200) - 2013/06/21 22:30:37 BRT [2013/06/21 21:30:37 ET]
Table '750518676 2' 9-max Seat #2 is the button
Seat 2: dfcastro.net (54581 in chips) 
Seat 6: chertas3 (12919 in chips) 
dfcastro.net: posts the ante 75
chertas3: posts the ante 75
dfcastro.net: posts small blind 600
chertas3: posts big blind 1200
*** HOLE CARDS ***
Dealt to dfcastro.net [5c Tc]
dfcastro.net: folds 
Uncalled bet (600) returned to chertas3
chertas3 collected 1350 from pot
chertas3: doesn't show hand 
*** SUMMARY ***
Total pot 1350 | Rake 0 
Seat 2: dfcastro.net (button) (small blind) folded before Flop
Seat 6: chertas3 (big blind) collected (1350)



PokerStars Hand #100389904156: Tournament #750518676, $0.23+$0.02 USD Hold'em No Limit - Level XIII (600/1200) - 2013/06/21 22:30:44 BRT [2013/06/21 21:30:44 ET]
Table '750518676 2' 9-max Seat #6 is the button
Seat 2: dfcastro.net (53906 in chips) 
Seat 6: chertas3 (13594 in chips) 
dfcastro.net: posts the ante 75
chertas3: posts the ante 75
chertas3: posts small blind 600
dfcastro.net: posts big blind 1200
*** HOLE CARDS ***
Dealt to dfcastro.net [As Ks]
chertas3: folds 
Uncalled bet (600) returned to dfcastro.net
dfcastro.net collected 1350 from pot
dfcastro.net: doesn't show hand 
*** SUMMARY ***
Total pot 1350 | Rake 0 
Seat 2: dfcastro.net (big blind) collected (1350)
Seat 6: chertas3 (button) (small blind) folded before Flop



PokerStars Hand #100389906686: Tournament #750518676, $0.23+$0.02 USD Hold'em No Limit - Level XIII (600/1200) - 2013/06/21 22:30:50 BRT [2013/06/21 21:30:50 ET]
Table '750518676 2' 9-max Seat #2 is the button
Seat 2: dfcastro.net (54581 in chips) 
Seat 6: chertas3 (12919 in chips) 
dfcastro.net: posts the ante 75
chertas3: posts the ante 75
dfcastro.net: posts small blind 600
chertas3: posts big blind 1200
*** HOLE CARDS ***
Dealt to dfcastro.net [As 6s]
dfcastro.net: calls 600
chertas3: checks 
*** FLOP *** [9s 2c 8s]
chertas3: checks 
dfcastro.net: checks 
*** TURN *** [9s 2c 8s] [2d]
chertas3: checks 
dfcastro.net: checks 
*** RIVER *** [9s 2c 8s 2d] [4h]
chertas3: checks 
dfcastro.net: checks 
*** SHOW DOWN ***
chertas3: shows [Qd 7c] (a pair of Deuces)
dfcastro.net: shows [As 6s] (a pair of Deuces - Ace kicker)
dfcastro.net collected 2550 from pot
*** SUMMARY ***
Total pot 2550 | Rake 0 
Board [9s 2c 8s 2d 4h]
Seat 2: dfcastro.net (button) (small blind) showed [As 6s] and won (2550) with a pair of Deuces
Seat 6: chertas3 (big blind) showed [Qd 7c] and lost with a pair of Deuces



PokerStars Hand #100389914513: Tournament #750518676, $0.23+$0.02 USD Hold'em No Limit - Level XIII (600/1200) - 2013/06/21 22:31:09 BRT [2013/06/21 21:31:09 ET]
Table '750518676 2' 9-max Seat #6 is the button
Seat 2: dfcastro.net (55856 in chips) 
Seat 6: chertas3 (11644 in chips) 
dfcastro.net: posts the ante 75
chertas3: posts the ante 75
chertas3: posts small blind 600
dfcastro.net: posts big blind 1200
*** HOLE CARDS ***
Dealt to dfcastro.net [4d Qh]
chertas3: raises 10369 to 11569 and is all-in
dfcastro.net: folds 
Uncalled bet (10369) returned to chertas3
chertas3 collected 2550 from pot
chertas3: doesn't show hand 
*** SUMMARY ***
Total pot 2550 | Rake 0 
Seat 2: dfcastro.net (big blind) folded before Flop
Seat 6: chertas3 (button) (small blind) collected (2550)



PokerStars Hand #100389917990: Tournament #750518676, $0.23+$0.02 USD Hold'em No Limit - Level XIII (600/1200) - 2013/06/21 22:31:17 BRT [2013/06/21 21:31:17 ET]
Table '750518676 2' 9-max Seat #2 is the button
Seat 2: dfcastro.net (54581 in chips) 
Seat 6: chertas3 (12919 in chips) 
dfcastro.net: posts the ante 75
chertas3: posts the ante 75
dfcastro.net: posts small blind 600
chertas3: posts big blind 1200
*** HOLE CARDS ***
Dealt to dfcastro.net [Ah 8h]
dfcastro.net: calls 600
chertas3: checks 
*** FLOP *** [Ad Kc Jc]
chertas3: checks 
dfcastro.net: checks 
*** TURN *** [Ad Kc Jc] [Ks]
chertas3: checks 
dfcastro.net: checks 
*** RIVER *** [Ad Kc Jc Ks] [Jd]
chertas3: checks 
dfcastro.net: bets 2400
chertas3: folds 
Uncalled bet (2400) returned to dfcastro.net
dfcastro.net collected 2550 from pot
dfcastro.net: doesn't show hand 
*** SUMMARY ***
Total pot 2550 | Rake 0 
Board [Ad Kc Jc Ks Jd]
Seat 2: dfcastro.net (button) (small blind) collected (2550)
Seat 6: chertas3 (big blind) folded on the River



PokerStars Hand #100389926009: Tournament #750518676, $0.23+$0.02 USD Hold'em No Limit - Level XIII (600/1200) - 2013/06/21 22:31:36 BRT [2013/06/21 21:31:36 ET]
Table '750518676 2' 9-max Seat #6 is the button
Seat 2: dfcastro.net (55856 in chips) 
Seat 6: chertas3 (11644 in chips) 
dfcastro.net: posts the ante 75
chertas3: posts the ante 75
chertas3: posts small blind 600
dfcastro.net: posts big blind 1200
*** HOLE CARDS ***
Dealt to dfcastro.net [7h Kh]
chertas3: raises 10369 to 11569 and is all-in
dfcastro.net: calls 10369
*** FLOP *** [3d Qd 9d]
*** TURN *** [3d Qd 9d] [Th]
*** RIVER *** [3d Qd 9d Th] [4c]
*** SHOW DOWN ***
dfcastro.net: shows [7h Kh] (high card King)
chertas3: shows [5s Qc] (a pair of Queens)
chertas3 collected 23288 from pot
*** SUMMARY ***
Total pot 23288 | Rake 0 
Board [3d Qd 9d Th 4c]
Seat 2: dfcastro.net (big blind) showed [7h Kh] and lost with high card King
Seat 6: chertas3 (button) (small blind) showed [5s Qc] and won (23288) with a pair of Queens



PokerStars Hand #100389932188: Tournament #750518676, $0.23+$0.02 USD Hold'em No Limit - Level XIII (600/1200) - 2013/06/21 22:31:51 BRT [2013/06/21 21:31:51 ET]
Table '750518676 2' 9-max Seat #2 is the button
Seat 2: dfcastro.net (44212 in chips) 
Seat 6: chertas3 (23288 in chips) 
dfcastro.net: posts the ante 75
chertas3: posts the ante 75
dfcastro.net: posts small blind 600
chertas3: posts big blind 1200
*** HOLE CARDS ***
Dealt to dfcastro.net [Td 9c]
dfcastro.net: folds 
Uncalled bet (600) returned to chertas3
chertas3 collected 1350 from pot
chertas3: doesn't show hand 
*** SUMMARY ***
Total pot 1350 | Rake 0 
Seat 2: dfcastro.net (button) (small blind) folded before Flop
Seat 6: chertas3 (big blind) collected (1350)



PokerStars Hand #100389935643: Tournament #750518676, $0.23+$0.02 USD Hold'em No Limit - Level XIII (600/1200) - 2013/06/21 22:32:00 BRT [2013/06/21 21:32:00 ET]
Table '750518676 2' 9-max Seat #6 is the button
Seat 2: dfcastro.net (43537 in chips) 
Seat 6: chertas3 (23963 in chips) 
dfcastro.net: posts the ante 75
chertas3: posts the ante 75
chertas3: posts small blind 600
dfcastro.net: posts big blind 1200
*** HOLE CARDS ***
Dealt to dfcastro.net [8s 3s]
chertas3: calls 600
dfcastro.net: checks 
*** FLOP *** [6d Ac Ad]
dfcastro.net: checks 
chertas3: bets 1912
dfcastro.net: folds 
Uncalled bet (1912) returned to chertas3
chertas3 collected 2550 from pot
chertas3: doesn't show hand 
*** SUMMARY ***
Total pot 2550 | Rake 0 
Board [6d Ac Ad]
Seat 2: dfcastro.net (big blind) folded on the Flop
Seat 6: chertas3 (button) (small blind) collected (2550)



PokerStars Hand #100389942660: Tournament #750518676, $0.23+$0.02 USD Hold'em No Limit - Level XIII (600/1200) - 2013/06/21 22:32:16 BRT [2013/06/21 21:32:16 ET]
Table '750518676 2' 9-max Seat #2 is the button
Seat 2: dfcastro.net (42262 in chips) 
Seat 6: chertas3 (25238 in chips) 
dfcastro.net: posts the ante 75
chertas3: posts the ante 75
dfcastro.net: posts small blind 600
chertas3: posts big blind 1200
*** HOLE CARDS ***
Dealt to dfcastro.net [5s Ad]
dfcastro.net: calls 600
chertas3: raises 23963 to 25163 and is all-in
dfcastro.net: calls 23963
*** FLOP *** [7c Qh 9c]
*** TURN *** [7c Qh 9c] [4d]
*** RIVER *** [7c Qh 9c 4d] [4h]
*** SHOW DOWN ***
chertas3: shows [8h As] (a pair of Fours)
dfcastro.net: shows [5s Ad] (a pair of Fours)
chertas3 collected 25238 from pot
dfcastro.net collected 25238 from pot
*** SUMMARY ***
Total pot 50476 | Rake 0 
Board [7c Qh 9c 4d 4h]
Seat 2: dfcastro.net (button) (small blind) showed [5s Ad] and won (25238) with a pair of Fours
Seat 6: chertas3 (big blind) showed [8h As] and won (25238) with a pair of Fours



PokerStars Hand #100389954920: Tournament #750518676, $0.23+$0.02 USD Hold'em No Limit - Level XIV (800/1600) - 2013/06/21 22:32:46 BRT [2013/06/21 21:32:46 ET]
Table '750518676 2' 9-max Seat #6 is the button
Seat 2: dfcastro.net (42262 in chips) 
Seat 6: chertas3 (25238 in chips) 
dfcastro.net: posts the ante 75
chertas3: posts the ante 75
chertas3: posts small blind 800
dfcastro.net: posts big blind 1600
*** HOLE CARDS ***
Dealt to dfcastro.net [2h 6h]
chertas3: raises 1760 to 3360
dfcastro.net: folds 
Uncalled bet (1760) returned to chertas3
chertas3 collected 3350 from pot
chertas3: doesn't show hand 
*** SUMMARY ***
Total pot 3350 | Rake 0 
Seat 2: dfcastro.net (big blind) folded before Flop
Seat 6: chertas3 (button) (small blind) collected (3350)



PokerStars Hand #100389958738: Tournament #750518676, $0.23+$0.02 USD Hold'em No Limit - Level XIV (800/1600) - 2013/06/21 22:32:55 BRT [2013/06/21 21:32:55 ET]
Table '750518676 2' 9-max Seat #2 is the button
Seat 2: dfcastro.net (40587 in chips) 
Seat 6: chertas3 (26913 in chips) 
dfcastro.net: posts the ante 75
chertas3: posts the ante 75
dfcastro.net: posts small blind 800
chertas3: posts big blind 1600
*** HOLE CARDS ***
Dealt to dfcastro.net [Kd 9c]
dfcastro.net: calls 800
chertas3: checks 
*** FLOP *** [Jc Ts 9s]
chertas3: checks 
dfcastro.net: bets 1600
chertas3: calls 1600
*** TURN *** [Jc Ts 9s] [Ac]
chertas3: checks 
dfcastro.net: bets 1600
chertas3: folds 
Uncalled bet (1600) returned to dfcastro.net
dfcastro.net collected 6550 from pot
dfcastro.net: doesn't show hand 
*** SUMMARY ***
Total pot 6550 | Rake 0 
Board [Jc Ts 9s Ac]
Seat 2: dfcastro.net (button) (small blind) collected (6550)
Seat 6: chertas3 (big blind) folded on the Turn



PokerStars Hand #100389966600: Tournament #750518676, $0.23+$0.02 USD Hold'em No Limit - Level XIV (800/1600) - 2013/06/21 22:33:14 BRT [2013/06/21 21:33:14 ET]
Table '750518676 2' 9-max Seat #6 is the button
Seat 2: dfcastro.net (43862 in chips) 
Seat 6: chertas3 (23638 in chips) 
dfcastro.net: posts the ante 75
chertas3: posts the ante 75
chertas3: posts small blind 800
dfcastro.net: posts big blind 1600
*** HOLE CARDS ***
Dealt to dfcastro.net [Jc 9c]
chertas3: raises 1760 to 3360
dfcastro.net: raises 1760 to 5120
chertas3: calls 1760
*** FLOP *** [8h 3h Ks]
dfcastro.net: bets 9600
chertas3: raises 8843 to 18443 and is all-in
dfcastro.net: folds 
Uncalled bet (8843) returned to chertas3
chertas3 collected 29590 from pot
chertas3: doesn't show hand 
*** SUMMARY ***
Total pot 29590 | Rake 0 
Board [8h 3h Ks]
Seat 2: dfcastro.net (big blind) folded on the Flop
Seat 6: chertas3 (button) (small blind) collected (29590)



PokerStars Hand #100389976691: Tournament #750518676, $0.23+$0.02 USD Hold'em No Limit - Level XIV (800/1600) - 2013/06/21 22:33:39 BRT [2013/06/21 21:33:39 ET]
Table '750518676 2' 9-max Seat #2 is the button
Seat 2: dfcastro.net (29067 in chips) 
Seat 6: chertas3 (38433 in chips) 
dfcastro.net: posts the ante 75
chertas3: posts the ante 75
dfcastro.net: posts small blind 800
chertas3: posts big blind 1600
*** HOLE CARDS ***
Dealt to dfcastro.net [5c Jh]
dfcastro.net: folds 
Uncalled bet (800) returned to chertas3
chertas3 collected 1750 from pot
chertas3: doesn't show hand 
*** SUMMARY ***
Total pot 1750 | Rake 0 
Seat 2: dfcastro.net (button) (small blind) folded before Flop
Seat 6: chertas3 (big blind) collected (1750)



PokerStars Hand #100389979323: Tournament #750518676, $0.23+$0.02 USD Hold'em No Limit - Level XIV (800/1600) - 2013/06/21 22:33:45 BRT [2013/06/21 21:33:45 ET]
Table '750518676 2' 9-max Seat #6 is the button
Seat 2: dfcastro.net (28192 in chips) 
Seat 6: chertas3 (39308 in chips) 
dfcastro.net: posts the ante 75
chertas3: posts the ante 75
chertas3: posts small blind 800
dfcastro.net: posts big blind 1600
*** HOLE CARDS ***
Dealt to dfcastro.net [Jh 5c]
chertas3: raises 1760 to 3360
dfcastro.net: folds 
Uncalled bet (1760) returned to chertas3
chertas3 collected 3350 from pot
chertas3: doesn't show hand 
*** SUMMARY ***
Total pot 3350 | Rake 0 
Seat 2: dfcastro.net (big blind) folded before Flop
Seat 6: chertas3 (button) (small blind) collected (3350)



PokerStars Hand #100389983279: Tournament #750518676, $0.23+$0.02 USD Hold'em No Limit - Level XIV (800/1600) - 2013/06/21 22:33:55 BRT [2013/06/21 21:33:55 ET]
Table '750518676 2' 9-max Seat #2 is the button
Seat 2: dfcastro.net (26517 in chips) 
Seat 6: chertas3 (40983 in chips) 
dfcastro.net: posts the ante 75
chertas3: posts the ante 75
dfcastro.net: posts small blind 800
chertas3: posts big blind 1600
*** HOLE CARDS ***
Dealt to dfcastro.net [Ah 2c]
dfcastro.net: calls 800
chertas3: checks 
*** FLOP *** [Ks 8h 5c]
chertas3: checks 
dfcastro.net: checks 
*** TURN *** [Ks 8h 5c] [2s]
chertas3: bets 2512
dfcastro.net: calls 2512
*** RIVER *** [Ks 8h 5c 2s] [Tc]
chertas3: bets 6280
dfcastro.net: folds 
Uncalled bet (6280) returned to chertas3
chertas3 collected 8374 from pot
chertas3: doesn't show hand 
*** SUMMARY ***
Total pot 8374 | Rake 0 
Board [Ks 8h 5c 2s Tc]
Seat 2: dfcastro.net (button) (small blind) folded on the River
Seat 6: chertas3 (big blind) collected (8374)



PokerStars Hand #100389992642: Tournament #750518676, $0.23+$0.02 USD Hold'em No Limit - Level XIV (800/1600) - 2013/06/21 22:34:18 BRT [2013/06/21 21:34:18 ET]
Table '750518676 2' 9-max Seat #6 is the button
Seat 2: dfcastro.net (22330 in chips) 
Seat 6: chertas3 (45170 in chips) 
dfcastro.net: posts the ante 75
chertas3: posts the ante 75
chertas3: posts small blind 800
dfcastro.net: posts big blind 1600
*** HOLE CARDS ***
Dealt to dfcastro.net [Kh Qd]
chertas3: calls 800
dfcastro.net: raises 20655 to 22255 and is all-in
chertas3: folds 
Uncalled bet (20655) returned to dfcastro.net
dfcastro.net collected 3350 from pot
dfcastro.net: doesn't show hand 
*** SUMMARY ***
Total pot 3350 | Rake 0 
Seat 2: dfcastro.net (big blind) collected (3350)
Seat 6: chertas3 (button) (small blind) folded before Flop



PokerStars Hand #100389997209: Tournament #750518676, $0.23+$0.02 USD Hold'em No Limit - Level XIV (800/1600) - 2013/06/21 22:34:29 BRT [2013/06/21 21:34:29 ET]
Table '750518676 2' 9-max Seat #2 is the button
Seat 2: dfcastro.net (24005 in chips) 
Seat 6: chertas3 (43495 in chips) 
dfcastro.net: posts the ante 75
chertas3: posts the ante 75
dfcastro.net: posts small blind 800
chertas3: posts big blind 1600
*** HOLE CARDS ***
Dealt to dfcastro.net [Qs Jc]
dfcastro.net: raises 22330 to 23930 and is all-in
chertas3: folds 
Uncalled bet (22330) returned to dfcastro.net
dfcastro.net collected 3350 from pot
dfcastro.net: doesn't show hand 
*** SUMMARY ***
Total pot 3350 | Rake 0 
Seat 2: dfcastro.net (button) (small blind) collected (3350)
Seat 6: chertas3 (big blind) folded before Flop



PokerStars Hand #100390001120: Tournament #750518676, $0.23+$0.02 USD Hold'em No Limit - Level XIV (800/1600) - 2013/06/21 22:34:39 BRT [2013/06/21 21:34:39 ET]
Table '750518676 2' 9-max Seat #6 is the button
Seat 2: dfcastro.net (25680 in chips) 
Seat 6: chertas3 (41820 in chips) 
dfcastro.net: posts the ante 75
chertas3: posts the ante 75
chertas3: posts small blind 800
dfcastro.net: posts big blind 1600
*** HOLE CARDS ***
Dealt to dfcastro.net [Td 3s]
chertas3: calls 800
dfcastro.net: checks 
*** FLOP *** [3h 2s 4h]
dfcastro.net: bets 24005 and is all-in
chertas3: folds 
Uncalled bet (24005) returned to dfcastro.net
dfcastro.net collected 3350 from pot
dfcastro.net: doesn't show hand 
*** SUMMARY ***
Total pot 3350 | Rake 0 
Board [3h 2s 4h]
Seat 2: dfcastro.net (big blind) collected (3350)
Seat 6: chertas3 (button) (small blind) folded on the Flop



PokerStars Hand #100390007596: Tournament #750518676, $0.23+$0.02 USD Hold'em No Limit - Level XIV (800/1600) - 2013/06/21 22:34:54 BRT [2013/06/21 21:34:54 ET]
Table '750518676 2' 9-max Seat #2 is the button
Seat 2: dfcastro.net (27355 in chips) 
Seat 6: chertas3 (40145 in chips) 
dfcastro.net: posts the ante 75
chertas3: posts the ante 75
dfcastro.net: posts small blind 800
chertas3: posts big blind 1600
*** HOLE CARDS ***
Dealt to dfcastro.net [8c Th]
dfcastro.net: folds 
Uncalled bet (800) returned to chertas3
chertas3 collected 1750 from pot
chertas3: doesn't show hand 
*** SUMMARY ***
Total pot 1750 | Rake 0 
Seat 2: dfcastro.net (button) (small blind) folded before Flop
Seat 6: chertas3 (big blind) collected (1750)



PokerStars Hand #100390010270: Tournament #750518676, $0.23+$0.02 USD Hold'em No Limit - Level XIV (800/1600) - 2013/06/21 22:35:01 BRT [2013/06/21 21:35:01 ET]
Table '750518676 2' 9-max Seat #6 is the button
Seat 2: dfcastro.net (26480 in chips) 
Seat 6: chertas3 (41020 in chips) 
dfcastro.net: posts the ante 75
chertas3: posts the ante 75
chertas3: posts small blind 800
dfcastro.net: posts big blind 1600
*** HOLE CARDS ***
Dealt to dfcastro.net [8c Tc]
chertas3: calls 800
dfcastro.net: checks 
*** FLOP *** [9s As 5d]
dfcastro.net: checks 
chertas3: bets 2512
dfcastro.net: folds 
Uncalled bet (2512) returned to chertas3
chertas3 collected 3350 from pot
chertas3: doesn't show hand 
*** SUMMARY ***
Total pot 3350 | Rake 0 
Board [9s As 5d]
Seat 2: dfcastro.net (big blind) folded on the Flop
Seat 6: chertas3 (button) (small blind) collected (3350)



PokerStars Hand #100390016023: Tournament #750518676, $0.23+$0.02 USD Hold'em No Limit - Level XIV (800/1600) - 2013/06/21 22:35:15 BRT [2013/06/21 21:35:15 ET]
Table '750518676 2' 9-max Seat #2 is the button
Seat 2: dfcastro.net (24805 in chips) 
Seat 6: chertas3 (42695 in chips) 
dfcastro.net: posts the ante 75
chertas3: posts the ante 75
dfcastro.net: posts small blind 800
chertas3: posts big blind 1600
*** HOLE CARDS ***
Dealt to dfcastro.net [9s 5d]
dfcastro.net: folds 
Uncalled bet (800) returned to chertas3
chertas3 collected 1750 from pot
chertas3: doesn't show hand 
*** SUMMARY ***
Total pot 1750 | Rake 0 
Seat 2: dfcastro.net (button) (small blind) folded before Flop
Seat 6: chertas3 (big blind) collected (1750)



PokerStars Hand #100390018681: Tournament #750518676, $0.23+$0.02 USD Hold'em No Limit - Level XIV (800/1600) - 2013/06/21 22:35:21 BRT [2013/06/21 21:35:21 ET]
Table '750518676 2' 9-max Seat #6 is the button
Seat 2: dfcastro.net (23930 in chips) 
Seat 6: chertas3 (43570 in chips) 
dfcastro.net: posts the ante 75
chertas3: posts the ante 75
chertas3: posts small blind 800
dfcastro.net: posts big blind 1600
*** HOLE CARDS ***
Dealt to dfcastro.net [Qd 3h]
chertas3: raises 1760 to 3360
dfcastro.net: calls 1760
*** FLOP *** [Kh Jc 6s]
dfcastro.net: checks 
chertas3: checks 
*** TURN *** [Kh Jc 6s] [As]
dfcastro.net: checks 
chertas3: checks 
*** RIVER *** [Kh Jc 6s As] [Qs]
dfcastro.net: bets 4800
chertas3: folds 
Uncalled bet (4800) returned to dfcastro.net
dfcastro.net collected 6870 from pot
dfcastro.net: doesn't show hand 
*** SUMMARY ***
Total pot 6870 | Rake 0 
Board [Kh Jc 6s As Qs]
Seat 2: dfcastro.net (big blind) collected (6870)
Seat 6: chertas3 (button) (small blind) folded on the River



PokerStars Hand #100390029876: Tournament #750518676, $0.23+$0.02 USD Hold'em No Limit - Level XIV (800/1600) - 2013/06/21 22:35:49 BRT [2013/06/21 21:35:49 ET]
Table '750518676 2' 9-max Seat #2 is the button
Seat 2: dfcastro.net (27365 in chips) 
Seat 6: chertas3 (40135 in chips) 
dfcastro.net: posts the ante 75
chertas3: posts the ante 75
dfcastro.net: posts small blind 800
chertas3: posts big blind 1600
*** HOLE CARDS ***
Dealt to dfcastro.net [Jd Kh]
dfcastro.net: raises 25690 to 27290 and is all-in
chertas3: folds 
Uncalled bet (25690) returned to dfcastro.net
dfcastro.net collected 3350 from pot
dfcastro.net: doesn't show hand 
*** SUMMARY ***
Total pot 3350 | Rake 0 
Seat 2: dfcastro.net (button) (small blind) collected (3350)
Seat 6: chertas3 (big blind) folded before Flop



PokerStars Hand #100390033639: Tournament #750518676, $0.23+$0.02 USD Hold'em No Limit - Level XIV (800/1600) - 2013/06/21 22:35:58 BRT [2013/06/21 21:35:58 ET]
Table '750518676 2' 9-max Seat #6 is the button
Seat 2: dfcastro.net (29040 in chips) 
Seat 6: chertas3 (38460 in chips) 
dfcastro.net: posts the ante 75
chertas3: posts the ante 75
chertas3: posts small blind 800
dfcastro.net: posts big blind 1600
*** HOLE CARDS ***
Dealt to dfcastro.net [Qs 8d]
chertas3: calls 800
dfcastro.net: raises 27365 to 28965 and is all-in
chertas3: folds 
Uncalled bet (27365) returned to dfcastro.net
dfcastro.net collected 3350 from pot
dfcastro.net: doesn't show hand 
*** SUMMARY ***
Total pot 3350 | Rake 0 
Seat 2: dfcastro.net (big blind) collected (3350)
Seat 6: chertas3 (button) (small blind) folded before Flop



PokerStars Hand #100390037857: Tournament #750518676, $0.23+$0.02 USD Hold'em No Limit - Level XIV (800/1600) - 2013/06/21 22:36:08 BRT [2013/06/21 21:36:08 ET]
Table '750518676 2' 9-max Seat #2 is the button
Seat 2: dfcastro.net (30715 in chips) 
Seat 6: chertas3 (36785 in chips) 
dfcastro.net: posts the ante 75
chertas3: posts the ante 75
dfcastro.net: posts small blind 800
chertas3: posts big blind 1600
*** HOLE CARDS ***
Dealt to dfcastro.net [4h 7h]
dfcastro.net: folds 
Uncalled bet (800) returned to chertas3
chertas3 collected 1750 from pot
chertas3: doesn't show hand 
*** SUMMARY ***
Total pot 1750 | Rake 0 
Seat 2: dfcastro.net (button) (small blind) folded before Flop
Seat 6: chertas3 (big blind) collected (1750)



PokerStars Hand #100390040488: Tournament #750518676, $0.23+$0.02 USD Hold'em No Limit - Level XIV (800/1600) - 2013/06/21 22:36:14 BRT [2013/06/21 21:36:14 ET]
Table '750518676 2' 9-max Seat #6 is the button
Seat 2: dfcastro.net (29840 in chips) 
Seat 6: chertas3 (37660 in chips) 
dfcastro.net: posts the ante 75
chertas3: posts the ante 75
chertas3: posts small blind 800
dfcastro.net: posts big blind 1600
*** HOLE CARDS ***
Dealt to dfcastro.net [Ac 9h]
chertas3: calls 800
dfcastro.net: raises 28165 to 29765 and is all-in
chertas3: folds 
Uncalled bet (28165) returned to dfcastro.net
dfcastro.net collected 3350 from pot
dfcastro.net: doesn't show hand 
*** SUMMARY ***
Total pot 3350 | Rake 0 
Seat 2: dfcastro.net (big blind) collected (3350)
Seat 6: chertas3 (button) (small blind) folded before Flop



PokerStars Hand #100390045024: Tournament #750518676, $0.23+$0.02 USD Hold'em No Limit - Level XIV (800/1600) - 2013/06/21 22:36:25 BRT [2013/06/21 21:36:25 ET]
Table '750518676 2' 9-max Seat #2 is the button
Seat 2: dfcastro.net (31515 in chips) 
Seat 6: chertas3 (35985 in chips) 
dfcastro.net: posts the ante 75
chertas3: posts the ante 75
dfcastro.net: posts small blind 800
chertas3: posts big blind 1600
*** HOLE CARDS ***
Dealt to dfcastro.net [6h 9d]
dfcastro.net: folds 
Uncalled bet (800) returned to chertas3
chertas3 collected 1750 from pot
chertas3: doesn't show hand 
*** SUMMARY ***
Total pot 1750 | Rake 0 
Seat 2: dfcastro.net (button) (small blind) folded before Flop
Seat 6: chertas3 (big blind) collected (1750)



PokerStars Hand #100390047675: Tournament #750518676, $0.23+$0.02 USD Hold'em No Limit - Level XIV (800/1600) - 2013/06/21 22:36:32 BRT [2013/06/21 21:36:32 ET]
Table '750518676 2' 9-max Seat #6 is the button
Seat 2: dfcastro.net (30640 in chips) 
Seat 6: chertas3 (36860 in chips) 
dfcastro.net: posts the ante 75
chertas3: posts the ante 75
chertas3: posts small blind 800
dfcastro.net: posts big blind 1600
*** HOLE CARDS ***
Dealt to dfcastro.net [5c Kh]
chertas3: calls 800
dfcastro.net: checks 
*** FLOP *** [5h 5s 2c]
dfcastro.net: checks 
chertas3: bets 2512
dfcastro.net: calls 2512
*** TURN *** [5h 5s 2c] [6c]
dfcastro.net: checks 
chertas3: checks 
*** RIVER *** [5h 5s 2c 6c] [Qh]
dfcastro.net: bets 8000
chertas3: folds 
Uncalled bet (8000) returned to dfcastro.net
dfcastro.net collected 8374 from pot
dfcastro.net: doesn't show hand 
*** SUMMARY ***
Total pot 8374 | Rake 0 
Board [5h 5s 2c 6c Qh]
Seat 2: dfcastro.net (big blind) collected (8374)
Seat 6: chertas3 (button) (small blind) folded on the River



PokerStars Hand #100390058486: Tournament #750518676, $0.23+$0.02 USD Hold'em No Limit - Level XIV (800/1600) - 2013/06/21 22:36:58 BRT [2013/06/21 21:36:58 ET]
Table '750518676 2' 9-max Seat #2 is the button
Seat 2: dfcastro.net (34827 in chips) 
Seat 6: chertas3 (32673 in chips) 
dfcastro.net: posts the ante 75
chertas3: posts the ante 75
dfcastro.net: posts small blind 800
chertas3: posts big blind 1600
*** HOLE CARDS ***
Dealt to dfcastro.net [Ad Ks]
dfcastro.net: raises 33152 to 34752 and is all-in
chertas3: folds 
Uncalled bet (33152) returned to dfcastro.net
dfcastro.net collected 3350 from pot
dfcastro.net: doesn't show hand 
*** SUMMARY ***
Total pot 3350 | Rake 0 
Seat 2: dfcastro.net (button) (small blind) collected (3350)
Seat 6: chertas3 (big blind) folded before Flop



PokerStars Hand #100390062108: Tournament #750518676, $0.23+$0.02 USD Hold'em No Limit - Level XIV (800/1600) - 2013/06/21 22:37:07 BRT [2013/06/21 21:37:07 ET]
Table '750518676 2' 9-max Seat #6 is the button
Seat 2: dfcastro.net (36502 in chips) 
Seat 6: chertas3 (30998 in chips) 
dfcastro.net: posts the ante 75
chertas3: posts the ante 75
chertas3: posts small blind 800
dfcastro.net: posts big blind 1600
*** HOLE CARDS ***
Dealt to dfcastro.net [2h 5c]
chertas3: calls 800
dfcastro.net: checks 
*** FLOP *** [3d 8d 7d]
dfcastro.net: checks 
chertas3: bets 2512
dfcastro.net: folds 
Uncalled bet (2512) returned to chertas3
chertas3 collected 3350 from pot
chertas3: doesn't show hand 
*** SUMMARY ***
Total pot 3350 | Rake 0 
Board [3d 8d 7d]
Seat 2: dfcastro.net (big blind) folded on the Flop
Seat 6: chertas3 (button) (small blind) collected (3350)



PokerStars Hand #100390068889: Tournament #750518676, $0.23+$0.02 USD Hold'em No Limit - Level XIV (800/1600) - 2013/06/21 22:37:24 BRT [2013/06/21 21:37:24 ET]
Table '750518676 2' 9-max Seat #2 is the button
Seat 2: dfcastro.net (34827 in chips) 
Seat 6: chertas3 (32673 in chips) 
dfcastro.net: posts the ante 75
chertas3: posts the ante 75
dfcastro.net: posts small blind 800
chertas3: posts big blind 1600
*** HOLE CARDS ***
Dealt to dfcastro.net [4h Ts]
dfcastro.net: folds 
Uncalled bet (800) returned to chertas3
chertas3 collected 1750 from pot
chertas3: doesn't show hand 
*** SUMMARY ***
Total pot 1750 | Rake 0 
Seat 2: dfcastro.net (button) (small blind) folded before Flop
Seat 6: chertas3 (big blind) collected (1750)



PokerStars Hand #100390071527: Tournament #750518676, $0.23+$0.02 USD Hold'em No Limit - Level XIV (800/1600) - 2013/06/21 22:37:30 BRT [2013/06/21 21:37:30 ET]
Table '750518676 2' 9-max Seat #6 is the button
Seat 2: dfcastro.net (33952 in chips) 
Seat 6: chertas3 (33548 in chips) 
dfcastro.net: posts the ante 75
chertas3: posts the ante 75
chertas3: posts small blind 800
dfcastro.net: posts big blind 1600
*** HOLE CARDS ***
Dealt to dfcastro.net [4c 8c]
chertas3: calls 800
dfcastro.net: checks 
*** FLOP *** [2s 8s Jc]
dfcastro.net: bets 3200
chertas3: folds 
Uncalled bet (3200) returned to dfcastro.net
dfcastro.net collected 3350 from pot
dfcastro.net: doesn't show hand 
*** SUMMARY ***
Total pot 3350 | Rake 0 
Board [2s 8s Jc]
Seat 2: dfcastro.net (big blind) collected (3350)
Seat 6: chertas3 (button) (small blind) folded on the Flop



PokerStars Hand #100390076953: Tournament #750518676, $0.23+$0.02 USD Hold'em No Limit - Level XIV (800/1600) - 2013/06/21 22:37:44 BRT [2013/06/21 21:37:44 ET]
Table '750518676 2' 9-max Seat #2 is the button
Seat 2: dfcastro.net (35627 in chips) 
Seat 6: chertas3 (31873 in chips) 
dfcastro.net: posts the ante 75
chertas3: posts the ante 75
dfcastro.net: posts small blind 800
chertas3: posts big blind 1600
*** HOLE CARDS ***
Dealt to dfcastro.net [9s Kd]
dfcastro.net: calls 800
chertas3: checks 
*** FLOP *** [Jc 5c 3s]
chertas3: checks 
dfcastro.net: bets 1600
chertas3: calls 1600
*** TURN *** [Jc 5c 3s] [6c]
chertas3: checks 
dfcastro.net: checks 
*** RIVER *** [Jc 5c 3s 6c] [4s]
chertas3: checks 
dfcastro.net: checks 
*** SHOW DOWN ***
chertas3: shows [8s Jh] (a pair of Jacks)
dfcastro.net: mucks hand 
chertas3 collected 6550 from pot
*** SUMMARY ***
Total pot 6550 | Rake 0 
Board [Jc 5c 3s 6c 4s]
Seat 2: dfcastro.net (button) (small blind) mucked [9s Kd]
Seat 6: chertas3 (big blind) showed [8s Jh] and won (6550) with a pair of Jacks



PokerStars Hand #100390088106: Tournament #750518676, $0.23+$0.02 USD Hold'em No Limit - Level XIV (800/1600) - 2013/06/21 22:38:11 BRT [2013/06/21 21:38:11 ET]
Table '750518676 2' 9-max Seat #6 is the button
Seat 2: dfcastro.net (32352 in chips) 
Seat 6: chertas3 (35148 in chips) 
dfcastro.net: posts the ante 75
chertas3: posts the ante 75
chertas3: posts small blind 800
dfcastro.net: posts big blind 1600
*** HOLE CARDS ***
Dealt to dfcastro.net [5h Kd]
chertas3: calls 800
dfcastro.net: checks 
*** FLOP *** [Tc Qh 2h]
dfcastro.net: checks 
chertas3: bets 2512
dfcastro.net: folds 
Uncalled bet (2512) returned to chertas3
chertas3 collected 3350 from pot
chertas3: doesn't show hand 
*** SUMMARY ***
Total pot 3350 | Rake 0 
Board [Tc Qh 2h]
Seat 2: dfcastro.net (big blind) folded on the Flop
Seat 6: chertas3 (button) (small blind) collected (3350)



PokerStars Hand #100390094940: Tournament #750518676, $0.23+$0.02 USD Hold'em No Limit - Level XIV (800/1600) - 2013/06/21 22:38:28 BRT [2013/06/21 21:38:28 ET]
Table '750518676 2' 9-max Seat #2 is the button
Seat 2: dfcastro.net (30677 in chips) 
Seat 6: chertas3 (36823 in chips) 
dfcastro.net: posts the ante 75
chertas3: posts the ante 75
dfcastro.net: posts small blind 800
chertas3: posts big blind 1600
*** HOLE CARDS ***
Dealt to dfcastro.net [Kd 9c]
dfcastro.net: raises 29002 to 30602 and is all-in
chertas3: folds 
Uncalled bet (29002) returned to dfcastro.net
dfcastro.net collected 3350 from pot
dfcastro.net: doesn't show hand 
*** SUMMARY ***
Total pot 3350 | Rake 0 
Seat 2: dfcastro.net (button) (small blind) collected (3350)
Seat 6: chertas3 (big blind) folded before Flop



PokerStars Hand #100390099042: Tournament #750518676, $0.23+$0.02 USD Hold'em No Limit - Level XIV (800/1600) - 2013/06/21 22:38:38 BRT [2013/06/21 21:38:38 ET]
Table '750518676 2' 9-max Seat #6 is the button
Seat 2: dfcastro.net (32352 in chips) 
Seat 6: chertas3 (35148 in chips) 
dfcastro.net: posts the ante 75
chertas3: posts the ante 75
chertas3: posts small blind 800
dfcastro.net: posts big blind 1600
*** HOLE CARDS ***
Dealt to dfcastro.net [7h Ah]
chertas3: raises 1760 to 3360
dfcastro.net: raises 28917 to 32277 and is all-in
chertas3: folds 
Uncalled bet (28917) returned to dfcastro.net
dfcastro.net collected 6870 from pot
dfcastro.net: doesn't show hand 
*** SUMMARY ***
Total pot 6870 | Rake 0 
Seat 2: dfcastro.net (big blind) collected (6870)
Seat 6: chertas3 (button) (small blind) folded before Flop



PokerStars Hand #100390103522: Tournament #750518676, $0.23+$0.02 USD Hold'em No Limit - Level XIV (800/1600) - 2013/06/21 22:38:49 BRT [2013/06/21 21:38:49 ET]
Table '750518676 2' 9-max Seat #2 is the button
Seat 2: dfcastro.net (35787 in chips) 
Seat 6: chertas3 (31713 in chips) 
dfcastro.net: posts the ante 75
chertas3: posts the ante 75
dfcastro.net: posts small blind 800
chertas3: posts big blind 1600
*** HOLE CARDS ***
Dealt to dfcastro.net [3d Ts]
dfcastro.net: folds 
Uncalled bet (800) returned to chertas3
chertas3 collected 1750 from pot
chertas3: doesn't show hand 
*** SUMMARY ***
Total pot 1750 | Rake 0 
Seat 2: dfcastro.net (button) (small blind) folded before Flop
Seat 6: chertas3 (big blind) collected (1750)



PokerStars Hand #100390106066: Tournament #750518676, $0.23+$0.02 USD Hold'em No Limit - Level XIV (800/1600) - 2013/06/21 22:38:56 BRT [2013/06/21 21:38:56 ET]
Table '750518676 2' 9-max Seat #6 is the button
Seat 2: dfcastro.net (34912 in chips) 
Seat 6: chertas3 (32588 in chips) 
dfcastro.net: posts the ante 75
chertas3: posts the ante 75
chertas3: posts small blind 800
dfcastro.net: posts big blind 1600
*** HOLE CARDS ***
Dealt to dfcastro.net [8s 4d]
chertas3: raises 1760 to 3360
dfcastro.net: folds 
Uncalled bet (1760) returned to chertas3
chertas3 collected 3350 from pot
chertas3: doesn't show hand 
*** SUMMARY ***
Total pot 3350 | Rake 0 
Seat 2: dfcastro.net (big blind) folded before Flop
Seat 6: chertas3 (button) (small blind) collected (3350)



PokerStars Hand #100390109396: Tournament #750518676, $0.23+$0.02 USD Hold'em No Limit - Level XIV (800/1600) - 2013/06/21 22:39:04 BRT [2013/06/21 21:39:04 ET]
Table '750518676 2' 9-max Seat #2 is the button
Seat 2: dfcastro.net (33237 in chips) 
Seat 6: chertas3 (34263 in chips) 
dfcastro.net: posts the ante 75
chertas3: posts the ante 75
dfcastro.net: posts small blind 800
chertas3: posts big blind 1600
*** HOLE CARDS ***
Dealt to dfcastro.net [2s 9s]
dfcastro.net: folds 
Uncalled bet (800) returned to chertas3
chertas3 collected 1750 from pot
chertas3: doesn't show hand 
*** SUMMARY ***
Total pot 1750 | Rake 0 
Seat 2: dfcastro.net (button) (small blind) folded before Flop
Seat 6: chertas3 (big blind) collected (1750)



PokerStars Hand #100390112097: Tournament #750518676, $0.23+$0.02 USD Hold'em No Limit - Level XIV (800/1600) - 2013/06/21 22:39:10 BRT [2013/06/21 21:39:10 ET]
Table '750518676 2' 9-max Seat #6 is the button
Seat 2: dfcastro.net (32362 in chips) 
Seat 6: chertas3 (35138 in chips) 
dfcastro.net: posts the ante 75
chertas3: posts the ante 75
chertas3: posts small blind 800
dfcastro.net: posts big blind 1600
*** HOLE CARDS ***
Dealt to dfcastro.net [3d 7s]
chertas3: raises 1760 to 3360
dfcastro.net: folds 
Uncalled bet (1760) returned to chertas3
chertas3 collected 3350 from pot
chertas3: doesn't show hand 
*** SUMMARY ***
Total pot 3350 | Rake 0 
Seat 2: dfcastro.net (big blind) folded before Flop
Seat 6: chertas3 (button) (small blind) collected (3350)



PokerStars Hand #100390115820: Tournament #750518676, $0.23+$0.02 USD Hold'em No Limit - Level XIV (800/1600) - 2013/06/21 22:39:19 BRT [2013/06/21 21:39:19 ET]
Table '750518676 2' 9-max Seat #2 is the button
Seat 2: dfcastro.net (30687 in chips) 
Seat 6: chertas3 (36813 in chips) 
dfcastro.net: posts the ante 75
chertas3: posts the ante 75
dfcastro.net: posts small blind 800
chertas3: posts big blind 1600
*** HOLE CARDS ***
Dealt to dfcastro.net [9d 8s]
dfcastro.net: raises 29012 to 30612 and is all-in
chertas3: folds 
Uncalled bet (29012) returned to dfcastro.net
dfcastro.net collected 3350 from pot
dfcastro.net: doesn't show hand 
*** SUMMARY ***
Total pot 3350 | Rake 0 
Seat 2: dfcastro.net (button) (small blind) collected (3350)
Seat 6: chertas3 (big blind) folded before Flop



PokerStars Hand #100390120148: Tournament #750518676, $0.23+$0.02 USD Hold'em No Limit - Level XIV (800/1600) - 2013/06/21 22:39:30 BRT [2013/06/21 21:39:30 ET]
Table '750518676 2' 9-max Seat #6 is the button
Seat 2: dfcastro.net (32362 in chips) 
Seat 6: chertas3 (35138 in chips) 
dfcastro.net: posts the ante 75
chertas3: posts the ante 75
chertas3: posts small blind 800
dfcastro.net: posts big blind 1600
*** HOLE CARDS ***
Dealt to dfcastro.net [Qd 5s]
chertas3: raises 1760 to 3360
dfcastro.net: calls 1760
*** FLOP *** [5d 6d 2d]
dfcastro.net: checks 
chertas3: checks 
*** TURN *** [5d 6d 2d] [Qs]
dfcastro.net: checks 
chertas3: checks 
*** RIVER *** [5d 6d 2d Qs] [6h]
dfcastro.net: bets 1600
chertas3: raises 5035 to 6635
dfcastro.net: raises 22292 to 28927 and is all-in
chertas3: calls 22292
*** SHOW DOWN ***
dfcastro.net: shows [Qd 5s] (two pair, Queens and Sixes)
chertas3: shows [9d Ad] (a flush, Ace high)
chertas3 collected 64724 from pot
dfcastro.net finished the tournament in 2nd place and received $2.22.
chertas3 wins the tournament and receives $3.23 - congratulations!
*** SUMMARY ***
Total pot 64724 | Rake 0 
Board [5d 6d 2d Qs 6h]
Seat 2: dfcastro.net (big blind) showed [Qd 5s] and lost with two pair, Queens and Sixes
Seat 6: chertas3 (button) (small blind) showed [9d Ad] and won (64724) with a flush, Ace high



