PokerStars Hand #97775299537: Tournament #725058424, $0.23+$0.02 USD Hold'em No Limit - Level I (10/20) - 2013/04/27 15:39:33 BRT [2013/04/27 14:39:33 ET]
Table '725058424 1' 9-max Seat #1 is the button
Seat 1: Krpnsk (1500 in chips) 
Seat 2: 75anatoliy (1500 in chips) 
Seat 3: osiolfish (1500 in chips) 
Seat 4: carlaocosta (1500 in chips) 
Seat 5: dfcastro.net (1500 in chips) 
Seat 6: stackchips12 (1500 in chips) 
Seat 7: 2bgd1 (1500 in chips) 
Seat 8: andedik (1500 in chips) 
Seat 9: skandal76 (1500 in chips) 
75anatoliy: posts small blind 10
osiolfish: posts big blind 20
*** HOLE CARDS ***
Dealt to dfcastro.net [Kc 7d]
carlaocosta: folds 
dfcastro.net: folds 
stackchips12: folds 
2bgd1: calls 20
andedik: folds 
skandal76: folds 
Krpnsk: folds 
75anatoliy has timed out
75anatoliy: folds 
75anatoliy is sitting out
osiolfish: checks 
*** FLOP *** [Ac Ks 5c]
osiolfish: checks 
2bgd1: bets 40
75anatoliy has returned
osiolfish: calls 40
*** TURN *** [Ac Ks 5c] [3c]
osiolfish: checks 
2bgd1: bets 40
osiolfish: folds 
Uncalled bet (40) returned to 2bgd1
2bgd1 collected 130 from pot
*** SUMMARY ***
Total pot 130 | Rake 0 
Board [Ac Ks 5c 3c]
Seat 1: Krpnsk (button) folded before Flop (didn't bet)
Seat 2: 75anatoliy (small blind) folded before Flop
Seat 3: osiolfish (big blind) folded on the Turn
Seat 4: carlaocosta folded before Flop (didn't bet)
Seat 5: dfcastro.net folded before Flop (didn't bet)
Seat 6: stackchips12 folded before Flop (didn't bet)
Seat 7: 2bgd1 collected (130)
Seat 8: andedik folded before Flop (didn't bet)
Seat 9: skandal76 folded before Flop (didn't bet)



PokerStars Hand #97775419760: Tournament #725058424, $0.23+$0.02 USD Hold'em No Limit - Level I (10/20) - 2013/04/27 15:41:48 BRT [2013/04/27 14:41:48 ET]
Table '725058424 1' 9-max Seat #2 is the button
Seat 1: Krpnsk (1500 in chips) 
Seat 2: 75anatoliy (1490 in chips) 
Seat 3: osiolfish (1440 in chips) 
Seat 4: carlaocosta (1500 in chips) 
Seat 5: dfcastro.net (1500 in chips) 
Seat 6: stackchips12 (1500 in chips) 
Seat 7: 2bgd1 (1570 in chips) 
Seat 8: andedik (1500 in chips) 
Seat 9: skandal76 (1500 in chips) 
osiolfish: posts small blind 10
carlaocosta: posts big blind 20
*** HOLE CARDS ***
Dealt to dfcastro.net [Ad Qh]
dfcastro.net: folds 
stackchips12: raises 20 to 40
2bgd1: folds 
andedik: calls 40
skandal76: folds 
Krpnsk: calls 40
75anatoliy: folds 
osiolfish: calls 30
carlaocosta: folds 
*** FLOP *** [8d Kc 6d]
osiolfish: checks 
stackchips12: checks 
andedik: checks 
Krpnsk: bets 40
osiolfish: calls 40
stackchips12: folds 
andedik: calls 40
*** TURN *** [8d Kc 6d] [7s]
osiolfish: checks 
andedik: checks 
Krpnsk: bets 120
osiolfish: calls 120
andedik: folds 
*** RIVER *** [8d Kc 6d 7s] [4s]
osiolfish: checks 
Krpnsk: bets 240
osiolfish: folds 
Uncalled bet (240) returned to Krpnsk
Krpnsk collected 540 from pot
*** SUMMARY ***
Total pot 540 | Rake 0 
Board [8d Kc 6d 7s 4s]
Seat 1: Krpnsk collected (540)
Seat 2: 75anatoliy (button) folded before Flop (didn't bet)
Seat 3: osiolfish (small blind) folded on the River
Seat 4: carlaocosta (big blind) folded before Flop
Seat 5: dfcastro.net folded before Flop (didn't bet)
Seat 6: stackchips12 folded on the Flop
Seat 7: 2bgd1 folded before Flop (didn't bet)
Seat 8: andedik folded on the Turn
Seat 9: skandal76 folded before Flop (didn't bet)



PokerStars Hand #97775501321: Tournament #725058424, $0.23+$0.02 USD Hold'em No Limit - Level I (10/20) - 2013/04/27 15:43:19 BRT [2013/04/27 14:43:19 ET]
Table '725058424 1' 9-max Seat #3 is the button
Seat 1: Krpnsk (1840 in chips) 
Seat 2: 75anatoliy (1490 in chips) 
Seat 3: osiolfish (1240 in chips) 
Seat 4: carlaocosta (1480 in chips) 
Seat 5: dfcastro.net (1500 in chips) 
Seat 6: stackchips12 (1460 in chips) 
Seat 7: 2bgd1 (1570 in chips) 
Seat 8: andedik (1420 in chips) 
Seat 9: skandal76 (1500 in chips) 
carlaocosta: posts small blind 10
dfcastro.net: posts big blind 20
*** HOLE CARDS ***
Dealt to dfcastro.net [Js 9c]
stackchips12: folds 
2bgd1: calls 20
andedik: folds 
skandal76: folds 
Krpnsk: raises 60 to 80
75anatoliy: folds 
osiolfish: folds 
carlaocosta: calls 70
dfcastro.net: folds 
2bgd1: calls 60
*** FLOP *** [7c Kd Jh]
carlaocosta: checks 
2bgd1: checks 
Krpnsk: bets 80
carlaocosta: folds 
2bgd1: calls 80
*** TURN *** [7c Kd Jh] [9h]
2bgd1: checks 
Krpnsk: checks 
*** RIVER *** [7c Kd Jh 9h] [5s]
2bgd1: checks 
Krpnsk: checks 
*** SHOW DOWN ***
2bgd1: shows [Ad 7d] (a pair of Sevens)
Krpnsk: shows [Th Ts] (a pair of Tens)
Krpnsk collected 420 from pot
*** SUMMARY ***
Total pot 420 | Rake 0 
Board [7c Kd Jh 9h 5s]
Seat 1: Krpnsk showed [Th Ts] and won (420) with a pair of Tens
Seat 2: 75anatoliy folded before Flop (didn't bet)
Seat 3: osiolfish (button) folded before Flop (didn't bet)
Seat 4: carlaocosta (small blind) folded on the Flop
Seat 5: dfcastro.net (big blind) folded before Flop
Seat 6: stackchips12 folded before Flop (didn't bet)
Seat 7: 2bgd1 showed [Ad 7d] and lost with a pair of Sevens
Seat 8: andedik folded before Flop (didn't bet)
Seat 9: skandal76 folded before Flop (didn't bet)



PokerStars Hand #97775564765: Tournament #725058424, $0.23+$0.02 USD Hold'em No Limit - Level I (10/20) - 2013/04/27 15:44:30 BRT [2013/04/27 14:44:30 ET]
Table '725058424 1' 9-max Seat #4 is the button
Seat 1: Krpnsk (2100 in chips) 
Seat 2: 75anatoliy (1490 in chips) 
Seat 3: osiolfish (1240 in chips) 
Seat 4: carlaocosta (1400 in chips) 
Seat 5: dfcastro.net (1480 in chips) 
Seat 7: 2bgd1 (1410 in chips) 
Seat 8: andedik (1420 in chips) 
Seat 9: skandal76 (1500 in chips) 
dfcastro.net: posts small blind 10
2bgd1: posts big blind 20
*** HOLE CARDS ***
Dealt to dfcastro.net [9s 3c]
andedik: folds 
skandal76: folds 
Krpnsk: folds 
75anatoliy: folds 
osiolfish: raises 40 to 60
carlaocosta: calls 60
dfcastro.net: folds 
2bgd1: calls 40
*** FLOP *** [9h 5h Ad]
2bgd1: checks 
osiolfish: bets 120
carlaocosta: folds 
2bgd1: folds 
Uncalled bet (120) returned to osiolfish
osiolfish collected 190 from pot
*** SUMMARY ***
Total pot 190 | Rake 0 
Board [9h 5h Ad]
Seat 1: Krpnsk folded before Flop (didn't bet)
Seat 2: 75anatoliy folded before Flop (didn't bet)
Seat 3: osiolfish collected (190)
Seat 4: carlaocosta (button) folded on the Flop
Seat 5: dfcastro.net (small blind) folded before Flop
Seat 7: 2bgd1 (big blind) folded on the Flop
Seat 8: andedik folded before Flop (didn't bet)
Seat 9: skandal76 folded before Flop (didn't bet)



PokerStars Hand #97775615416: Tournament #725058424, $0.23+$0.02 USD Hold'em No Limit - Level I (10/20) - 2013/04/27 15:45:26 BRT [2013/04/27 14:45:26 ET]
Table '725058424 1' 9-max Seat #5 is the button
Seat 1: Krpnsk (2100 in chips) 
Seat 2: 75anatoliy (1490 in chips) 
Seat 3: osiolfish (1370 in chips) 
Seat 4: carlaocosta (1340 in chips) 
Seat 5: dfcastro.net (1470 in chips) 
Seat 7: 2bgd1 (1350 in chips) 
Seat 8: andedik (1420 in chips) 
Seat 9: skandal76 (1500 in chips) 
2bgd1: posts small blind 10
andedik: posts big blind 20
*** HOLE CARDS ***
Dealt to dfcastro.net [Js 2d]
skandal76: folds 
Krpnsk: folds 
75anatoliy: raises 20 to 40
osiolfish: folds 
carlaocosta: folds 
dfcastro.net: folds 
2bgd1: calls 30
andedik: calls 20
*** FLOP *** [As 4h 2s]
2bgd1: checks 
andedik: checks 
75anatoliy: checks 
*** TURN *** [As 4h 2s] [3c]
2bgd1: checks 
andedik: checks 
75anatoliy: checks 
*** RIVER *** [As 4h 2s 3c] [3s]
2bgd1: bets 60
andedik: folds 
75anatoliy: calls 60
*** SHOW DOWN ***
2bgd1: shows [7h 5h] (a straight, Ace to Five)
75anatoliy: mucks hand 
2bgd1 collected 240 from pot
*** SUMMARY ***
Total pot 240 | Rake 0 
Board [As 4h 2s 3c 3s]
Seat 1: Krpnsk folded before Flop (didn't bet)
Seat 2: 75anatoliy mucked [Qd Kh]
Seat 3: osiolfish folded before Flop (didn't bet)
Seat 4: carlaocosta folded before Flop (didn't bet)
Seat 5: dfcastro.net (button) folded before Flop (didn't bet)
Seat 7: 2bgd1 (small blind) showed [7h 5h] and won (240) with a straight, Ace to Five
Seat 8: andedik (big blind) folded on the River
Seat 9: skandal76 folded before Flop (didn't bet)



PokerStars Hand #97775664739: Tournament #725058424, $0.23+$0.02 USD Hold'em No Limit - Level I (10/20) - 2013/04/27 15:46:21 BRT [2013/04/27 14:46:21 ET]
Table '725058424 1' 9-max Seat #7 is the button
Seat 1: Krpnsk (2100 in chips) 
Seat 2: 75anatoliy (1390 in chips) 
Seat 3: osiolfish (1370 in chips) 
Seat 4: carlaocosta (1340 in chips) 
Seat 5: dfcastro.net (1470 in chips) 
Seat 7: 2bgd1 (1490 in chips) 
Seat 8: andedik (1380 in chips) 
Seat 9: skandal76 (1500 in chips) 
andedik: posts small blind 10
skandal76: posts big blind 20
*** HOLE CARDS ***
Dealt to dfcastro.net [Ah 8h]
Krpnsk: raises 40 to 60
75anatoliy: calls 60
osiolfish: folds 
carlaocosta: folds 
dfcastro.net: folds 
2bgd1: calls 60
andedik: calls 50
skandal76: folds 
*** FLOP *** [8c 3h 6d]
andedik: checks 
Krpnsk: bets 100
75anatoliy: folds 
2bgd1: folds 
andedik: folds 
Uncalled bet (100) returned to Krpnsk
Krpnsk collected 260 from pot
*** SUMMARY ***
Total pot 260 | Rake 0 
Board [8c 3h 6d]
Seat 1: Krpnsk collected (260)
Seat 2: 75anatoliy folded on the Flop
Seat 3: osiolfish folded before Flop (didn't bet)
Seat 4: carlaocosta folded before Flop (didn't bet)
Seat 5: dfcastro.net folded before Flop (didn't bet)
Seat 7: 2bgd1 (button) folded on the Flop
Seat 8: andedik (small blind) folded on the Flop
Seat 9: skandal76 (big blind) folded before Flop



PokerStars Hand #97775718434: Tournament #725058424, $0.23+$0.02 USD Hold'em No Limit - Level I (10/20) - 2013/04/27 15:47:21 BRT [2013/04/27 14:47:21 ET]
Table '725058424 1' 9-max Seat #8 is the button
Seat 1: Krpnsk (2300 in chips) 
Seat 2: 75anatoliy (1330 in chips) 
Seat 3: osiolfish (1370 in chips) 
Seat 4: carlaocosta (1340 in chips) 
Seat 5: dfcastro.net (1470 in chips) 
Seat 7: 2bgd1 (1430 in chips) 
Seat 8: andedik (1320 in chips) 
Seat 9: skandal76 (1480 in chips) 
skandal76: posts small blind 10
Krpnsk: posts big blind 20
*** HOLE CARDS ***
Dealt to dfcastro.net [7s 4s]
75anatoliy: calls 20
osiolfish: folds 
carlaocosta: folds 
dfcastro.net: folds 
2bgd1: calls 20
andedik: folds 
skandal76: folds 
Krpnsk: checks 
*** FLOP *** [4d 8s 2c]
Krpnsk: checks 
75anatoliy: bets 60
2bgd1: calls 60
Krpnsk: calls 60
*** TURN *** [4d 8s 2c] [7h]
Krpnsk: checks 
75anatoliy: bets 100
2bgd1: calls 100
Krpnsk: folds 
*** RIVER *** [4d 8s 2c 7h] [2h]
75anatoliy: bets 100
2bgd1: folds 
Uncalled bet (100) returned to 75anatoliy
75anatoliy collected 450 from pot
75anatoliy: doesn't show hand 
*** SUMMARY ***
Total pot 450 | Rake 0 
Board [4d 8s 2c 7h 2h]
Seat 1: Krpnsk (big blind) folded on the Turn
Seat 2: 75anatoliy collected (450)
Seat 3: osiolfish folded before Flop (didn't bet)
Seat 4: carlaocosta folded before Flop (didn't bet)
Seat 5: dfcastro.net folded before Flop (didn't bet)
Seat 7: 2bgd1 folded on the River
Seat 8: andedik (button) folded before Flop (didn't bet)
Seat 9: skandal76 (small blind) folded before Flop



PokerStars Hand #97775786842: Tournament #725058424, $0.23+$0.02 USD Hold'em No Limit - Level I (10/20) - 2013/04/27 15:48:38 BRT [2013/04/27 14:48:38 ET]
Table '725058424 1' 9-max Seat #9 is the button
Seat 1: Krpnsk (2220 in chips) 
Seat 2: 75anatoliy (1600 in chips) 
Seat 3: osiolfish (1370 in chips) 
Seat 4: carlaocosta (1340 in chips) 
Seat 5: dfcastro.net (1470 in chips) 
Seat 7: 2bgd1 (1250 in chips) 
Seat 8: andedik (1320 in chips) 
Seat 9: skandal76 (1470 in chips) 
Krpnsk: posts small blind 10
75anatoliy: posts big blind 20
*** HOLE CARDS ***
Dealt to dfcastro.net [Kd 8d]
osiolfish: folds 
carlaocosta: folds 
dfcastro.net: folds 
2bgd1: calls 20
andedik: folds 
skandal76: folds 
Krpnsk: calls 10
75anatoliy: checks 
*** FLOP *** [Kh 7c 3h]
Krpnsk: checks 
75anatoliy: checks 
2bgd1: checks 
*** TURN *** [Kh 7c 3h] [2c]
Krpnsk: bets 40
75anatoliy: folds 
2bgd1: calls 40
*** RIVER *** [Kh 7c 3h 2c] [Ac]
Krpnsk: bets 60
2bgd1: calls 60
*** SHOW DOWN ***
Krpnsk: shows [2d 3s] (two pair, Threes and Deuces)
2bgd1: mucks hand 
Krpnsk collected 260 from pot
*** SUMMARY ***
Total pot 260 | Rake 0 
Board [Kh 7c 3h 2c Ac]
Seat 1: Krpnsk (small blind) showed [2d 3s] and won (260) with two pair, Threes and Deuces
Seat 2: 75anatoliy (big blind) folded on the Turn
Seat 3: osiolfish folded before Flop (didn't bet)
Seat 4: carlaocosta folded before Flop (didn't bet)
Seat 5: dfcastro.net folded before Flop (didn't bet)
Seat 7: 2bgd1 mucked [6d 7h]
Seat 8: andedik folded before Flop (didn't bet)
Seat 9: skandal76 (button) folded before Flop (didn't bet)



PokerStars Hand #97775832104: Tournament #725058424, $0.23+$0.02 USD Hold'em No Limit - Level I (10/20) - 2013/04/27 15:49:29 BRT [2013/04/27 14:49:29 ET]
Table '725058424 1' 9-max Seat #1 is the button
Seat 1: Krpnsk (2360 in chips) 
Seat 2: 75anatoliy (1580 in chips) 
Seat 3: osiolfish (1370 in chips) 
Seat 4: carlaocosta (1340 in chips) 
Seat 5: dfcastro.net (1470 in chips) 
Seat 7: 2bgd1 (1130 in chips) 
Seat 8: andedik (1320 in chips) 
Seat 9: skandal76 (1470 in chips) 
75anatoliy: posts small blind 10
osiolfish: posts big blind 20
*** HOLE CARDS ***
Dealt to dfcastro.net [9c 4c]
carlaocosta: folds 
dfcastro.net: folds 
2bgd1: calls 20
andedik: calls 20
skandal76: folds 
Krpnsk: raises 60 to 80
75anatoliy: raises 1500 to 1580 and is all-in
osiolfish: folds 
2bgd1: folds 
andedik: folds 
Krpnsk: folds 
Uncalled bet (1500) returned to 75anatoliy
75anatoliy collected 220 from pot
75anatoliy: shows [Ks Kd] (a pair of Kings)
*** SUMMARY ***
Total pot 220 | Rake 0 
Seat 1: Krpnsk (button) folded before Flop
Seat 2: 75anatoliy (small blind) collected (220)
Seat 3: osiolfish (big blind) folded before Flop
Seat 4: carlaocosta folded before Flop (didn't bet)
Seat 5: dfcastro.net folded before Flop (didn't bet)
Seat 7: 2bgd1 folded before Flop
Seat 8: andedik folded before Flop
Seat 9: skandal76 folded before Flop (didn't bet)



PokerStars Hand #97775867217: Tournament #725058424, $0.23+$0.02 USD Hold'em No Limit - Level II (15/30) - 2013/04/27 15:50:09 BRT [2013/04/27 14:50:09 ET]
Table '725058424 1' 9-max Seat #2 is the button
Seat 1: Krpnsk (2280 in chips) 
Seat 2: 75anatoliy (1720 in chips) 
Seat 3: osiolfish (1350 in chips) 
Seat 4: carlaocosta (1340 in chips) 
Seat 5: dfcastro.net (1470 in chips) 
Seat 7: 2bgd1 (1110 in chips) 
Seat 8: andedik (1300 in chips) 
Seat 9: skandal76 (1470 in chips) 
osiolfish: posts small blind 15
carlaocosta: posts big blind 30
*** HOLE CARDS ***
Dealt to dfcastro.net [4h Qs]
dfcastro.net: folds 
2bgd1: calls 30
andedik: folds 
skandal76: folds 
Krpnsk: folds 
75anatoliy: folds 
osiolfish: raises 90 to 120
carlaocosta: folds 
2bgd1: calls 90
*** FLOP *** [Ks 5d 7s]
osiolfish: bets 150
2bgd1: folds 
Uncalled bet (150) returned to osiolfish
osiolfish collected 270 from pot
*** SUMMARY ***
Total pot 270 | Rake 0 
Board [Ks 5d 7s]
Seat 1: Krpnsk folded before Flop (didn't bet)
Seat 2: 75anatoliy (button) folded before Flop (didn't bet)
Seat 3: osiolfish (small blind) collected (270)
Seat 4: carlaocosta (big blind) folded before Flop
Seat 5: dfcastro.net folded before Flop (didn't bet)
Seat 7: 2bgd1 folded on the Flop
Seat 8: andedik folded before Flop (didn't bet)
Seat 9: skandal76 folded before Flop (didn't bet)



PokerStars Hand #97775904728: Tournament #725058424, $0.23+$0.02 USD Hold'em No Limit - Level II (15/30) - 2013/04/27 15:50:52 BRT [2013/04/27 14:50:52 ET]
Table '725058424 1' 9-max Seat #3 is the button
Seat 1: Krpnsk (2280 in chips) 
Seat 2: 75anatoliy (1720 in chips) 
Seat 3: osiolfish (1500 in chips) 
Seat 4: carlaocosta (1310 in chips) 
Seat 5: dfcastro.net (1470 in chips) 
Seat 7: 2bgd1 (990 in chips) 
Seat 8: andedik (1300 in chips) 
Seat 9: skandal76 (1470 in chips) 
carlaocosta: posts small blind 15
dfcastro.net: posts big blind 30
*** HOLE CARDS ***
Dealt to dfcastro.net [8d 6s]
2bgd1: calls 30
andedik: folds 
skandal76: folds 
Krpnsk: folds 
75anatoliy: calls 30
osiolfish: folds 
carlaocosta: calls 15
dfcastro.net: checks 
*** FLOP *** [5h Jh 9d]
carlaocosta: checks 
dfcastro.net: checks 
2bgd1: checks 
75anatoliy: checks 
*** TURN *** [5h Jh 9d] [7s]
carlaocosta: checks 
dfcastro.net: checks 
2bgd1: checks 
75anatoliy: checks 
*** RIVER *** [5h Jh 9d 7s] [3c]
carlaocosta: checks 
dfcastro.net: bets 240
2bgd1: folds 
75anatoliy: folds 
carlaocosta: folds 
Uncalled bet (240) returned to dfcastro.net
dfcastro.net collected 120 from pot
*** SUMMARY ***
Total pot 120 | Rake 0 
Board [5h Jh 9d 7s 3c]
Seat 1: Krpnsk folded before Flop (didn't bet)
Seat 2: 75anatoliy folded on the River
Seat 3: osiolfish (button) folded before Flop (didn't bet)
Seat 4: carlaocosta (small blind) folded on the River
Seat 5: dfcastro.net (big blind) collected (120)
Seat 7: 2bgd1 folded on the River
Seat 8: andedik folded before Flop (didn't bet)
Seat 9: skandal76 folded before Flop (didn't bet)



PokerStars Hand #97775981646: Tournament #725058424, $0.23+$0.02 USD Hold'em No Limit - Level II (15/30) - 2013/04/27 15:52:21 BRT [2013/04/27 14:52:21 ET]
Table '725058424 1' 9-max Seat #4 is the button
Seat 1: Krpnsk (2280 in chips) 
Seat 2: 75anatoliy (1690 in chips) 
Seat 3: osiolfish (1500 in chips) 
Seat 4: carlaocosta (1280 in chips) 
Seat 5: dfcastro.net (1560 in chips) 
Seat 7: 2bgd1 (960 in chips) 
Seat 8: andedik (1300 in chips) 
Seat 9: skandal76 (1470 in chips) 
dfcastro.net: posts small blind 15
2bgd1: posts big blind 30
*** HOLE CARDS ***
Dealt to dfcastro.net [Tc Qc]
andedik: folds 
skandal76: folds 
Krpnsk: folds 
75anatoliy: raises 30 to 60
osiolfish: folds 
carlaocosta: folds 
dfcastro.net: folds 
2bgd1: calls 30
*** FLOP *** [Jd Ks Td]
2bgd1: checks 
75anatoliy: checks 
*** TURN *** [Jd Ks Td] [2s]
2bgd1: bets 60
75anatoliy: calls 60
*** RIVER *** [Jd Ks Td 2s] [Ac]
2bgd1: bets 120
75anatoliy: calls 120
*** SHOW DOWN ***
2bgd1: shows [2h Ts] (two pair, Tens and Deuces)
75anatoliy: mucks hand 
2bgd1 collected 495 from pot
*** SUMMARY ***
Total pot 495 | Rake 0 
Board [Jd Ks Td 2s Ac]
Seat 1: Krpnsk folded before Flop (didn't bet)
Seat 2: 75anatoliy mucked [8d 8h]
Seat 3: osiolfish folded before Flop (didn't bet)
Seat 4: carlaocosta (button) folded before Flop (didn't bet)
Seat 5: dfcastro.net (small blind) folded before Flop
Seat 7: 2bgd1 (big blind) showed [2h Ts] and won (495) with two pair, Tens and Deuces
Seat 8: andedik folded before Flop (didn't bet)
Seat 9: skandal76 folded before Flop (didn't bet)



PokerStars Hand #97776032910: Tournament #725058424, $0.23+$0.02 USD Hold'em No Limit - Level II (15/30) - 2013/04/27 15:53:21 BRT [2013/04/27 14:53:21 ET]
Table '725058424 1' 9-max Seat #5 is the button
Seat 1: Krpnsk (2280 in chips) 
Seat 2: 75anatoliy (1450 in chips) 
Seat 3: osiolfish (1500 in chips) 
Seat 4: carlaocosta (1280 in chips) 
Seat 5: dfcastro.net (1545 in chips) 
Seat 7: 2bgd1 (1215 in chips) 
Seat 8: andedik (1300 in chips) 
Seat 9: skandal76 (1470 in chips) 
2bgd1: posts small blind 15
andedik: posts big blind 30
*** HOLE CARDS ***
Dealt to dfcastro.net [Qs 7c]
skandal76: folds 
Krpnsk: folds 
75anatoliy: folds 
osiolfish: folds 
carlaocosta: raises 60 to 90
dfcastro.net: folds 
2bgd1: folds 
andedik: calls 60
*** FLOP *** [6s 3s 5h]
andedik: checks 
carlaocosta: bets 90
andedik: folds 
Uncalled bet (90) returned to carlaocosta
carlaocosta collected 195 from pot
*** SUMMARY ***
Total pot 195 | Rake 0 
Board [6s 3s 5h]
Seat 1: Krpnsk folded before Flop (didn't bet)
Seat 2: 75anatoliy folded before Flop (didn't bet)
Seat 3: osiolfish folded before Flop (didn't bet)
Seat 4: carlaocosta collected (195)
Seat 5: dfcastro.net (button) folded before Flop (didn't bet)
Seat 7: 2bgd1 (small blind) folded before Flop
Seat 8: andedik (big blind) folded on the Flop
Seat 9: skandal76 folded before Flop (didn't bet)



PokerStars Hand #97776087700: Tournament #725058424, $0.23+$0.02 USD Hold'em No Limit - Level II (15/30) - 2013/04/27 15:54:25 BRT [2013/04/27 14:54:25 ET]
Table '725058424 1' 9-max Seat #7 is the button
Seat 1: Krpnsk (2280 in chips) 
Seat 2: 75anatoliy (1450 in chips) 
Seat 3: osiolfish (1500 in chips) 
Seat 4: carlaocosta (1385 in chips) 
Seat 5: dfcastro.net (1545 in chips) 
Seat 6: ista6 (1530 in chips) 
Seat 7: 2bgd1 (1200 in chips) 
Seat 8: andedik (1210 in chips) 
Seat 9: skandal76 (1470 in chips) 
andedik: posts small blind 15
skandal76: posts big blind 30
*** HOLE CARDS ***
Dealt to dfcastro.net [2h 6h]
Krpnsk: folds 
75anatoliy: calls 30
osiolfish has timed out while being disconnected
osiolfish: folds 
osiolfish is sitting out
osiolfish is disconnected 
carlaocosta: folds 
dfcastro.net: folds 
ista6: folds 
2bgd1: calls 30
andedik: calls 15
skandal76: checks 
*** FLOP *** [8h 4h Th]
andedik: checks 
skandal76: bets 60
75anatoliy: calls 60
2bgd1: calls 60
andedik: folds 
*** TURN *** [8h 4h Th] [5h]
skandal76: bets 150
75anatoliy: folds 
2bgd1: folds 
Uncalled bet (150) returned to skandal76
skandal76 collected 300 from pot
skandal76: doesn't show hand 
*** SUMMARY ***
Total pot 300 | Rake 0 
Board [8h 4h Th 5h]
Seat 1: Krpnsk folded before Flop (didn't bet)
Seat 2: 75anatoliy folded on the Turn
Seat 3: osiolfish folded before Flop (didn't bet)
Seat 4: carlaocosta folded before Flop (didn't bet)
Seat 5: dfcastro.net folded before Flop (didn't bet)
Seat 6: ista6 folded before Flop (didn't bet)
Seat 7: 2bgd1 (button) folded on the Turn
Seat 8: andedik (small blind) folded on the Flop
Seat 9: skandal76 (big blind) collected (300)



PokerStars Hand #97776322626: Tournament #725058424, $0.23+$0.02 USD Hold'em No Limit - Level II (15/30) - 2013/04/27 16:00:43 BRT [2013/04/27 15:00:43 ET]
Table '725058424 1' 9-max Seat #8 is the button
Seat 1: Krpnsk (2280 in chips) 
Seat 2: 75anatoliy (1360 in chips) 
Seat 3: osiolfish (1500 in chips) is sitting out
Seat 4: carlaocosta (1385 in chips) 
Seat 5: dfcastro.net (1545 in chips) 
Seat 6: ista6 (1530 in chips) 
Seat 7: 2bgd1 (1110 in chips) 
Seat 8: andedik (1180 in chips) 
Seat 9: skandal76 (1680 in chips) 
skandal76: posts small blind 15
Krpnsk: posts big blind 30
*** HOLE CARDS ***
Dealt to dfcastro.net [Td 6d]
osiolfish has returned
75anatoliy has timed out
75anatoliy: folds 
75anatoliy is sitting out
osiolfish: folds 
carlaocosta: raises 60 to 90
dfcastro.net: folds 
ista6: folds 
2bgd1: folds 
andedik: folds 
75anatoliy has returned
skandal76: folds 
Krpnsk: folds 
Uncalled bet (60) returned to carlaocosta
carlaocosta collected 75 from pot
*** SUMMARY ***
Total pot 75 | Rake 0 
Seat 1: Krpnsk (big blind) folded before Flop
Seat 2: 75anatoliy folded before Flop (didn't bet)
Seat 3: osiolfish folded before Flop (didn't bet)
Seat 4: carlaocosta collected (75)
Seat 5: dfcastro.net folded before Flop (didn't bet)
Seat 6: ista6 folded before Flop (didn't bet)
Seat 7: 2bgd1 folded before Flop (didn't bet)
Seat 8: andedik (button) folded before Flop (didn't bet)
Seat 9: skandal76 (small blind) folded before Flop



PokerStars Hand #97776437220: Tournament #725058424, $0.23+$0.02 USD Hold'em No Limit - Level II (15/30) - 2013/04/27 16:02:59 BRT [2013/04/27 15:02:59 ET]
Table '725058424 1' 9-max Seat #9 is the button
Seat 1: Krpnsk (2250 in chips) 
Seat 2: 75anatoliy (1360 in chips) 
Seat 3: osiolfish (1500 in chips) 
Seat 5: dfcastro.net (1545 in chips) 
Seat 6: ista6 (1530 in chips) 
Seat 7: 2bgd1 (1110 in chips) 
Seat 8: andedik (1180 in chips) 
Seat 9: skandal76 (1665 in chips) 
Krpnsk: posts small blind 15
75anatoliy: posts big blind 30
*** HOLE CARDS ***
Dealt to dfcastro.net [Ad 8h]
osiolfish: folds 
dfcastro.net: folds 
ista6: raises 30 to 60
2bgd1: calls 60
andedik: folds 
skandal76: folds 
Krpnsk: raises 60 to 120
75anatoliy: folds 
ista6: calls 60
2bgd1: calls 60
*** FLOP *** [Qc Tc 7h]
Krpnsk: bets 180
ista6: folds 
2bgd1: raises 810 to 990 and is all-in
Krpnsk: folds 
Uncalled bet (810) returned to 2bgd1
2bgd1 collected 750 from pot
2bgd1: doesn't show hand 
*** SUMMARY ***
Total pot 750 | Rake 0 
Board [Qc Tc 7h]
Seat 1: Krpnsk (small blind) folded on the Flop
Seat 2: 75anatoliy (big blind) folded before Flop
Seat 3: osiolfish folded before Flop (didn't bet)
Seat 5: dfcastro.net folded before Flop (didn't bet)
Seat 6: ista6 folded on the Flop
Seat 7: 2bgd1 collected (750)
Seat 8: andedik folded before Flop (didn't bet)
Seat 9: skandal76 (button) folded before Flop (didn't bet)



PokerStars Hand #97776525396: Tournament #725058424, $0.23+$0.02 USD Hold'em No Limit - Level II (15/30) - 2013/04/27 16:04:34 BRT [2013/04/27 15:04:34 ET]
Table '725058424 1' 9-max Seat #1 is the button
Seat 1: Krpnsk (1950 in chips) 
Seat 2: 75anatoliy (1330 in chips) 
Seat 3: osiolfish (1500 in chips) 
Seat 5: dfcastro.net (1545 in chips) 
Seat 6: ista6 (1410 in chips) 
Seat 7: 2bgd1 (1560 in chips) 
Seat 8: andedik (1180 in chips) 
Seat 9: skandal76 (1665 in chips) 
75anatoliy: posts small blind 15
osiolfish: posts big blind 30
*** HOLE CARDS ***
Dealt to dfcastro.net [9s 8d]
dfcastro.net: folds 
ista6: folds 
2bgd1: calls 30
andedik: folds 
skandal76: folds 
Krpnsk: folds 
75anatoliy: calls 15
osiolfish: checks 
*** FLOP *** [8h 6s 9c]
75anatoliy: checks 
osiolfish: checks 
2bgd1: bets 60
75anatoliy: folds 
osiolfish: calls 60
*** TURN *** [8h 6s 9c] [9d]
osiolfish: checks 
2bgd1: bets 60
osiolfish: calls 60
*** RIVER *** [8h 6s 9c 9d] [5h]
osiolfish: checks 
2bgd1: bets 60
osiolfish: calls 60
*** SHOW DOWN ***
2bgd1: shows [8s Ks] (two pair, Nines and Eights)
osiolfish: mucks hand 
2bgd1 collected 450 from pot
*** SUMMARY ***
Total pot 450 | Rake 0 
Board [8h 6s 9c 9d 5h]
Seat 1: Krpnsk (button) folded before Flop (didn't bet)
Seat 2: 75anatoliy (small blind) folded on the Flop
Seat 3: osiolfish (big blind) mucked [Qd 5s]
Seat 5: dfcastro.net folded before Flop (didn't bet)
Seat 6: ista6 folded before Flop (didn't bet)
Seat 7: 2bgd1 showed [8s Ks] and won (450) with two pair, Nines and Eights
Seat 8: andedik folded before Flop (didn't bet)
Seat 9: skandal76 folded before Flop (didn't bet)



PokerStars Hand #97776602613: Tournament #725058424, $0.23+$0.02 USD Hold'em No Limit - Level III (25/50) - 2013/04/27 16:05:56 BRT [2013/04/27 15:05:56 ET]
Table '725058424 1' 9-max Seat #2 is the button
Seat 1: Krpnsk (1950 in chips) 
Seat 2: 75anatoliy (1300 in chips) 
Seat 3: osiolfish (1290 in chips) 
Seat 5: dfcastro.net (1545 in chips) 
Seat 6: ista6 (1410 in chips) 
Seat 7: 2bgd1 (1800 in chips) 
Seat 8: andedik (1180 in chips) 
Seat 9: skandal76 (1665 in chips) 
osiolfish: posts small blind 25
dfcastro.net: posts big blind 50
*** HOLE CARDS ***
Dealt to dfcastro.net [3d Qd]
ista6: folds 
2bgd1: calls 50
andedik: folds 
skandal76: folds 
Krpnsk: folds 
75anatoliy: folds 
osiolfish: calls 25
dfcastro.net: checks 
*** FLOP *** [Ks 5d 8d]
osiolfish: checks 
dfcastro.net: checks 
2bgd1: checks 
*** TURN *** [Ks 5d 8d] [As]
osiolfish: checks 
dfcastro.net: checks 
2bgd1: bets 50
osiolfish: folds 
dfcastro.net: folds 
Uncalled bet (50) returned to 2bgd1
2bgd1 collected 150 from pot
2bgd1: doesn't show hand 
*** SUMMARY ***
Total pot 150 | Rake 0 
Board [Ks 5d 8d As]
Seat 1: Krpnsk folded before Flop (didn't bet)
Seat 2: 75anatoliy (button) folded before Flop (didn't bet)
Seat 3: osiolfish (small blind) folded on the Turn
Seat 5: dfcastro.net (big blind) folded on the Turn
Seat 6: ista6 folded before Flop (didn't bet)
Seat 7: 2bgd1 collected (150)
Seat 8: andedik folded before Flop (didn't bet)
Seat 9: skandal76 folded before Flop (didn't bet)



PokerStars Hand #97776674787: Tournament #725058424, $0.23+$0.02 USD Hold'em No Limit - Level III (25/50) - 2013/04/27 16:07:12 BRT [2013/04/27 15:07:12 ET]
Table '725058424 1' 9-max Seat #3 is the button
Seat 1: Krpnsk (1950 in chips) 
Seat 2: 75anatoliy (1300 in chips) 
Seat 3: osiolfish (1240 in chips) 
Seat 5: dfcastro.net (1495 in chips) 
Seat 6: ista6 (1410 in chips) 
Seat 7: 2bgd1 (1900 in chips) 
Seat 8: andedik (1180 in chips) 
Seat 9: skandal76 (1665 in chips) 
dfcastro.net: posts small blind 25
ista6: posts big blind 50
*** HOLE CARDS ***
Dealt to dfcastro.net [Th 3d]
2bgd1: raises 50 to 100
andedik: folds 
skandal76: folds 
Krpnsk: calls 100
75anatoliy: folds 
osiolfish has timed out while being disconnected
osiolfish: folds 
osiolfish is sitting out
dfcastro.net: folds 
osiolfish has returned
ista6: folds 
*** FLOP *** [Qs Kd 7d]
2bgd1: bets 100
Krpnsk: raises 200 to 300
2bgd1: calls 200
*** TURN *** [Qs Kd 7d] [5c]
2bgd1: checks 
Krpnsk: bets 450
2bgd1: folds 
Uncalled bet (450) returned to Krpnsk
Krpnsk collected 875 from pot
*** SUMMARY ***
Total pot 875 | Rake 0 
Board [Qs Kd 7d 5c]
Seat 1: Krpnsk collected (875)
Seat 2: 75anatoliy folded before Flop (didn't bet)
Seat 3: osiolfish (button) folded before Flop (didn't bet)
Seat 5: dfcastro.net (small blind) folded before Flop
Seat 6: ista6 (big blind) folded before Flop
Seat 7: 2bgd1 folded on the Turn
Seat 8: andedik folded before Flop (didn't bet)
Seat 9: skandal76 folded before Flop (didn't bet)



PokerStars Hand #97776757312: Tournament #725058424, $0.23+$0.02 USD Hold'em No Limit - Level III (25/50) - 2013/04/27 16:08:40 BRT [2013/04/27 15:08:40 ET]
Table '725058424 1' 9-max Seat #5 is the button
Seat 1: Krpnsk (2425 in chips) 
Seat 2: 75anatoliy (1300 in chips) 
Seat 3: osiolfish (1240 in chips) 
Seat 5: dfcastro.net (1470 in chips) 
Seat 6: ista6 (1360 in chips) 
Seat 7: 2bgd1 (1500 in chips) 
Seat 8: andedik (1180 in chips) 
Seat 9: skandal76 (1665 in chips) 
ista6: posts small blind 25
2bgd1: posts big blind 50
*** HOLE CARDS ***
Dealt to dfcastro.net [Qh 6c]
andedik: folds 
skandal76: folds 
Krpnsk: raises 50 to 100
75anatoliy: raises 1200 to 1300 and is all-in
osiolfish: folds 
dfcastro.net: folds 
ista6: folds 
2bgd1: folds 
Krpnsk: folds 
Uncalled bet (1200) returned to 75anatoliy
75anatoliy collected 275 from pot
*** SUMMARY ***
Total pot 275 | Rake 0 
Seat 1: Krpnsk folded before Flop
Seat 2: 75anatoliy collected (275)
Seat 3: osiolfish folded before Flop (didn't bet)
Seat 5: dfcastro.net (button) folded before Flop (didn't bet)
Seat 6: ista6 (small blind) folded before Flop
Seat 7: 2bgd1 (big blind) folded before Flop
Seat 8: andedik folded before Flop (didn't bet)
Seat 9: skandal76 folded before Flop (didn't bet)



PokerStars Hand #97776800714: Tournament #725058424, $0.23+$0.02 USD Hold'em No Limit - Level III (25/50) - 2013/04/27 16:09:26 BRT [2013/04/27 15:09:26 ET]
Table '725058424 1' 9-max Seat #6 is the button
Seat 2: 75anatoliy (1475 in chips) 
Seat 3: osiolfish (1240 in chips) 
Seat 5: dfcastro.net (1470 in chips) 
Seat 6: ista6 (1335 in chips) 
Seat 7: 2bgd1 (1450 in chips) 
Seat 8: andedik (1180 in chips) 
Seat 9: skandal76 (1665 in chips) 
2bgd1: posts small blind 25
andedik: posts big blind 50
*** HOLE CARDS ***
Dealt to dfcastro.net [Kd Qc]
skandal76: folds 
75anatoliy: folds 
osiolfish: folds 
dfcastro.net: raises 60 to 110
ista6: folds 
2bgd1: calls 85
andedik: calls 60
*** FLOP *** [6s 6c 2d]
2bgd1: checks 
andedik: checks 
dfcastro.net: bets 160
2bgd1: folds 
andedik: folds 
Uncalled bet (160) returned to dfcastro.net
dfcastro.net collected 330 from pot
*** SUMMARY ***
Total pot 330 | Rake 0 
Board [6s 6c 2d]
Seat 2: 75anatoliy folded before Flop (didn't bet)
Seat 3: osiolfish folded before Flop (didn't bet)
Seat 5: dfcastro.net collected (330)
Seat 6: ista6 (button) folded before Flop (didn't bet)
Seat 7: 2bgd1 (small blind) folded on the Flop
Seat 8: andedik (big blind) folded on the Flop
Seat 9: skandal76 folded before Flop (didn't bet)



PokerStars Hand #97776849443: Tournament #725058424, $0.23+$0.02 USD Hold'em No Limit - Level III (25/50) - 2013/04/27 16:10:18 BRT [2013/04/27 15:10:18 ET]
Table '725058424 1' 9-max Seat #7 is the button
Seat 2: 75anatoliy (1475 in chips) 
Seat 3: osiolfish (1240 in chips) 
Seat 5: dfcastro.net (1690 in chips) 
Seat 6: ista6 (1335 in chips) 
Seat 7: 2bgd1 (1340 in chips) 
Seat 8: andedik (1070 in chips) 
Seat 9: skandal76 (1665 in chips) 
andedik: posts small blind 25
skandal76: posts big blind 50
*** HOLE CARDS ***
Dealt to dfcastro.net [2c 9d]
75anatoliy: calls 50
osiolfish: folds 
dfcastro.net: folds 
ista6: folds 
2bgd1: folds 
andedik: folds 
skandal76: checks 
*** FLOP *** [6c 2s Ac]
skandal76: checks 
75anatoliy: checks 
*** TURN *** [6c 2s Ac] [As]
skandal76: checks 
75anatoliy: checks 
*** RIVER *** [6c 2s Ac As] [Qh]
skandal76: checks 
75anatoliy: bets 100
skandal76: folds 
Uncalled bet (100) returned to 75anatoliy
75anatoliy collected 125 from pot
*** SUMMARY ***
Total pot 125 | Rake 0 
Board [6c 2s Ac As Qh]
Seat 2: 75anatoliy collected (125)
Seat 3: osiolfish folded before Flop (didn't bet)
Seat 5: dfcastro.net folded before Flop (didn't bet)
Seat 6: ista6 folded before Flop (didn't bet)
Seat 7: 2bgd1 (button) folded before Flop (didn't bet)
Seat 8: andedik (small blind) folded before Flop
Seat 9: skandal76 (big blind) folded on the River



PokerStars Hand #97776882685: Tournament #725058424, $0.23+$0.02 USD Hold'em No Limit - Level III (25/50) - 2013/04/27 16:10:53 BRT [2013/04/27 15:10:53 ET]
Table '725058424 1' 9-max Seat #8 is the button
Seat 2: 75anatoliy (1550 in chips) 
Seat 3: osiolfish (1240 in chips) 
Seat 5: dfcastro.net (1690 in chips) 
Seat 6: ista6 (1335 in chips) 
Seat 7: 2bgd1 (1340 in chips) 
Seat 8: andedik (1045 in chips) 
Seat 9: skandal76 (1615 in chips) 
skandal76: posts small blind 25
75anatoliy: posts big blind 50
*** HOLE CARDS ***
Dealt to dfcastro.net [2d Jd]
osiolfish: folds 
dfcastro.net: folds 
ista6: folds 
2bgd1: calls 50
andedik: folds 
skandal76: folds 
75anatoliy: checks 
*** FLOP *** [8c 9c Th]
75anatoliy: checks 
2bgd1: bets 100
75anatoliy: folds 
Uncalled bet (100) returned to 2bgd1
2bgd1 collected 125 from pot
2bgd1: doesn't show hand 
*** SUMMARY ***
Total pot 125 | Rake 0 
Board [8c 9c Th]
Seat 2: 75anatoliy (big blind) folded on the Flop
Seat 3: osiolfish folded before Flop (didn't bet)
Seat 5: dfcastro.net folded before Flop (didn't bet)
Seat 6: ista6 folded before Flop (didn't bet)
Seat 7: 2bgd1 collected (125)
Seat 8: andedik (button) folded before Flop (didn't bet)
Seat 9: skandal76 (small blind) folded before Flop



PokerStars Hand #97776922112: Tournament #725058424, $0.23+$0.02 USD Hold'em No Limit - Level III (25/50) - 2013/04/27 16:11:35 BRT [2013/04/27 15:11:35 ET]
Table '725058424 1' 9-max Seat #9 is the button
Seat 2: 75anatoliy (1500 in chips) 
Seat 3: osiolfish (1240 in chips) 
Seat 5: dfcastro.net (1690 in chips) 
Seat 6: ista6 (1335 in chips) 
Seat 7: 2bgd1 (1415 in chips) 
Seat 8: andedik (1045 in chips) 
Seat 9: skandal76 (1590 in chips) 
75anatoliy: posts small blind 25
osiolfish: posts big blind 50
*** HOLE CARDS ***
Dealt to dfcastro.net [As 2h]
dfcastro.net: folds 
ista6: folds 
2bgd1: calls 50
andedik: folds 
skandal76: folds 
75anatoliy: calls 25
osiolfish: checks 
*** FLOP *** [Js 4h Kd]
75anatoliy: checks 
osiolfish: checks 
2bgd1: checks 
*** TURN *** [Js 4h Kd] [7h]
75anatoliy: checks 
osiolfish: checks 
2bgd1: checks 
*** RIVER *** [Js 4h Kd 7h] [9c]
75anatoliy: checks 
osiolfish: checks 
2bgd1: bets 50
75anatoliy: folds 
osiolfish: calls 50
*** SHOW DOWN ***
2bgd1: shows [9s Qc] (a pair of Nines)
osiolfish: mucks hand 
2bgd1 collected 250 from pot
*** SUMMARY ***
Total pot 250 | Rake 0 
Board [Js 4h Kd 7h 9c]
Seat 2: 75anatoliy (small blind) folded on the River
Seat 3: osiolfish (big blind) mucked [Ts 9d]
Seat 5: dfcastro.net folded before Flop (didn't bet)
Seat 6: ista6 folded before Flop (didn't bet)
Seat 7: 2bgd1 showed [9s Qc] and won (250) with a pair of Nines
Seat 8: andedik folded before Flop (didn't bet)
Seat 9: skandal76 (button) folded before Flop (didn't bet)



PokerStars Hand #97776977061: Tournament #725058424, $0.23+$0.02 USD Hold'em No Limit - Level III (25/50) - 2013/04/27 16:12:34 BRT [2013/04/27 15:12:34 ET]
Table '725058424 1' 9-max Seat #2 is the button
Seat 2: 75anatoliy (1450 in chips) 
Seat 3: osiolfish (1140 in chips) 
Seat 5: dfcastro.net (1690 in chips) 
Seat 6: ista6 (1335 in chips) 
Seat 7: 2bgd1 (1565 in chips) 
Seat 8: andedik (1045 in chips) 
Seat 9: skandal76 (1590 in chips) 
osiolfish: posts small blind 25
dfcastro.net: posts big blind 50
*** HOLE CARDS ***
Dealt to dfcastro.net [9s 2h]
ista6: folds 
2bgd1: calls 50
andedik: folds 
skandal76: folds 
75anatoliy: folds 
osiolfish: raises 100 to 150
dfcastro.net: folds 
2bgd1: calls 100
*** FLOP *** [Td 6h 2c]
osiolfish: bets 200
2bgd1: calls 200
*** TURN *** [Td 6h 2c] [Kh]
osiolfish: bets 450
2bgd1: folds 
Uncalled bet (450) returned to osiolfish
osiolfish collected 750 from pot
osiolfish: doesn't show hand 
*** SUMMARY ***
Total pot 750 | Rake 0 
Board [Td 6h 2c Kh]
Seat 2: 75anatoliy (button) folded before Flop (didn't bet)
Seat 3: osiolfish (small blind) collected (750)
Seat 5: dfcastro.net (big blind) folded before Flop
Seat 6: ista6 folded before Flop (didn't bet)
Seat 7: 2bgd1 folded on the Turn
Seat 8: andedik folded before Flop (didn't bet)
Seat 9: skandal76 folded before Flop (didn't bet)



PokerStars Hand #97777042798: Tournament #725058424, $0.23+$0.02 USD Hold'em No Limit - Level III (25/50) - 2013/04/27 16:13:44 BRT [2013/04/27 15:13:44 ET]
Table '725058424 1' 9-max Seat #3 is the button
Seat 1: Zeus6669 (1385 in chips) 
Seat 2: 75anatoliy (1450 in chips) 
Seat 3: osiolfish (1540 in chips) 
Seat 4: eliasfleitas (1900 in chips) out of hand (moved from another table into small blind)
Seat 5: dfcastro.net (1640 in chips) 
Seat 6: ista6 (1335 in chips) 
Seat 7: 2bgd1 (1215 in chips) 
Seat 8: andedik (1045 in chips) 
Seat 9: skandal76 (1590 in chips) 
dfcastro.net: posts small blind 25
ista6: posts big blind 50
*** HOLE CARDS ***
Dealt to dfcastro.net [8s 2c]
2bgd1: folds 
andedik: folds 
skandal76: folds 
Zeus6669: folds 
75anatoliy: folds 
osiolfish: folds 
dfcastro.net: folds 
Uncalled bet (25) returned to ista6
ista6 collected 50 from pot
*** SUMMARY ***
Total pot 50 | Rake 0 
Seat 1: Zeus6669 folded before Flop (didn't bet)
Seat 2: 75anatoliy folded before Flop (didn't bet)
Seat 3: osiolfish (button) folded before Flop (didn't bet)
Seat 5: dfcastro.net (small blind) folded before Flop
Seat 6: ista6 (big blind) collected (50)
Seat 7: 2bgd1 folded before Flop (didn't bet)
Seat 8: andedik folded before Flop (didn't bet)
Seat 9: skandal76 folded before Flop (didn't bet)



PokerStars Hand #97777065744: Tournament #725058424, $0.23+$0.02 USD Hold'em No Limit - Level III (25/50) - 2013/04/27 16:14:08 BRT [2013/04/27 15:14:08 ET]
Table '725058424 1' 9-max Seat #5 is the button
Seat 1: Zeus6669 (1385 in chips) 
Seat 2: 75anatoliy (1450 in chips) 
Seat 3: osiolfish (1540 in chips) 
Seat 4: eliasfleitas (1900 in chips) 
Seat 5: dfcastro.net (1615 in chips) 
Seat 6: ista6 (1360 in chips) 
Seat 7: 2bgd1 (1215 in chips) 
Seat 8: andedik (1045 in chips) 
Seat 9: skandal76 (1590 in chips) 
ista6: posts small blind 25
2bgd1: posts big blind 50
*** HOLE CARDS ***
Dealt to dfcastro.net [7c Js]
andedik: folds 
skandal76: folds 
Zeus6669: folds 
75anatoliy: raises 1400 to 1450 and is all-in
osiolfish: folds 
eliasfleitas: folds 
dfcastro.net: folds 
ista6: folds 
2bgd1: calls 1165 and is all-in
Uncalled bet (235) returned to 75anatoliy
*** FLOP *** [3d 2h Jc]
*** TURN *** [3d 2h Jc] [8d]
*** RIVER *** [3d 2h Jc 8d] [2c]
*** SHOW DOWN ***
2bgd1: shows [Qh Jd] (two pair, Jacks and Deuces)
75anatoliy: shows [Qd Qs] (two pair, Queens and Deuces)
75anatoliy collected 2455 from pot
2bgd1 finished the tournament in 26th place
*** SUMMARY ***
Total pot 2455 | Rake 0 
Board [3d 2h Jc 8d 2c]
Seat 1: Zeus6669 folded before Flop (didn't bet)
Seat 2: 75anatoliy showed [Qd Qs] and won (2455) with two pair, Queens and Deuces
Seat 3: osiolfish folded before Flop (didn't bet)
Seat 4: eliasfleitas folded before Flop (didn't bet)
Seat 5: dfcastro.net (button) folded before Flop (didn't bet)
Seat 6: ista6 (small blind) folded before Flop
Seat 7: 2bgd1 (big blind) showed [Qh Jd] and lost with two pair, Jacks and Deuces
Seat 8: andedik folded before Flop (didn't bet)
Seat 9: skandal76 folded before Flop (didn't bet)



PokerStars Hand #97777099198: Tournament #725058424, $0.23+$0.02 USD Hold'em No Limit - Level III (25/50) - 2013/04/27 16:14:44 BRT [2013/04/27 15:14:44 ET]
Table '725058424 1' 9-max Seat #6 is the button
Seat 1: Zeus6669 (1385 in chips) 
Seat 2: 75anatoliy (2690 in chips) 
Seat 3: osiolfish (1540 in chips) 
Seat 4: eliasfleitas (1900 in chips) 
Seat 5: dfcastro.net (1615 in chips) 
Seat 6: ista6 (1335 in chips) 
Seat 8: andedik (1045 in chips) 
Seat 9: skandal76 (1590 in chips) 
andedik: posts small blind 25
skandal76: posts big blind 50
*** HOLE CARDS ***
Dealt to dfcastro.net [8d 7h]
Zeus6669: folds 
75anatoliy: folds 
osiolfish has timed out while being disconnected
osiolfish: folds 
osiolfish is sitting out
eliasfleitas: folds 
dfcastro.net: folds 
ista6: raises 67 to 117
andedik: folds 
osiolfish is disconnected 
skandal76: folds 
Uncalled bet (67) returned to ista6
ista6 collected 125 from pot
*** SUMMARY ***
Total pot 125 | Rake 0 
Seat 1: Zeus6669 folded before Flop (didn't bet)
Seat 2: 75anatoliy folded before Flop (didn't bet)
Seat 3: osiolfish folded before Flop (didn't bet)
Seat 4: eliasfleitas folded before Flop (didn't bet)
Seat 5: dfcastro.net folded before Flop (didn't bet)
Seat 6: ista6 (button) collected (125)
Seat 8: andedik (small blind) folded before Flop
Seat 9: skandal76 (big blind) folded before Flop



PokerStars Hand #97777138881: Tournament #725058424, $0.23+$0.02 USD Hold'em No Limit - Level IV (50/100) - 2013/04/27 16:15:26 BRT [2013/04/27 15:15:26 ET]
Table '725058424 1' 9-max Seat #8 is the button
Seat 1: Zeus6669 (1385 in chips) 
Seat 2: 75anatoliy (2690 in chips) 
Seat 3: osiolfish (1540 in chips) is sitting out
Seat 4: eliasfleitas (1900 in chips) 
Seat 5: dfcastro.net (1615 in chips) 
Seat 6: ista6 (1410 in chips) 
Seat 8: andedik (1020 in chips) 
Seat 9: skandal76 (1540 in chips) 
skandal76: posts small blind 50
Zeus6669: posts big blind 100
*** HOLE CARDS ***
Dealt to dfcastro.net [Kc Qc]
75anatoliy: folds 
osiolfish: folds 
eliasfleitas: folds 
dfcastro.net: folds 
ista6: folds 
andedik: raises 920 to 1020 and is all-in
skandal76: folds 
Zeus6669: folds 
Uncalled bet (920) returned to andedik
andedik collected 250 from pot
andedik: doesn't show hand 
*** SUMMARY ***
Total pot 250 | Rake 0 
Seat 1: Zeus6669 (big blind) folded before Flop
Seat 2: 75anatoliy folded before Flop (didn't bet)
Seat 3: osiolfish folded before Flop (didn't bet)
Seat 4: eliasfleitas folded before Flop (didn't bet)
Seat 5: dfcastro.net folded before Flop (didn't bet)
Seat 6: ista6 folded before Flop (didn't bet)
Seat 8: andedik (button) collected (250)
Seat 9: skandal76 (small blind) folded before Flop



PokerStars Hand #97777163304: Tournament #725058424, $0.23+$0.02 USD Hold'em No Limit - Level IV (50/100) - 2013/04/27 16:15:52 BRT [2013/04/27 15:15:52 ET]
Table '725058424 1' 9-max Seat #9 is the button
Seat 1: Zeus6669 (1285 in chips) 
Seat 2: 75anatoliy (2690 in chips) 
Seat 3: osiolfish (1540 in chips) is sitting out
Seat 4: eliasfleitas (1900 in chips) 
Seat 5: dfcastro.net (1615 in chips) 
Seat 6: ista6 (1410 in chips) 
Seat 8: andedik (1170 in chips) 
Seat 9: skandal76 (1490 in chips) 
Zeus6669: posts small blind 50
75anatoliy: posts big blind 100
*** HOLE CARDS ***
Dealt to dfcastro.net [Qd Ah]
osiolfish: folds 
eliasfleitas: folds 
dfcastro.net: raises 120 to 220
ista6: folds 
andedik: folds 
skandal76: folds 
Zeus6669: folds 
75anatoliy: folds 
Uncalled bet (120) returned to dfcastro.net
dfcastro.net collected 250 from pot
dfcastro.net: doesn't show hand 
*** SUMMARY ***
Total pot 250 | Rake 0 
Seat 1: Zeus6669 (small blind) folded before Flop
Seat 2: 75anatoliy (big blind) folded before Flop
Seat 3: osiolfish folded before Flop (didn't bet)
Seat 4: eliasfleitas folded before Flop (didn't bet)
Seat 5: dfcastro.net collected (250)
Seat 6: ista6 folded before Flop (didn't bet)
Seat 8: andedik folded before Flop (didn't bet)
Seat 9: skandal76 (button) folded before Flop (didn't bet)



PokerStars Hand #97777188861: Tournament #725058424, $0.23+$0.02 USD Hold'em No Limit - Level IV (50/100) - 2013/04/27 16:16:20 BRT [2013/04/27 15:16:20 ET]
Table '725058424 1' 9-max Seat #1 is the button
Seat 1: Zeus6669 (1235 in chips) 
Seat 2: 75anatoliy (2590 in chips) 
Seat 3: osiolfish (1540 in chips) is sitting out
Seat 4: eliasfleitas (1900 in chips) 
Seat 5: dfcastro.net (1765 in chips) 
Seat 6: ista6 (1410 in chips) 
Seat 8: andedik (1170 in chips) 
Seat 9: skandal76 (1490 in chips) 
75anatoliy: posts small blind 50
osiolfish: posts big blind 100
*** HOLE CARDS ***
Dealt to dfcastro.net [8d 2c]
eliasfleitas: folds 
dfcastro.net: folds 
ista6: folds 
andedik: folds 
skandal76: folds 
Zeus6669: folds 
75anatoliy: calls 50
osiolfish: folds 
75anatoliy collected 200 from pot
*** SUMMARY ***
Total pot 200 | Rake 0 
Seat 1: Zeus6669 (button) folded before Flop (didn't bet)
Seat 2: 75anatoliy (small blind) collected (200)
Seat 3: osiolfish (big blind) folded before Flop
Seat 4: eliasfleitas folded before Flop (didn't bet)
Seat 5: dfcastro.net folded before Flop (didn't bet)
Seat 6: ista6 folded before Flop (didn't bet)
Seat 8: andedik folded before Flop (didn't bet)
Seat 9: skandal76 folded before Flop (didn't bet)



PokerStars Hand #97777205737: Tournament #725058424, $0.23+$0.02 USD Hold'em No Limit - Level IV (50/100) - 2013/04/27 16:16:38 BRT [2013/04/27 15:16:38 ET]
Table '725058424 1' 9-max Seat #2 is the button
Seat 1: Zeus6669 (1235 in chips) 
Seat 2: 75anatoliy (2690 in chips) 
Seat 4: eliasfleitas (1900 in chips) 
Seat 5: dfcastro.net (1765 in chips) 
Seat 6: ista6 (1410 in chips) 
Seat 8: andedik (1170 in chips) 
Seat 9: skandal76 (1490 in chips) 
eliasfleitas: posts small blind 50
dfcastro.net: posts big blind 100
*** HOLE CARDS ***
Dealt to dfcastro.net [5d Ks]
ista6: folds 
andedik: folds 
skandal76: folds 
Zeus6669: folds 
75anatoliy: folds 
eliasfleitas: folds 
Uncalled bet (50) returned to dfcastro.net
dfcastro.net collected 100 from pot
dfcastro.net: doesn't show hand 
*** SUMMARY ***
Total pot 100 | Rake 0 
Seat 1: Zeus6669 folded before Flop (didn't bet)
Seat 2: 75anatoliy (button) folded before Flop (didn't bet)
Seat 4: eliasfleitas (small blind) folded before Flop
Seat 5: dfcastro.net (big blind) collected (100)
Seat 6: ista6 folded before Flop (didn't bet)
Seat 8: andedik folded before Flop (didn't bet)
Seat 9: skandal76 folded before Flop (didn't bet)



PokerStars Hand #97777223063: Tournament #725058424, $0.23+$0.02 USD Hold'em No Limit - Level IV (50/100) - 2013/04/27 16:16:56 BRT [2013/04/27 15:16:56 ET]
Table '725058424 1' 9-max Seat #4 is the button
Seat 1: Zeus6669 (1235 in chips) 
Seat 2: 75anatoliy (2690 in chips) 
Seat 4: eliasfleitas (1850 in chips) 
Seat 5: dfcastro.net (1815 in chips) 
Seat 6: ista6 (1410 in chips) 
Seat 8: andedik (1170 in chips) 
Seat 9: skandal76 (1490 in chips) 
dfcastro.net: posts small blind 50
ista6: posts big blind 100
*** HOLE CARDS ***
Dealt to dfcastro.net [8s 4d]
andedik: folds 
skandal76: folds 
Zeus6669: folds 
75anatoliy: folds 
eliasfleitas: folds 
dfcastro.net: folds 
Uncalled bet (50) returned to ista6
ista6 collected 100 from pot
*** SUMMARY ***
Total pot 100 | Rake 0 
Seat 1: Zeus6669 folded before Flop (didn't bet)
Seat 2: 75anatoliy folded before Flop (didn't bet)
Seat 4: eliasfleitas (button) folded before Flop (didn't bet)
Seat 5: dfcastro.net (small blind) folded before Flop
Seat 6: ista6 (big blind) collected (100)
Seat 8: andedik folded before Flop (didn't bet)
Seat 9: skandal76 folded before Flop (didn't bet)



PokerStars Hand #97777240648: Tournament #725058424, $0.23+$0.02 USD Hold'em No Limit - Level IV (50/100) - 2013/04/27 16:17:15 BRT [2013/04/27 15:17:15 ET]
Table '725058424 1' 9-max Seat #5 is the button
Seat 1: Zeus6669 (1235 in chips) 
Seat 2: 75anatoliy (2690 in chips) 
Seat 4: eliasfleitas (1850 in chips) 
Seat 5: dfcastro.net (1765 in chips) 
Seat 6: ista6 (1460 in chips) 
Seat 8: andedik (1170 in chips) 
Seat 9: skandal76 (1490 in chips) 
ista6: posts small blind 50
andedik: posts big blind 100
*** HOLE CARDS ***
Dealt to dfcastro.net [3c Qh]
skandal76: folds 
Zeus6669: folds 
75anatoliy: folds 
eliasfleitas: folds 
dfcastro.net: folds 
ista6: folds 
Uncalled bet (50) returned to andedik
andedik collected 100 from pot
andedik: doesn't show hand 
*** SUMMARY ***
Total pot 100 | Rake 0 
Seat 1: Zeus6669 folded before Flop (didn't bet)
Seat 2: 75anatoliy folded before Flop (didn't bet)
Seat 4: eliasfleitas folded before Flop (didn't bet)
Seat 5: dfcastro.net (button) folded before Flop (didn't bet)
Seat 6: ista6 (small blind) folded before Flop
Seat 8: andedik (big blind) collected (100)
Seat 9: skandal76 folded before Flop (didn't bet)



PokerStars Hand #97777255078: Tournament #725058424, $0.23+$0.02 USD Hold'em No Limit - Level IV (50/100) - 2013/04/27 16:17:30 BRT [2013/04/27 15:17:30 ET]
Table '725058424 1' 9-max Seat #6 is the button
Seat 1: Zeus6669 (1235 in chips) 
Seat 2: 75anatoliy (2690 in chips) 
Seat 4: eliasfleitas (1850 in chips) 
Seat 5: dfcastro.net (1765 in chips) 
Seat 6: ista6 (1410 in chips) 
Seat 8: andedik (1220 in chips) 
Seat 9: skandal76 (1490 in chips) 
andedik: posts small blind 50
skandal76: posts big blind 100
*** HOLE CARDS ***
Dealt to dfcastro.net [4s Qh]
Zeus6669: folds 
75anatoliy: folds 
eliasfleitas: folds 
dfcastro.net: folds 
ista6: folds 
andedik: raises 1120 to 1220 and is all-in
skandal76: calls 1120
*** FLOP *** [5d 3h 3s]
*** TURN *** [5d 3h 3s] [Qc]
*** RIVER *** [5d 3h 3s Qc] [8h]
*** SHOW DOWN ***
andedik: shows [Js Jd] (two pair, Jacks and Threes)
skandal76: shows [7c 7d] (two pair, Sevens and Threes)
andedik collected 2440 from pot
*** SUMMARY ***
Total pot 2440 | Rake 0 
Board [5d 3h 3s Qc 8h]
Seat 1: Zeus6669 folded before Flop (didn't bet)
Seat 2: 75anatoliy folded before Flop (didn't bet)
Seat 4: eliasfleitas folded before Flop (didn't bet)
Seat 5: dfcastro.net folded before Flop (didn't bet)
Seat 6: ista6 (button) folded before Flop (didn't bet)
Seat 8: andedik (small blind) showed [Js Jd] and won (2440) with two pair, Jacks and Threes
Seat 9: skandal76 (big blind) showed [7c 7d] and lost with two pair, Sevens and Threes



PokerStars Hand #97777285236: Tournament #725058424, $0.23+$0.02 USD Hold'em No Limit - Level IV (50/100) - 2013/04/27 16:18:02 BRT [2013/04/27 15:18:02 ET]
Table '725058424 1' 9-max Seat #8 is the button
Seat 1: Zeus6669 (1235 in chips) 
Seat 2: 75anatoliy (2690 in chips) 
Seat 4: eliasfleitas (1850 in chips) 
Seat 5: dfcastro.net (1765 in chips) 
Seat 6: ista6 (1410 in chips) 
Seat 8: andedik (2440 in chips) 
Seat 9: skandal76 (270 in chips) 
skandal76: posts small blind 50
Zeus6669: posts big blind 100
*** HOLE CARDS ***
Dealt to dfcastro.net [Tc 8h]
75anatoliy: calls 100
eliasfleitas: folds 
dfcastro.net: folds 
ista6: folds 
andedik: raises 2340 to 2440 and is all-in
skandal76: folds 
Zeus6669: folds 
75anatoliy: calls 2340
*** FLOP *** [5d 3c 6d]
*** TURN *** [5d 3c 6d] [7h]
*** RIVER *** [5d 3c 6d 7h] [9c]
*** SHOW DOWN ***
75anatoliy: shows [Jh Kh] (high card King)
andedik: shows [Kd Qd] (high card King - Queen kicker)
andedik collected 5030 from pot
*** SUMMARY ***
Total pot 5030 | Rake 0 
Board [5d 3c 6d 7h 9c]
Seat 1: Zeus6669 (big blind) folded before Flop
Seat 2: 75anatoliy showed [Jh Kh] and lost with high card King
Seat 4: eliasfleitas folded before Flop (didn't bet)
Seat 5: dfcastro.net folded before Flop (didn't bet)
Seat 6: ista6 folded before Flop (didn't bet)
Seat 8: andedik (button) showed [Kd Qd] and won (5030) with high card King
Seat 9: skandal76 (small blind) folded before Flop



PokerStars Hand #97777333555: Tournament #725058424, $0.23+$0.02 USD Hold'em No Limit - Level IV (50/100) - 2013/04/27 16:18:54 BRT [2013/04/27 15:18:54 ET]
Table '725058424 1' 9-max Seat #9 is the button
Seat 1: Zeus6669 (1135 in chips) 
Seat 2: 75anatoliy (250 in chips) 
Seat 4: eliasfleitas (1850 in chips) 
Seat 5: dfcastro.net (1765 in chips) 
Seat 6: ista6 (1410 in chips) 
Seat 8: andedik (5030 in chips) 
Seat 9: skandal76 (220 in chips) 
Zeus6669: posts small blind 50
75anatoliy: posts big blind 100
*** HOLE CARDS ***
Dealt to dfcastro.net [Qd 8d]
eliasfleitas: folds 
dfcastro.net: folds 
ista6: folds 
andedik: folds 
skandal76: raises 120 to 220 and is all-in
Zeus6669: folds 
75anatoliy: calls 120
*** FLOP *** [Td 4d Kd]
*** TURN *** [Td 4d Kd] [7c]
*** RIVER *** [Td 4d Kd 7c] [9d]
*** SHOW DOWN ***
75anatoliy: shows [Jc 5s] (high card King)
skandal76: shows [9s 4s] (two pair, Nines and Fours)
skandal76 collected 490 from pot
*** SUMMARY ***
Total pot 490 | Rake 0 
Board [Td 4d Kd 7c 9d]
Seat 1: Zeus6669 (small blind) folded before Flop
Seat 2: 75anatoliy (big blind) showed [Jc 5s] and lost with high card King
Seat 4: eliasfleitas folded before Flop (didn't bet)
Seat 5: dfcastro.net folded before Flop (didn't bet)
Seat 6: ista6 folded before Flop (didn't bet)
Seat 8: andedik folded before Flop (didn't bet)
Seat 9: skandal76 (button) showed [9s 4s] and won (490) with two pair, Nines and Fours



PokerStars Hand #97777361110: Tournament #725058424, $0.23+$0.02 USD Hold'em No Limit - Level IV (50/100) - 2013/04/27 16:19:23 BRT [2013/04/27 15:19:23 ET]
Table '725058424 1' 9-max Seat #1 is the button
Seat 1: Zeus6669 (1085 in chips) 
Seat 2: 75anatoliy (30 in chips) 
Seat 4: eliasfleitas (1850 in chips) 
Seat 5: dfcastro.net (1765 in chips) 
Seat 6: ista6 (1410 in chips) 
Seat 8: andedik (5030 in chips) 
Seat 9: skandal76 (490 in chips) 
75anatoliy: posts small blind 30 and is all-in
eliasfleitas: posts big blind 100
*** HOLE CARDS ***
Dealt to dfcastro.net [5c 8d]
dfcastro.net: folds 
ista6: folds 
andedik: raises 200 to 300
skandal76: folds 
Zeus6669: folds 
eliasfleitas: calls 200
*** FLOP *** [Jd 7d 3s]
eliasfleitas: bets 300
andedik: calls 300
*** TURN *** [Jd 7d 3s] [9h]
eliasfleitas: bets 1250 and is all-in
andedik: calls 1250
*** RIVER *** [Jd 7d 3s 9h] [5d]
*** SHOW DOWN ***
eliasfleitas: shows [9s 7s] (two pair, Nines and Sevens)
andedik: shows [Jc Kc] (a pair of Jacks)
eliasfleitas collected 3640 from side pot
75anatoliy: shows [6h 8s] (a straight, Five to Nine)
75anatoliy collected 90 from main pot
*** SUMMARY ***
Total pot 3730 Main pot 90. Side pot 3640. | Rake 0 
Board [Jd 7d 3s 9h 5d]
Seat 1: Zeus6669 (button) folded before Flop (didn't bet)
Seat 2: 75anatoliy (small blind) showed [6h 8s] and won (90) with a straight, Five to Nine
Seat 4: eliasfleitas (big blind) showed [9s 7s] and won (3640) with two pair, Nines and Sevens
Seat 5: dfcastro.net folded before Flop (didn't bet)
Seat 6: ista6 folded before Flop (didn't bet)
Seat 8: andedik showed [Jc Kc] and lost with a pair of Jacks
Seat 9: skandal76 folded before Flop (didn't bet)



PokerStars Hand #97777399042: Tournament #725058424, $0.23+$0.02 USD Hold'em No Limit - Level IV (50/100) - 2013/04/27 16:20:04 BRT [2013/04/27 15:20:04 ET]
Table '725058424 1' 9-max Seat #2 is the button
Seat 1: Zeus6669 (1085 in chips) 
Seat 2: 75anatoliy (90 in chips) 
Seat 4: eliasfleitas (3640 in chips) 
Seat 5: dfcastro.net (1765 in chips) 
Seat 6: ista6 (1410 in chips) 
Seat 8: andedik (3180 in chips) 
Seat 9: skandal76 (490 in chips) 
eliasfleitas: posts small blind 50
dfcastro.net: posts big blind 100
*** HOLE CARDS ***
Dealt to dfcastro.net [9c Qh]
ista6: folds 
andedik: folds 
skandal76: folds 
Zeus6669: folds 
75anatoliy: calls 90 and is all-in
eliasfleitas: folds 
Uncalled bet (10) returned to dfcastro.net
*** FLOP *** [2c 8d 8c]
*** TURN *** [2c 8d 8c] [3d]
*** RIVER *** [2c 8d 8c 3d] [8s]
*** SHOW DOWN ***
dfcastro.net: shows [9c Qh] (three of a kind, Eights)
75anatoliy: shows [7h 9h] (three of a kind, Eights - lower kicker)
dfcastro.net collected 230 from pot
75anatoliy finished the tournament in 23rd place
*** SUMMARY ***
Total pot 230 | Rake 0 
Board [2c 8d 8c 3d 8s]
Seat 1: Zeus6669 folded before Flop (didn't bet)
Seat 2: 75anatoliy (button) showed [7h 9h] and lost with three of a kind, Eights
Seat 4: eliasfleitas (small blind) folded before Flop
Seat 5: dfcastro.net (big blind) showed [9c Qh] and won (230) with three of a kind, Eights
Seat 6: ista6 folded before Flop (didn't bet)
Seat 8: andedik folded before Flop (didn't bet)
Seat 9: skandal76 folded before Flop (didn't bet)



PokerStars Hand #97777419353: Tournament #725058424, $0.23+$0.02 USD Hold'em No Limit - Level IV (50/100) - 2013/04/27 16:20:26 BRT [2013/04/27 15:20:26 ET]
Table '725058424 1' 9-max Seat #4 is the button
Seat 1: Zeus6669 (1085 in chips) 
Seat 4: eliasfleitas (3590 in chips) 
Seat 5: dfcastro.net (1905 in chips) 
Seat 6: ista6 (1410 in chips) 
Seat 8: andedik (3180 in chips) 
Seat 9: skandal76 (490 in chips) 
dfcastro.net: posts small blind 50
ista6: posts big blind 100
*** HOLE CARDS ***
Dealt to dfcastro.net [2h 5h]
andedik: folds 
skandal76: folds 
Zeus6669: folds 
eliasfleitas: folds 
dfcastro.net: folds 
Uncalled bet (50) returned to ista6
ista6 collected 100 from pot
*** SUMMARY ***
Total pot 100 | Rake 0 
Seat 1: Zeus6669 folded before Flop (didn't bet)
Seat 4: eliasfleitas (button) folded before Flop (didn't bet)
Seat 5: dfcastro.net (small blind) folded before Flop
Seat 6: ista6 (big blind) collected (100)
Seat 8: andedik folded before Flop (didn't bet)
Seat 9: skandal76 folded before Flop (didn't bet)



PokerStars Hand #97777434646: Tournament #725058424, $0.23+$0.02 USD Hold'em No Limit - Level IV (50/100) - 2013/04/27 16:20:42 BRT [2013/04/27 15:20:42 ET]
Table '725058424 1' 9-max Seat #5 is the button
Seat 1: Zeus6669 (1085 in chips) 
Seat 2: sajtos5 (1140 in chips) is sitting out
Seat 4: eliasfleitas (3590 in chips) 
Seat 5: dfcastro.net (1855 in chips) 
Seat 6: ista6 (1460 in chips) 
Seat 8: andedik (3180 in chips) 
Seat 9: skandal76 (490 in chips) 
ista6: posts small blind 50
andedik: posts big blind 100
*** HOLE CARDS ***
Dealt to dfcastro.net [9h 5c]
skandal76: folds 
Zeus6669: folds 
sajtos5: folds 
eliasfleitas: folds 
dfcastro.net: folds 
ista6: folds 
Uncalled bet (50) returned to andedik
andedik collected 100 from pot
andedik: doesn't show hand 
*** SUMMARY ***
Total pot 100 | Rake 0 
Seat 1: Zeus6669 folded before Flop (didn't bet)
Seat 2: sajtos5 folded before Flop (didn't bet)
Seat 4: eliasfleitas folded before Flop (didn't bet)
Seat 5: dfcastro.net (button) folded before Flop (didn't bet)
Seat 6: ista6 (small blind) folded before Flop
Seat 8: andedik (big blind) collected (100)
Seat 9: skandal76 folded before Flop (didn't bet)



PokerStars Hand #97777448419: Tournament #725058424, $0.23+$0.02 USD Hold'em No Limit - Level IV (50/100) - 2013/04/27 16:20:57 BRT [2013/04/27 15:20:57 ET]
Table '725058424 1' 9-max Seat #6 is the button
Seat 1: Zeus6669 (1085 in chips) 
Seat 2: sajtos5 (1140 in chips) is sitting out
Seat 4: eliasfleitas (3590 in chips) 
Seat 5: dfcastro.net (1855 in chips) 
Seat 6: ista6 (1410 in chips) 
Seat 8: andedik (3230 in chips) 
Seat 9: skandal76 (490 in chips) 
andedik: posts small blind 50
skandal76: posts big blind 100
*** HOLE CARDS ***
Dealt to dfcastro.net [2d Ks]
Zeus6669: folds 
sajtos5: folds 
eliasfleitas: folds 
dfcastro.net: folds 
ista6: folds 
andedik: raises 200 to 300
skandal76: folds 
Uncalled bet (200) returned to andedik
andedik collected 200 from pot
andedik: doesn't show hand 
*** SUMMARY ***
Total pot 200 | Rake 0 
Seat 1: Zeus6669 folded before Flop (didn't bet)
Seat 2: sajtos5 folded before Flop (didn't bet)
Seat 4: eliasfleitas folded before Flop (didn't bet)
Seat 5: dfcastro.net folded before Flop (didn't bet)
Seat 6: ista6 (button) folded before Flop (didn't bet)
Seat 8: andedik (small blind) collected (200)
Seat 9: skandal76 (big blind) folded before Flop



PokerStars Hand #97777466360: Tournament #725058424, $0.23+$0.02 USD Hold'em No Limit - Level IV (50/100) - 2013/04/27 16:21:16 BRT [2013/04/27 15:21:16 ET]
Table '725058424 1' 9-max Seat #8 is the button
Seat 1: Zeus6669 (1085 in chips) 
Seat 2: sajtos5 (1140 in chips) is sitting out
Seat 4: eliasfleitas (3590 in chips) 
Seat 5: dfcastro.net (1855 in chips) 
Seat 6: ista6 (1410 in chips) 
Seat 8: andedik (3330 in chips) 
Seat 9: skandal76 (390 in chips) 
skandal76: posts small blind 50
Zeus6669: posts big blind 100
*** HOLE CARDS ***
Dealt to dfcastro.net [7h 9s]
sajtos5: folds 
eliasfleitas: folds 
dfcastro.net: folds 
ista6: folds 
andedik: folds 
skandal76: folds 
Uncalled bet (50) returned to Zeus6669
Zeus6669 collected 100 from pot
*** SUMMARY ***
Total pot 100 | Rake 0 
Seat 1: Zeus6669 (big blind) collected (100)
Seat 2: sajtos5 folded before Flop (didn't bet)
Seat 4: eliasfleitas folded before Flop (didn't bet)
Seat 5: dfcastro.net folded before Flop (didn't bet)
Seat 6: ista6 folded before Flop (didn't bet)
Seat 8: andedik (button) folded before Flop (didn't bet)
Seat 9: skandal76 (small blind) folded before Flop



PokerStars Hand #97777480322: Tournament #725058424, $0.23+$0.02 USD Hold'em No Limit - Level IV (50/100) - 2013/04/27 16:21:31 BRT [2013/04/27 15:21:31 ET]
Table '725058424 1' 9-max Seat #9 is the button
Seat 1: Zeus6669 (1135 in chips) 
Seat 2: sajtos5 (1140 in chips) is sitting out
Seat 4: eliasfleitas (3590 in chips) 
Seat 5: dfcastro.net (1855 in chips) 
Seat 6: ista6 (1410 in chips) 
Seat 8: andedik (3330 in chips) 
Seat 9: skandal76 (340 in chips) 
Zeus6669: posts small blind 50
sajtos5: posts big blind 100
*** HOLE CARDS ***
Dealt to dfcastro.net [7h 2h]
eliasfleitas: folds 
dfcastro.net: folds 
ista6: folds 
andedik: calls 100
skandal76: folds 
Zeus6669: folds 
sajtos5: folds 
andedik collected 250 from pot
andedik: doesn't show hand 
*** SUMMARY ***
Total pot 250 | Rake 0 
Seat 1: Zeus6669 (small blind) folded before Flop
Seat 2: sajtos5 (big blind) folded before Flop
Seat 4: eliasfleitas folded before Flop (didn't bet)
Seat 5: dfcastro.net folded before Flop (didn't bet)
Seat 6: ista6 folded before Flop (didn't bet)
Seat 8: andedik collected (250)
Seat 9: skandal76 (button) folded before Flop (didn't bet)



PokerStars Hand #97777492873: Tournament #725058424, $0.23+$0.02 USD Hold'em No Limit - Level IV (50/100) - 2013/04/27 16:21:45 BRT [2013/04/27 15:21:45 ET]
Table '725058424 1' 9-max Seat #1 is the button
Seat 1: Zeus6669 (1085 in chips) 
Seat 2: sajtos5 (1040 in chips) is sitting out
Seat 4: eliasfleitas (3590 in chips) 
Seat 5: dfcastro.net (1855 in chips) 
Seat 6: ista6 (1410 in chips) 
Seat 8: andedik (3480 in chips) 
Seat 9: skandal76 (340 in chips) 
sajtos5: posts small blind 50
eliasfleitas: posts big blind 100
*** HOLE CARDS ***
Dealt to dfcastro.net [8s Jh]
dfcastro.net: folds 
ista6: folds 
andedik: folds 
skandal76: folds 
Zeus6669: folds 
sajtos5: folds 
Uncalled bet (50) returned to eliasfleitas
eliasfleitas collected 100 from pot
*** SUMMARY ***
Total pot 100 | Rake 0 
Seat 1: Zeus6669 (button) folded before Flop (didn't bet)
Seat 2: sajtos5 (small blind) folded before Flop
Seat 4: eliasfleitas (big blind) collected (100)
Seat 5: dfcastro.net folded before Flop (didn't bet)
Seat 6: ista6 folded before Flop (didn't bet)
Seat 8: andedik folded before Flop (didn't bet)
Seat 9: skandal76 folded before Flop (didn't bet)



PokerStars Hand #97777508938: Tournament #725058424, $0.23+$0.02 USD Hold'em No Limit - Level IV (50/100) - 2013/04/27 16:22:02 BRT [2013/04/27 15:22:02 ET]
Table '725058424 1' 9-max Seat #2 is the button
Seat 1: Zeus6669 (1085 in chips) 
Seat 2: sajtos5 (990 in chips) is sitting out
Seat 4: eliasfleitas (3640 in chips) 
Seat 5: dfcastro.net (1855 in chips) 
Seat 6: ista6 (1410 in chips) 
Seat 8: andedik (3480 in chips) 
Seat 9: skandal76 (340 in chips) 
eliasfleitas: posts small blind 50
dfcastro.net: posts big blind 100
*** HOLE CARDS ***
Dealt to dfcastro.net [9s 5h]
ista6: folds 
andedik: folds 
skandal76: folds 
Zeus6669: folds 
sajtos5: folds 
eliasfleitas: folds 
Uncalled bet (50) returned to dfcastro.net
dfcastro.net collected 100 from pot
dfcastro.net: doesn't show hand 
*** SUMMARY ***
Total pot 100 | Rake 0 
Seat 1: Zeus6669 folded before Flop (didn't bet)
Seat 2: sajtos5 (button) folded before Flop (didn't bet)
Seat 4: eliasfleitas (small blind) folded before Flop
Seat 5: dfcastro.net (big blind) collected (100)
Seat 6: ista6 folded before Flop (didn't bet)
Seat 8: andedik folded before Flop (didn't bet)
Seat 9: skandal76 folded before Flop (didn't bet)



PokerStars Hand #97777521006: Tournament #725058424, $0.23+$0.02 USD Hold'em No Limit - Level IV (50/100) - 2013/04/27 16:22:15 BRT [2013/04/27 15:22:15 ET]
Table '725058424 1' 9-max Seat #4 is the button
Seat 1: Zeus6669 (1085 in chips) 
Seat 2: sajtos5 (990 in chips) is sitting out
Seat 4: eliasfleitas (3590 in chips) 
Seat 5: dfcastro.net (1905 in chips) 
Seat 6: ista6 (1410 in chips) 
Seat 8: andedik (3480 in chips) 
Seat 9: skandal76 (340 in chips) 
dfcastro.net: posts small blind 50
ista6: posts big blind 100
*** HOLE CARDS ***
Dealt to dfcastro.net [Qc 4h]
andedik: folds 
skandal76: folds 
Zeus6669: folds 
sajtos5: folds 
eliasfleitas: folds 
dfcastro.net: folds 
Uncalled bet (50) returned to ista6
ista6 collected 100 from pot
*** SUMMARY ***
Total pot 100 | Rake 0 
Seat 1: Zeus6669 folded before Flop (didn't bet)
Seat 2: sajtos5 folded before Flop (didn't bet)
Seat 4: eliasfleitas (button) folded before Flop (didn't bet)
Seat 5: dfcastro.net (small blind) folded before Flop
Seat 6: ista6 (big blind) collected (100)
Seat 8: andedik folded before Flop (didn't bet)
Seat 9: skandal76 folded before Flop (didn't bet)



PokerStars Hand #97777537050: Tournament #725058424, $0.23+$0.02 USD Hold'em No Limit - Level IV (50/100) - 2013/04/27 16:22:32 BRT [2013/04/27 15:22:32 ET]
Table '725058424 1' 9-max Seat #5 is the button
Seat 1: Zeus6669 (1085 in chips) 
Seat 2: sajtos5 (990 in chips) is sitting out
Seat 4: eliasfleitas (3590 in chips) 
Seat 5: dfcastro.net (1855 in chips) 
Seat 6: ista6 (1460 in chips) 
Seat 8: andedik (3480 in chips) 
Seat 9: skandal76 (340 in chips) 
ista6: posts small blind 50
andedik: posts big blind 100
*** HOLE CARDS ***
Dealt to dfcastro.net [Ks 4c]
skandal76: folds 
Zeus6669: folds 
sajtos5: folds 
eliasfleitas: folds 
dfcastro.net: folds 
ista6: folds 
Uncalled bet (50) returned to andedik
andedik collected 100 from pot
andedik: doesn't show hand 
*** SUMMARY ***
Total pot 100 | Rake 0 
Seat 1: Zeus6669 folded before Flop (didn't bet)
Seat 2: sajtos5 folded before Flop (didn't bet)
Seat 4: eliasfleitas folded before Flop (didn't bet)
Seat 5: dfcastro.net (button) folded before Flop (didn't bet)
Seat 6: ista6 (small blind) folded before Flop
Seat 8: andedik (big blind) collected (100)
Seat 9: skandal76 folded before Flop (didn't bet)



PokerStars Hand #97777548086: Tournament #725058424, $0.23+$0.02 USD Hold'em No Limit - Level IV (50/100) - 2013/04/27 16:22:44 BRT [2013/04/27 15:22:44 ET]
Table '725058424 1' 9-max Seat #6 is the button
Seat 1: Zeus6669 (1085 in chips) 
Seat 2: sajtos5 (990 in chips) is sitting out
Seat 4: eliasfleitas (3590 in chips) 
Seat 5: dfcastro.net (1855 in chips) 
Seat 6: ista6 (1410 in chips) 
Seat 8: andedik (3530 in chips) 
Seat 9: skandal76 (340 in chips) 
andedik: posts small blind 50
skandal76: posts big blind 100
*** HOLE CARDS ***
Dealt to dfcastro.net [Ac 4d]
Zeus6669: folds 
sajtos5: folds 
eliasfleitas: raises 200 to 300
dfcastro.net: folds 
ista6: folds 
andedik: folds 
skandal76: folds 
Uncalled bet (200) returned to eliasfleitas
eliasfleitas collected 250 from pot
*** SUMMARY ***
Total pot 250 | Rake 0 
Seat 1: Zeus6669 folded before Flop (didn't bet)
Seat 2: sajtos5 folded before Flop (didn't bet)
Seat 4: eliasfleitas collected (250)
Seat 5: dfcastro.net folded before Flop (didn't bet)
Seat 6: ista6 (button) folded before Flop (didn't bet)
Seat 8: andedik (small blind) folded before Flop
Seat 9: skandal76 (big blind) folded before Flop



PokerStars Hand #97777574216: Tournament #725058424, $0.23+$0.02 USD Hold'em No Limit - Level IV (50/100) - 2013/04/27 16:23:13 BRT [2013/04/27 15:23:13 ET]
Table '725058424 1' 9-max Seat #8 is the button
Seat 1: Zeus6669 (1085 in chips) 
Seat 2: sajtos5 (990 in chips) is sitting out
Seat 4: eliasfleitas (3740 in chips) 
Seat 5: dfcastro.net (1855 in chips) 
Seat 6: ista6 (1410 in chips) 
Seat 8: andedik (3480 in chips) 
Seat 9: skandal76 (240 in chips) 
skandal76: posts small blind 50
Zeus6669: posts big blind 100
*** HOLE CARDS ***
Dealt to dfcastro.net [Ac 3d]
sajtos5: folds 
eliasfleitas: folds 
dfcastro.net: folds 
ista6: folds 
andedik: folds 
skandal76: folds 
Uncalled bet (50) returned to Zeus6669
Zeus6669 collected 100 from pot
*** SUMMARY ***
Total pot 100 | Rake 0 
Seat 1: Zeus6669 (big blind) collected (100)
Seat 2: sajtos5 folded before Flop (didn't bet)
Seat 4: eliasfleitas folded before Flop (didn't bet)
Seat 5: dfcastro.net folded before Flop (didn't bet)
Seat 6: ista6 folded before Flop (didn't bet)
Seat 8: andedik (button) folded before Flop (didn't bet)
Seat 9: skandal76 (small blind) folded before Flop



PokerStars Hand #97777594374: Tournament #725058424, $0.23+$0.02 USD Hold'em No Limit - Level IV (50/100) - 2013/04/27 16:23:35 BRT [2013/04/27 15:23:35 ET]
Table '725058424 1' 9-max Seat #9 is the button
Seat 1: Zeus6669 (1135 in chips) 
Seat 2: sajtos5 (990 in chips) is sitting out
Seat 4: eliasfleitas (3740 in chips) 
Seat 5: dfcastro.net (1855 in chips) 
Seat 6: ista6 (1410 in chips) 
Seat 8: andedik (3480 in chips) 
Seat 9: skandal76 (190 in chips) 
Zeus6669: posts small blind 50
sajtos5: posts big blind 100
*** HOLE CARDS ***
Dealt to dfcastro.net [7d Ks]
eliasfleitas: raises 200 to 300
dfcastro.net: folds 
ista6: folds 
andedik: calls 300
skandal76: folds 
Zeus6669: folds 
sajtos5: folds 
*** FLOP *** [3d Qh 7s]
eliasfleitas: bets 400
andedik: folds 
Uncalled bet (400) returned to eliasfleitas
eliasfleitas collected 750 from pot
*** SUMMARY ***
Total pot 750 | Rake 0 
Board [3d Qh 7s]
Seat 1: Zeus6669 (small blind) folded before Flop
Seat 2: sajtos5 (big blind) folded before Flop
Seat 4: eliasfleitas collected (750)
Seat 5: dfcastro.net folded before Flop (didn't bet)
Seat 6: ista6 folded before Flop (didn't bet)
Seat 8: andedik folded on the Flop
Seat 9: skandal76 (button) folded before Flop (didn't bet)



PokerStars Hand #97777627920: Tournament #725058424, $0.23+$0.02 USD Hold'em No Limit - Level IV (50/100) - 2013/04/27 16:24:12 BRT [2013/04/27 15:24:12 ET]
Table '725058424 1' 9-max Seat #1 is the button
Seat 1: Zeus6669 (1085 in chips) 
Seat 2: sajtos5 (890 in chips) is sitting out
Seat 3: mitto1989 (3932 in chips) 
Seat 4: eliasfleitas (4190 in chips) 
Seat 5: dfcastro.net (1855 in chips) 
Seat 6: ista6 (1410 in chips) 
Seat 7: IlyaFD (11370 in chips) 
Seat 8: andedik (3180 in chips) 
Seat 9: skandal76 (190 in chips) 
sajtos5: posts small blind 50
mitto1989: posts big blind 100
*** HOLE CARDS ***
Dealt to dfcastro.net [4s 8s]
eliasfleitas: folds 
dfcastro.net: folds 
ista6: folds 
IlyaFD: raises 100 to 200
andedik: folds 
skandal76: calls 190 and is all-in
Zeus6669: folds 
sajtos5: folds 
mitto1989: folds 
Uncalled bet (10) returned to IlyaFD
*** FLOP *** [2h Ah Td]
*** TURN *** [2h Ah Td] [Qh]
*** RIVER *** [2h Ah Td Qh] [5d]
*** SHOW DOWN ***
IlyaFD: shows [7s 6s] (high card Ace)
skandal76: shows [Ks Kd] (a pair of Kings)
skandal76 collected 530 from pot
*** SUMMARY ***
Total pot 530 | Rake 0 
Board [2h Ah Td Qh 5d]
Seat 1: Zeus6669 (button) folded before Flop (didn't bet)
Seat 2: sajtos5 (small blind) folded before Flop
Seat 3: mitto1989 (big blind) folded before Flop
Seat 4: eliasfleitas folded before Flop (didn't bet)
Seat 5: dfcastro.net folded before Flop (didn't bet)
Seat 6: ista6 folded before Flop (didn't bet)
Seat 7: IlyaFD showed [7s 6s] and lost with high card Ace
Seat 8: andedik folded before Flop (didn't bet)
Seat 9: skandal76 showed [Ks Kd] and won (530) with a pair of Kings



PokerStars Hand #97777661560: Tournament #725058424, $0.23+$0.02 USD Hold'em No Limit - Level IV (50/100) - 2013/04/27 16:24:48 BRT [2013/04/27 15:24:48 ET]
Table '725058424 1' 9-max Seat #2 is the button
Seat 1: Zeus6669 (1085 in chips) 
Seat 2: sajtos5 (840 in chips) is sitting out
Seat 3: mitto1989 (3832 in chips) 
Seat 4: eliasfleitas (4190 in chips) 
Seat 5: dfcastro.net (1855 in chips) 
Seat 6: ista6 (1410 in chips) 
Seat 7: IlyaFD (11180 in chips) 
Seat 8: andedik (3180 in chips) 
Seat 9: skandal76 (530 in chips) 
mitto1989: posts small blind 50
eliasfleitas: posts big blind 100
*** HOLE CARDS ***
Dealt to dfcastro.net [Kd Jd]
dfcastro.net: folds 
ista6: folds 
IlyaFD: folds 
andedik: folds 
skandal76: folds 
Zeus6669: folds 
sajtos5: folds 
mitto1989: folds 
Uncalled bet (50) returned to eliasfleitas
eliasfleitas collected 100 from pot
*** SUMMARY ***
Total pot 100 | Rake 0 
Seat 1: Zeus6669 folded before Flop (didn't bet)
Seat 2: sajtos5 (button) folded before Flop (didn't bet)
Seat 3: mitto1989 (small blind) folded before Flop
Seat 4: eliasfleitas (big blind) collected (100)
Seat 5: dfcastro.net folded before Flop (didn't bet)
Seat 6: ista6 folded before Flop (didn't bet)
Seat 7: IlyaFD folded before Flop (didn't bet)
Seat 8: andedik folded before Flop (didn't bet)
Seat 9: skandal76 folded before Flop (didn't bet)



PokerStars Hand #97777693588: Tournament #725058424, $0.23+$0.02 USD Hold'em No Limit - Level V (75/150) - 2013/04/27 16:25:23 BRT [2013/04/27 15:25:23 ET]
Table '725058424 1' 9-max Seat #3 is the button
Seat 1: Zeus6669 (1085 in chips) 
Seat 2: sajtos5 (840 in chips) is sitting out
Seat 3: mitto1989 (3782 in chips) 
Seat 4: eliasfleitas (4240 in chips) 
Seat 5: dfcastro.net (1855 in chips) 
Seat 6: ista6 (1410 in chips) 
Seat 7: IlyaFD (11180 in chips) 
Seat 8: andedik (3180 in chips) 
Seat 9: skandal76 (530 in chips) 
eliasfleitas: posts small blind 75
dfcastro.net: posts big blind 150
*** HOLE CARDS ***
Dealt to dfcastro.net [9h 2d]
ista6: folds 
IlyaFD: raises 150 to 300
andedik: folds 
skandal76: folds 
Zeus6669: folds 
sajtos5: folds 
mitto1989: folds 
eliasfleitas: folds 
dfcastro.net: folds 
Uncalled bet (150) returned to IlyaFD
IlyaFD collected 375 from pot
*** SUMMARY ***
Total pot 375 | Rake 0 
Seat 1: Zeus6669 folded before Flop (didn't bet)
Seat 2: sajtos5 folded before Flop (didn't bet)
Seat 3: mitto1989 (button) folded before Flop (didn't bet)
Seat 4: eliasfleitas (small blind) folded before Flop
Seat 5: dfcastro.net (big blind) folded before Flop
Seat 6: ista6 folded before Flop (didn't bet)
Seat 7: IlyaFD collected (375)
Seat 8: andedik folded before Flop (didn't bet)
Seat 9: skandal76 folded before Flop (didn't bet)



PokerStars Hand #97777737343: Tournament #725058424, $0.23+$0.02 USD Hold'em No Limit - Level V (75/150) - 2013/04/27 16:26:11 BRT [2013/04/27 15:26:11 ET]
Table '725058424 1' 9-max Seat #4 is the button
Seat 1: Zeus6669 (1085 in chips) 
Seat 2: sajtos5 (840 in chips) is sitting out
Seat 3: mitto1989 (3782 in chips) 
Seat 4: eliasfleitas (4165 in chips) 
Seat 5: dfcastro.net (1705 in chips) 
Seat 6: ista6 (1410 in chips) 
Seat 7: IlyaFD (11405 in chips) 
Seat 8: andedik (3180 in chips) 
Seat 9: skandal76 (530 in chips) 
dfcastro.net: posts small blind 75
ista6: posts big blind 150
*** HOLE CARDS ***
Dealt to dfcastro.net [Qd 5c]
IlyaFD: folds 
andedik: calls 150
skandal76: folds 
Zeus6669: raises 935 to 1085 and is all-in
sajtos5: folds 
mitto1989: folds 
eliasfleitas: folds 
dfcastro.net: folds 
ista6: folds 
andedik: folds 
Uncalled bet (935) returned to Zeus6669
Zeus6669 collected 525 from pot
*** SUMMARY ***
Total pot 525 | Rake 0 
Seat 1: Zeus6669 collected (525)
Seat 2: sajtos5 folded before Flop (didn't bet)
Seat 3: mitto1989 folded before Flop (didn't bet)
Seat 4: eliasfleitas (button) folded before Flop (didn't bet)
Seat 5: dfcastro.net (small blind) folded before Flop
Seat 6: ista6 (big blind) folded before Flop
Seat 7: IlyaFD folded before Flop (didn't bet)
Seat 8: andedik folded before Flop
Seat 9: skandal76 folded before Flop (didn't bet)



PokerStars Hand #97777774347: Tournament #725058424, $0.23+$0.02 USD Hold'em No Limit - Level V (75/150) - 2013/04/27 16:26:51 BRT [2013/04/27 15:26:51 ET]
Table '725058424 1' 9-max Seat #5 is the button
Seat 1: Zeus6669 (1460 in chips) 
Seat 2: sajtos5 (840 in chips) is sitting out
Seat 3: mitto1989 (3782 in chips) 
Seat 4: eliasfleitas (4165 in chips) 
Seat 5: dfcastro.net (1630 in chips) 
Seat 6: ista6 (1260 in chips) 
Seat 7: IlyaFD (11405 in chips) 
Seat 8: andedik (3030 in chips) 
Seat 9: skandal76 (530 in chips) 
ista6: posts small blind 75
IlyaFD: posts big blind 150
*** HOLE CARDS ***
Dealt to dfcastro.net [3h 5s]
andedik: folds 
skandal76: raises 380 to 530 and is all-in
Zeus6669: folds 
sajtos5: folds 
mitto1989: folds 
eliasfleitas: folds 
dfcastro.net: folds 
ista6: folds 
IlyaFD: folds 
Uncalled bet (380) returned to skandal76
skandal76 collected 375 from pot
skandal76: doesn't show hand 
*** SUMMARY ***
Total pot 375 | Rake 0 
Seat 1: Zeus6669 folded before Flop (didn't bet)
Seat 2: sajtos5 folded before Flop (didn't bet)
Seat 3: mitto1989 folded before Flop (didn't bet)
Seat 4: eliasfleitas folded before Flop (didn't bet)
Seat 5: dfcastro.net (button) folded before Flop (didn't bet)
Seat 6: ista6 (small blind) folded before Flop
Seat 7: IlyaFD (big blind) folded before Flop
Seat 8: andedik folded before Flop (didn't bet)
Seat 9: skandal76 collected (375)



PokerStars Hand #97777791849: Tournament #725058424, $0.23+$0.02 USD Hold'em No Limit - Level V (75/150) - 2013/04/27 16:27:10 BRT [2013/04/27 15:27:10 ET]
Table '725058424 1' 9-max Seat #6 is the button
Seat 1: Zeus6669 (1460 in chips) 
Seat 2: sajtos5 (840 in chips) is sitting out
Seat 3: mitto1989 (3782 in chips) 
Seat 4: eliasfleitas (4165 in chips) 
Seat 5: dfcastro.net (1630 in chips) 
Seat 6: ista6 (1185 in chips) 
Seat 7: IlyaFD (11255 in chips) 
Seat 8: andedik (3030 in chips) 
Seat 9: skandal76 (755 in chips) 
IlyaFD: posts small blind 75
andedik: posts big blind 150
*** HOLE CARDS ***
Dealt to dfcastro.net [3h Js]
skandal76: folds 
Zeus6669: folds 
sajtos5: folds 
mitto1989 has timed out
mitto1989: folds 
mitto1989 is sitting out
eliasfleitas: folds 
mitto1989 has returned
dfcastro.net: folds 
ista6: raises 1035 to 1185 and is all-in
IlyaFD: folds 
andedik: folds 
Uncalled bet (1035) returned to ista6
ista6 collected 375 from pot
*** SUMMARY ***
Total pot 375 | Rake 0 
Seat 1: Zeus6669 folded before Flop (didn't bet)
Seat 2: sajtos5 folded before Flop (didn't bet)
Seat 3: mitto1989 folded before Flop (didn't bet)
Seat 4: eliasfleitas folded before Flop (didn't bet)
Seat 5: dfcastro.net folded before Flop (didn't bet)
Seat 6: ista6 (button) collected (375)
Seat 7: IlyaFD (small blind) folded before Flop
Seat 8: andedik (big blind) folded before Flop
Seat 9: skandal76 folded before Flop (didn't bet)



PokerStars Hand #97777852135: Tournament #725058424, $0.23+$0.02 USD Hold'em No Limit - Level V (75/150) - 2013/04/27 16:28:17 BRT [2013/04/27 15:28:17 ET]
Table '725058424 1' 9-max Seat #7 is the button
Seat 1: Zeus6669 (1460 in chips) 
Seat 2: sajtos5 (840 in chips) is sitting out
Seat 3: mitto1989 (3782 in chips) 
Seat 4: eliasfleitas (4165 in chips) 
Seat 5: dfcastro.net (1630 in chips) 
Seat 6: ista6 (1410 in chips) 
Seat 7: IlyaFD (11180 in chips) 
Seat 8: andedik (2880 in chips) 
Seat 9: skandal76 (755 in chips) 
andedik: posts small blind 75
skandal76: posts big blind 150
*** HOLE CARDS ***
Dealt to dfcastro.net [9d 9h]
Zeus6669: folds 
sajtos5: folds 
mitto1989: folds 
eliasfleitas: raises 300 to 450
dfcastro.net: raises 1180 to 1630 and is all-in
ista6: folds 
IlyaFD has timed out
IlyaFD: folds 
IlyaFD is sitting out
IlyaFD has returned
andedik: folds 
skandal76: folds 
eliasfleitas: folds [Th Jh]
Uncalled bet (1180) returned to dfcastro.net
dfcastro.net collected 1125 from pot
dfcastro.net: doesn't show hand 
*** SUMMARY ***
Total pot 1125 | Rake 0 
Seat 1: Zeus6669 folded before Flop (didn't bet)
Seat 2: sajtos5 folded before Flop (didn't bet)
Seat 3: mitto1989 folded before Flop (didn't bet)
Seat 4: eliasfleitas folded before Flop
Seat 5: dfcastro.net collected (1125)
Seat 6: ista6 folded before Flop (didn't bet)
Seat 7: IlyaFD (button) folded before Flop (didn't bet)
Seat 8: andedik (small blind) folded before Flop
Seat 9: skandal76 (big blind) folded before Flop



PokerStars Hand #97777900132: Tournament #725058424, $0.23+$0.02 USD Hold'em No Limit - Level V (75/150) - 2013/04/27 16:29:09 BRT [2013/04/27 15:29:09 ET]
Table '725058424 1' 9-max Seat #8 is the button
Seat 1: Zeus6669 (1460 in chips) 
Seat 2: sajtos5 (840 in chips) is sitting out
Seat 3: mitto1989 (3782 in chips) 
Seat 4: eliasfleitas (3715 in chips) 
Seat 5: dfcastro.net (2305 in chips) 
Seat 6: ista6 (1410 in chips) 
Seat 7: IlyaFD (11180 in chips) 
Seat 8: andedik (2805 in chips) 
Seat 9: skandal76 (605 in chips) 
skandal76: posts small blind 75
Zeus6669: posts big blind 150
*** HOLE CARDS ***
Dealt to dfcastro.net [Qc Td]
sajtos5: folds 
mitto1989: folds 
eliasfleitas: folds 
dfcastro.net: folds 
ista6: folds 
IlyaFD: raises 150 to 300
andedik: raises 150 to 450
skandal76: folds 
Zeus6669: folds 
IlyaFD: calls 150
*** FLOP *** [8h 9h 6d]
IlyaFD: checks 
andedik: bets 600
IlyaFD: calls 600
*** TURN *** [8h 9h 6d] [3d]
IlyaFD: checks 
andedik: bets 1755 and is all-in
IlyaFD: folds 
Uncalled bet (1755) returned to andedik
andedik collected 2325 from pot
andedik: doesn't show hand 
*** SUMMARY ***
Total pot 2325 | Rake 0 
Board [8h 9h 6d 3d]
Seat 1: Zeus6669 (big blind) folded before Flop
Seat 2: sajtos5 folded before Flop (didn't bet)
Seat 3: mitto1989 folded before Flop (didn't bet)
Seat 4: eliasfleitas folded before Flop (didn't bet)
Seat 5: dfcastro.net folded before Flop (didn't bet)
Seat 6: ista6 folded before Flop (didn't bet)
Seat 7: IlyaFD folded on the Turn
Seat 8: andedik (button) collected (2325)
Seat 9: skandal76 (small blind) folded before Flop



PokerStars Hand #97777942269: Tournament #725058424, $0.23+$0.02 USD Hold'em No Limit - Level V (75/150) - 2013/04/27 16:29:55 BRT [2013/04/27 15:29:55 ET]
Table '725058424 1' 9-max Seat #9 is the button
Seat 1: Zeus6669 (1310 in chips) 
Seat 2: sajtos5 (840 in chips) is sitting out
Seat 3: mitto1989 (3782 in chips) 
Seat 4: eliasfleitas (3715 in chips) 
Seat 5: dfcastro.net (2305 in chips) 
Seat 6: ista6 (1410 in chips) 
Seat 7: IlyaFD (10130 in chips) 
Seat 8: andedik (4080 in chips) 
Seat 9: skandal76 (530 in chips) 
Zeus6669: posts small blind 75
sajtos5: posts big blind 150
*** HOLE CARDS ***
Dealt to dfcastro.net [7c Td]
mitto1989: folds 
eliasfleitas: raises 300 to 450
dfcastro.net: folds 
ista6: folds 
IlyaFD: folds 
andedik: folds 
skandal76: raises 80 to 530 and is all-in
Zeus6669: calls 455
sajtos5: folds 
eliasfleitas: calls 80
*** FLOP *** [9d 2d 5h]
Zeus6669: bets 780 and is all-in
eliasfleitas: calls 780
*** TURN *** [9d 2d 5h] [8h]
*** RIVER *** [9d 2d 5h 8h] [Ts]
*** SHOW DOWN ***
Zeus6669: shows [Ac Jc] (high card Ace)
eliasfleitas: shows [Qs Ad] (high card Ace - Queen kicker)
eliasfleitas collected 1560 from side pot
skandal76: shows [Js As] (high card Ace - lower kicker)
eliasfleitas collected 1740 from main pot
Zeus6669 finished the tournament in 16th place
skandal76 finished the tournament in 17th place
*** SUMMARY ***
Total pot 3300 Main pot 1740. Side pot 1560. | Rake 0 
Board [9d 2d 5h 8h Ts]
Seat 1: Zeus6669 (small blind) showed [Ac Jc] and lost with high card Ace
Seat 2: sajtos5 (big blind) folded before Flop
Seat 3: mitto1989 folded before Flop (didn't bet)
Seat 4: eliasfleitas showed [Qs Ad] and won (3300) with high card Ace
Seat 5: dfcastro.net folded before Flop (didn't bet)
Seat 6: ista6 folded before Flop (didn't bet)
Seat 7: IlyaFD folded before Flop (didn't bet)
Seat 8: andedik folded before Flop (didn't bet)
Seat 9: skandal76 (button) showed [Js As] and lost with high card Ace



PokerStars Hand #97778002393: Tournament #725058424, $0.23+$0.02 USD Hold'em No Limit - Level V (75/150) - 2013/04/27 16:30:56 BRT [2013/04/27 15:30:56 ET]
Table '725058424 1' 9-max Seat #2 is the button
Seat 2: sajtos5 (690 in chips) is sitting out
Seat 3: mitto1989 (3782 in chips) 
Seat 4: eliasfleitas (5705 in chips) 
Seat 5: dfcastro.net (2305 in chips) 
Seat 6: ista6 (1410 in chips) 
Seat 7: IlyaFD (10130 in chips) 
Seat 8: andedik (4080 in chips) 
mitto1989: posts small blind 75
eliasfleitas: posts big blind 150
*** HOLE CARDS ***
Dealt to dfcastro.net [Kd 8c]
dfcastro.net: folds 
ista6: folds 
IlyaFD: raises 150 to 300
andedik: folds 
sajtos5: folds 
mitto1989: folds 
eliasfleitas: folds 
Uncalled bet (150) returned to IlyaFD
IlyaFD collected 375 from pot
*** SUMMARY ***
Total pot 375 | Rake 0 
Seat 2: sajtos5 (button) folded before Flop (didn't bet)
Seat 3: mitto1989 (small blind) folded before Flop
Seat 4: eliasfleitas (big blind) folded before Flop
Seat 5: dfcastro.net folded before Flop (didn't bet)
Seat 6: ista6 folded before Flop (didn't bet)
Seat 7: IlyaFD collected (375)
Seat 8: andedik folded before Flop (didn't bet)



PokerStars Hand #97778017383: Tournament #725058424, $0.23+$0.02 USD Hold'em No Limit - Level V (75/150) - 2013/04/27 16:31:12 BRT [2013/04/27 15:31:12 ET]
Table '725058424 1' 9-max Seat #3 is the button
Seat 2: sajtos5 (690 in chips) is sitting out
Seat 3: mitto1989 (3707 in chips) 
Seat 4: eliasfleitas (5555 in chips) 
Seat 5: dfcastro.net (2305 in chips) 
Seat 6: ista6 (1410 in chips) 
Seat 7: IlyaFD (10355 in chips) 
Seat 8: andedik (4080 in chips) 
eliasfleitas: posts small blind 75
dfcastro.net: posts big blind 150
*** HOLE CARDS ***
Dealt to dfcastro.net [6h Ac]
ista6: raises 1260 to 1410 and is all-in
IlyaFD: folds 
andedik: folds 
sajtos5: folds 
mitto1989: folds 
eliasfleitas: folds 
dfcastro.net: calls 1260
*** FLOP *** [Ts 5c Kd]
*** TURN *** [Ts 5c Kd] [Td]
*** RIVER *** [Ts 5c Kd Td] [5s]
*** SHOW DOWN ***
dfcastro.net: shows [6h Ac] (two pair, Tens and Fives)
ista6: shows [Qc Ad] (two pair, Tens and Fives)
dfcastro.net collected 1448 from pot
ista6 collected 1447 from pot
*** SUMMARY ***
Total pot 2895 | Rake 0 
Board [Ts 5c Kd Td 5s]
Seat 2: sajtos5 folded before Flop (didn't bet)
Seat 3: mitto1989 (button) folded before Flop (didn't bet)
Seat 4: eliasfleitas (small blind) folded before Flop
Seat 5: dfcastro.net (big blind) showed [6h Ac] and won (1448) with two pair, Tens and Fives
Seat 6: ista6 showed [Qc Ad] and won (1447) with two pair, Tens and Fives
Seat 7: IlyaFD folded before Flop (didn't bet)
Seat 8: andedik folded before Flop (didn't bet)



PokerStars Hand #97778039740: Tournament #725058424, $0.23+$0.02 USD Hold'em No Limit - Level V (75/150) - 2013/04/27 16:31:35 BRT [2013/04/27 15:31:35 ET]
Table '725058424 1' 9-max Seat #4 is the button
Seat 2: sajtos5 (690 in chips) is sitting out
Seat 3: mitto1989 (3707 in chips) 
Seat 4: eliasfleitas (5480 in chips) 
Seat 5: dfcastro.net (2343 in chips) 
Seat 6: ista6 (1447 in chips) 
Seat 7: IlyaFD (10355 in chips) 
Seat 8: andedik (4080 in chips) 
dfcastro.net: posts small blind 75
ista6: posts big blind 150
*** HOLE CARDS ***
Dealt to dfcastro.net [9d 4s]
IlyaFD: folds 
andedik: folds 
sajtos5: folds 
mitto1989: folds 
eliasfleitas: folds 
dfcastro.net: folds 
Uncalled bet (75) returned to ista6
ista6 collected 150 from pot
*** SUMMARY ***
Total pot 150 | Rake 0 
Seat 2: sajtos5 folded before Flop (didn't bet)
Seat 3: mitto1989 folded before Flop (didn't bet)
Seat 4: eliasfleitas (button) folded before Flop (didn't bet)
Seat 5: dfcastro.net (small blind) folded before Flop
Seat 6: ista6 (big blind) collected (150)
Seat 7: IlyaFD folded before Flop (didn't bet)
Seat 8: andedik folded before Flop (didn't bet)



PokerStars Hand #97778052550: Tournament #725058424, $0.23+$0.02 USD Hold'em No Limit - Level V (75/150) - 2013/04/27 16:31:48 BRT [2013/04/27 15:31:48 ET]
Table '725058424 1' 9-max Seat #5 is the button
Seat 2: sajtos5 (690 in chips) is sitting out
Seat 3: mitto1989 (3707 in chips) 
Seat 4: eliasfleitas (5480 in chips) 
Seat 5: dfcastro.net (2268 in chips) 
Seat 6: ista6 (1522 in chips) 
Seat 7: IlyaFD (10355 in chips) 
Seat 8: andedik (4080 in chips) 
ista6: posts small blind 75
IlyaFD: posts big blind 150
*** HOLE CARDS ***
Dealt to dfcastro.net [Th 9c]
andedik: folds 
sajtos5: folds 
mitto1989: raises 187 to 337
eliasfleitas: folds 
dfcastro.net: folds 
ista6: folds 
IlyaFD: folds 
Uncalled bet (187) returned to mitto1989
mitto1989 collected 375 from pot
mitto1989: doesn't show hand 
*** SUMMARY ***
Total pot 375 | Rake 0 
Seat 2: sajtos5 folded before Flop (didn't bet)
Seat 3: mitto1989 collected (375)
Seat 4: eliasfleitas folded before Flop (didn't bet)
Seat 5: dfcastro.net (button) folded before Flop (didn't bet)
Seat 6: ista6 (small blind) folded before Flop
Seat 7: IlyaFD (big blind) folded before Flop
Seat 8: andedik folded before Flop (didn't bet)



PokerStars Hand #97778072042: Tournament #725058424, $0.23+$0.02 USD Hold'em No Limit - Level V (75/150) - 2013/04/27 16:32:08 BRT [2013/04/27 15:32:08 ET]
Table '725058424 1' 9-max Seat #6 is the button
Seat 2: sajtos5 (690 in chips) is sitting out
Seat 3: mitto1989 (3932 in chips) 
Seat 4: eliasfleitas (5480 in chips) 
Seat 5: dfcastro.net (2268 in chips) 
Seat 6: ista6 (1447 in chips) 
Seat 7: IlyaFD (10205 in chips) 
Seat 8: andedik (4080 in chips) 
IlyaFD: posts small blind 75
andedik: posts big blind 150
*** HOLE CARDS ***
Dealt to dfcastro.net [Td 8c]
sajtos5: folds 
mitto1989: folds 
eliasfleitas: folds 
dfcastro.net: folds 
ista6: folds 
IlyaFD: calls 75
andedik: checks 
*** FLOP *** [8h Jd 2s]
IlyaFD: bets 150
andedik: folds 
Uncalled bet (150) returned to IlyaFD
IlyaFD collected 300 from pot
*** SUMMARY ***
Total pot 300 | Rake 0 
Board [8h Jd 2s]
Seat 2: sajtos5 folded before Flop (didn't bet)
Seat 3: mitto1989 folded before Flop (didn't bet)
Seat 4: eliasfleitas folded before Flop (didn't bet)
Seat 5: dfcastro.net folded before Flop (didn't bet)
Seat 6: ista6 (button) folded before Flop (didn't bet)
Seat 7: IlyaFD (small blind) collected (300)
Seat 8: andedik (big blind) folded on the Flop



PokerStars Hand #97778107794: Tournament #725058424, $0.23+$0.02 USD Hold'em No Limit - Level V (75/150) - 2013/04/27 16:32:45 BRT [2013/04/27 15:32:45 ET]
Table '725058424 1' 9-max Seat #7 is the button
Seat 2: sajtos5 (690 in chips) is sitting out
Seat 3: mitto1989 (3932 in chips) 
Seat 4: eliasfleitas (5480 in chips) 
Seat 5: dfcastro.net (2268 in chips) 
Seat 6: ista6 (1447 in chips) 
Seat 7: IlyaFD (10355 in chips) 
Seat 8: andedik (3930 in chips) 
andedik: posts small blind 75
sajtos5: posts big blind 150
*** HOLE CARDS ***
Dealt to dfcastro.net [3c Ac]
mitto1989: folds 
eliasfleitas: folds 
dfcastro.net: folds 
ista6: folds 
IlyaFD: raises 150 to 300
andedik: folds 
sajtos5: folds 
Uncalled bet (150) returned to IlyaFD
IlyaFD collected 375 from pot
*** SUMMARY ***
Total pot 375 | Rake 0 
Seat 2: sajtos5 (big blind) folded before Flop
Seat 3: mitto1989 folded before Flop (didn't bet)
Seat 4: eliasfleitas folded before Flop (didn't bet)
Seat 5: dfcastro.net folded before Flop (didn't bet)
Seat 6: ista6 folded before Flop (didn't bet)
Seat 7: IlyaFD (button) collected (375)
Seat 8: andedik (small blind) folded before Flop



PokerStars Hand #97778129582: Tournament #725058424, $0.23+$0.02 USD Hold'em No Limit - Level V (75/150) - 2013/04/27 16:33:07 BRT [2013/04/27 15:33:07 ET]
Table '725058424 1' 9-max Seat #8 is the button
Seat 2: sajtos5 (540 in chips) is sitting out
Seat 3: mitto1989 (3932 in chips) 
Seat 4: eliasfleitas (5480 in chips) 
Seat 5: dfcastro.net (2268 in chips) 
Seat 6: ista6 (1447 in chips) 
Seat 7: IlyaFD (10580 in chips) 
Seat 8: andedik (3855 in chips) 
sajtos5: posts small blind 75
mitto1989: posts big blind 150
*** HOLE CARDS ***
Dealt to dfcastro.net [4s 6d]
eliasfleitas: folds 
dfcastro.net: folds 
ista6: folds 
IlyaFD: raises 150 to 300
andedik: folds 
sajtos5: folds 
mitto1989: folds 
Uncalled bet (150) returned to IlyaFD
IlyaFD collected 375 from pot
*** SUMMARY ***
Total pot 375 | Rake 0 
Seat 2: sajtos5 (small blind) folded before Flop
Seat 3: mitto1989 (big blind) folded before Flop
Seat 4: eliasfleitas folded before Flop (didn't bet)
Seat 5: dfcastro.net folded before Flop (didn't bet)
Seat 6: ista6 folded before Flop (didn't bet)
Seat 7: IlyaFD collected (375)
Seat 8: andedik (button) folded before Flop (didn't bet)



PokerStars Hand #97778151778: Tournament #725058424, $0.23+$0.02 USD Hold'em No Limit - Level V (75/150) - 2013/04/27 16:33:30 BRT [2013/04/27 15:33:30 ET]
Table '725058424 1' 9-max Seat #2 is the button
Seat 2: sajtos5 (465 in chips) is sitting out
Seat 3: mitto1989 (3782 in chips) 
Seat 4: eliasfleitas (5480 in chips) 
Seat 5: dfcastro.net (2268 in chips) 
Seat 6: ista6 (1447 in chips) 
Seat 7: IlyaFD (10805 in chips) 
Seat 8: andedik (3855 in chips) 
mitto1989: posts small blind 75
eliasfleitas: posts big blind 150
*** HOLE CARDS ***
Dealt to dfcastro.net [Kh 4c]
dfcastro.net: folds 
ista6: folds 
IlyaFD: raises 150 to 300
andedik: folds 
sajtos5: folds 
mitto1989: folds 
eliasfleitas: calls 150
*** FLOP *** [Ac Jc Td]
eliasfleitas: bets 300
IlyaFD: calls 300
*** TURN *** [Ac Jc Td] [5c]
eliasfleitas: bets 600
IlyaFD: calls 600
*** RIVER *** [Ac Jc Td 5c] [8d]
eliasfleitas: bets 2100
IlyaFD: folds 
Uncalled bet (2100) returned to eliasfleitas
eliasfleitas collected 2475 from pot
*** SUMMARY ***
Total pot 2475 | Rake 0 
Board [Ac Jc Td 5c 8d]
Seat 2: sajtos5 (button) folded before Flop (didn't bet)
Seat 3: mitto1989 (small blind) folded before Flop
Seat 4: eliasfleitas (big blind) collected (2475)
Seat 5: dfcastro.net folded before Flop (didn't bet)
Seat 6: ista6 folded before Flop (didn't bet)
Seat 7: IlyaFD folded on the River
Seat 8: andedik folded before Flop (didn't bet)



PokerStars Hand #97778192801: Tournament #725058424, $0.23+$0.02 USD Hold'em No Limit - Level V (75/150) - 2013/04/27 16:34:12 BRT [2013/04/27 15:34:12 ET]
Table '725058424 1' 9-max Seat #3 is the button
Seat 3: mitto1989 (3707 in chips) 
Seat 4: eliasfleitas (6755 in chips) 
Seat 5: dfcastro.net (2268 in chips) 
Seat 6: ista6 (1447 in chips) 
Seat 7: IlyaFD (9605 in chips) 
Seat 8: andedik (3855 in chips) 
eliasfleitas: posts small blind 75
dfcastro.net: posts big blind 150
*** HOLE CARDS ***
Dealt to dfcastro.net [9h 6h]
ista6: folds 
IlyaFD: folds 
andedik: folds 
mitto1989: folds 
eliasfleitas: folds 
Uncalled bet (75) returned to dfcastro.net
dfcastro.net collected 150 from pot
dfcastro.net: doesn't show hand 
*** SUMMARY ***
Total pot 150 | Rake 0 
Seat 3: mitto1989 (button) folded before Flop (didn't bet)
Seat 4: eliasfleitas (small blind) folded before Flop
Seat 5: dfcastro.net (big blind) collected (150)
Seat 6: ista6 folded before Flop (didn't bet)
Seat 7: IlyaFD folded before Flop (didn't bet)
Seat 8: andedik folded before Flop (didn't bet)



PokerStars Hand #97778214941: Tournament #725058424, $0.23+$0.02 USD Hold'em No Limit - Level V (75/150) - 2013/04/27 16:34:35 BRT [2013/04/27 15:34:35 ET]
Table '725058424 1' 9-max Seat #4 is the button
Seat 3: mitto1989 (3707 in chips) 
Seat 4: eliasfleitas (6680 in chips) 
Seat 5: dfcastro.net (2343 in chips) 
Seat 6: ista6 (1447 in chips) 
Seat 7: IlyaFD (9605 in chips) 
Seat 8: andedik (3855 in chips) 
dfcastro.net: posts small blind 75
ista6: posts big blind 150
*** HOLE CARDS ***
Dealt to dfcastro.net [Ks 9s]
IlyaFD: raises 150 to 300
andedik: folds 
mitto1989: folds 
eliasfleitas: folds 
dfcastro.net: folds 
ista6: folds 
Uncalled bet (150) returned to IlyaFD
IlyaFD collected 375 from pot
*** SUMMARY ***
Total pot 375 | Rake 0 
Seat 3: mitto1989 folded before Flop (didn't bet)
Seat 4: eliasfleitas (button) folded before Flop (didn't bet)
Seat 5: dfcastro.net (small blind) folded before Flop
Seat 6: ista6 (big blind) folded before Flop
Seat 7: IlyaFD collected (375)
Seat 8: andedik folded before Flop (didn't bet)



PokerStars Hand #97778235554: Tournament #725058424, $0.23+$0.02 USD Hold'em No Limit - Level V (75/150) - 2013/04/27 16:34:57 BRT [2013/04/27 15:34:57 ET]
Table '725058424 1' 9-max Seat #5 is the button
Seat 3: mitto1989 (3707 in chips) 
Seat 4: eliasfleitas (6680 in chips) 
Seat 5: dfcastro.net (2268 in chips) 
Seat 6: ista6 (1297 in chips) 
Seat 7: IlyaFD (9830 in chips) 
Seat 8: andedik (3855 in chips) 
ista6: posts small blind 75
IlyaFD: posts big blind 150
*** HOLE CARDS ***
Dealt to dfcastro.net [5s 2h]
andedik: folds 
mitto1989: folds 
eliasfleitas: raises 300 to 450
dfcastro.net: folds 
ista6: folds 
IlyaFD: folds 
Uncalled bet (300) returned to eliasfleitas
eliasfleitas collected 375 from pot
*** SUMMARY ***
Total pot 375 | Rake 0 
Seat 3: mitto1989 folded before Flop (didn't bet)
Seat 4: eliasfleitas collected (375)
Seat 5: dfcastro.net (button) folded before Flop (didn't bet)
Seat 6: ista6 (small blind) folded before Flop
Seat 7: IlyaFD (big blind) folded before Flop
Seat 8: andedik folded before Flop (didn't bet)



PokerStars Hand #97778264626: Tournament #725058424, $0.23+$0.02 USD Hold'em No Limit - Level VI (100/200) - 2013/04/27 16:35:27 BRT [2013/04/27 15:35:27 ET]
Table '725058424 1' 9-max Seat #6 is the button
Seat 3: mitto1989 (3707 in chips) 
Seat 4: eliasfleitas (6905 in chips) 
Seat 5: dfcastro.net (2268 in chips) 
Seat 6: ista6 (1222 in chips) 
Seat 7: IlyaFD (9680 in chips) 
Seat 8: andedik (3855 in chips) 
IlyaFD: posts small blind 100
andedik: posts big blind 200
*** HOLE CARDS ***
Dealt to dfcastro.net [4c Qs]
mitto1989: folds 
eliasfleitas: folds 
dfcastro.net: folds 
ista6: folds 
IlyaFD: raises 200 to 400
andedik: calls 200
*** FLOP *** [4s Th 7h]
IlyaFD: checks 
andedik: bets 600
IlyaFD: calls 600
*** TURN *** [4s Th 7h] [5s]
IlyaFD: checks 
andedik: checks 
*** RIVER *** [4s Th 7h 5s] [Jc]
IlyaFD: checks 
andedik: bets 1000
IlyaFD: calls 1000
*** SHOW DOWN ***
andedik: shows [7d Jd] (two pair, Jacks and Sevens)
IlyaFD: mucks hand 
andedik collected 4000 from pot
*** SUMMARY ***
Total pot 4000 | Rake 0 
Board [4s Th 7h 5s Jc]
Seat 3: mitto1989 folded before Flop (didn't bet)
Seat 4: eliasfleitas folded before Flop (didn't bet)
Seat 5: dfcastro.net folded before Flop (didn't bet)
Seat 6: ista6 (button) folded before Flop (didn't bet)
Seat 7: IlyaFD (small blind) mucked [Tc Qd]
Seat 8: andedik (big blind) showed [7d Jd] and won (4000) with two pair, Jacks and Sevens



PokerStars Hand #97778311782: Tournament #725058424, $0.23+$0.02 USD Hold'em No Limit - Level VI (100/200) - 2013/04/27 16:36:15 BRT [2013/04/27 15:36:15 ET]
Table '725058424 1' 9-max Seat #7 is the button
Seat 3: mitto1989 (3707 in chips) 
Seat 4: eliasfleitas (6905 in chips) 
Seat 5: dfcastro.net (2268 in chips) 
Seat 6: ista6 (1222 in chips) 
Seat 7: IlyaFD (7680 in chips) 
Seat 8: andedik (5855 in chips) 
andedik: posts small blind 100
mitto1989: posts big blind 200
*** HOLE CARDS ***
Dealt to dfcastro.net [Qd 3s]
eliasfleitas: folds 
dfcastro.net: folds 
ista6: folds 
IlyaFD: calls 200
andedik: folds 
mitto1989: checks 
*** FLOP *** [4d 5c 2d]
mitto1989: checks 
IlyaFD: bets 200
mitto1989: folds 
Uncalled bet (200) returned to IlyaFD
IlyaFD collected 500 from pot
*** SUMMARY ***
Total pot 500 | Rake 0 
Board [4d 5c 2d]
Seat 3: mitto1989 (big blind) folded on the Flop
Seat 4: eliasfleitas folded before Flop (didn't bet)
Seat 5: dfcastro.net folded before Flop (didn't bet)
Seat 6: ista6 folded before Flop (didn't bet)
Seat 7: IlyaFD (button) collected (500)
Seat 8: andedik (small blind) folded before Flop



PokerStars Hand #97778342768: Tournament #725058424, $0.23+$0.02 USD Hold'em No Limit - Level VI (100/200) - 2013/04/27 16:36:47 BRT [2013/04/27 15:36:47 ET]
Table '725058424 1' 9-max Seat #8 is the button
Seat 3: mitto1989 (3507 in chips) 
Seat 4: eliasfleitas (6905 in chips) 
Seat 5: dfcastro.net (2268 in chips) 
Seat 6: ista6 (1222 in chips) 
Seat 7: IlyaFD (7980 in chips) 
Seat 8: andedik (5755 in chips) 
mitto1989: posts small blind 100
eliasfleitas: posts big blind 200
*** HOLE CARDS ***
Dealt to dfcastro.net [5h Jh]
dfcastro.net: folds 
ista6: folds 
IlyaFD: raises 200 to 400
andedik: folds 
mitto1989: folds 
eliasfleitas: calls 200
*** FLOP *** [3d Jd 5d]
eliasfleitas: bets 1400
IlyaFD: folds 
Uncalled bet (1400) returned to eliasfleitas
eliasfleitas collected 900 from pot
*** SUMMARY ***
Total pot 900 | Rake 0 
Board [3d Jd 5d]
Seat 3: mitto1989 (small blind) folded before Flop
Seat 4: eliasfleitas (big blind) collected (900)
Seat 5: dfcastro.net folded before Flop (didn't bet)
Seat 6: ista6 folded before Flop (didn't bet)
Seat 7: IlyaFD folded on the Flop
Seat 8: andedik (button) folded before Flop (didn't bet)



PokerStars Hand #97778371431: Tournament #725058424, $0.23+$0.02 USD Hold'em No Limit - Level VI (100/200) - 2013/04/27 16:37:17 BRT [2013/04/27 15:37:17 ET]
Table '725058424 1' 9-max Seat #3 is the button
Seat 3: mitto1989 (3407 in chips) 
Seat 4: eliasfleitas (7405 in chips) 
Seat 5: dfcastro.net (2268 in chips) 
Seat 6: ista6 (1222 in chips) 
Seat 7: IlyaFD (7580 in chips) 
Seat 8: andedik (5755 in chips) 
eliasfleitas: posts small blind 100
dfcastro.net: posts big blind 200
*** HOLE CARDS ***
Dealt to dfcastro.net [6d 7s]
ista6: folds 
IlyaFD: folds 
andedik: folds 
mitto1989: folds 
eliasfleitas: folds 
Uncalled bet (100) returned to dfcastro.net
dfcastro.net collected 200 from pot
dfcastro.net: doesn't show hand 
*** SUMMARY ***
Total pot 200 | Rake 0 
Seat 3: mitto1989 (button) folded before Flop (didn't bet)
Seat 4: eliasfleitas (small blind) folded before Flop
Seat 5: dfcastro.net (big blind) collected (200)
Seat 6: ista6 folded before Flop (didn't bet)
Seat 7: IlyaFD folded before Flop (didn't bet)
Seat 8: andedik folded before Flop (didn't bet)



PokerStars Hand #97778384056: Tournament #725058424, $0.23+$0.02 USD Hold'em No Limit - Level VI (100/200) - 2013/04/27 16:37:30 BRT [2013/04/27 15:37:30 ET]
Table '725058424 1' 9-max Seat #4 is the button
Seat 3: mitto1989 (3407 in chips) 
Seat 4: eliasfleitas (7305 in chips) 
Seat 5: dfcastro.net (2368 in chips) 
Seat 6: ista6 (1222 in chips) 
Seat 7: IlyaFD (7580 in chips) 
Seat 8: andedik (5755 in chips) 
dfcastro.net: posts small blind 100
ista6: posts big blind 200
*** HOLE CARDS ***
Dealt to dfcastro.net [Ad 7c]
IlyaFD: raises 200 to 400
andedik: folds 
mitto1989: folds 
eliasfleitas: folds 
dfcastro.net: raises 1968 to 2368 and is all-in
ista6: folds 
IlyaFD: calls 1968
*** FLOP *** [5s Js Jd]
*** TURN *** [5s Js Jd] [8c]
*** RIVER *** [5s Js Jd 8c] [3d]
*** SHOW DOWN ***
dfcastro.net: shows [Ad 7c] (a pair of Jacks)
IlyaFD: shows [Kc Qs] (a pair of Jacks - lower kicker)
dfcastro.net collected 4936 from pot
*** SUMMARY ***
Total pot 4936 | Rake 0 
Board [5s Js Jd 8c 3d]
Seat 3: mitto1989 folded before Flop (didn't bet)
Seat 4: eliasfleitas (button) folded before Flop (didn't bet)
Seat 5: dfcastro.net (small blind) showed [Ad 7c] and won (4936) with a pair of Jacks
Seat 6: ista6 (big blind) folded before Flop
Seat 7: IlyaFD showed [Kc Qs] and lost with a pair of Jacks
Seat 8: andedik folded before Flop (didn't bet)



PokerStars Hand #97778420437: Tournament #725058424, $0.23+$0.02 USD Hold'em No Limit - Level VI (100/200) - 2013/04/27 16:38:09 BRT [2013/04/27 15:38:09 ET]
Table '725058424 1' 9-max Seat #5 is the button
Seat 3: mitto1989 (3407 in chips) 
Seat 4: eliasfleitas (7305 in chips) 
Seat 5: dfcastro.net (4936 in chips) 
Seat 6: ista6 (1022 in chips) 
Seat 7: IlyaFD (5212 in chips) 
Seat 8: andedik (5755 in chips) 
ista6: posts small blind 100
IlyaFD: posts big blind 200
*** HOLE CARDS ***
Dealt to dfcastro.net [6h 2c]
andedik: folds 
mitto1989: raises 250 to 450
eliasfleitas: folds 
dfcastro.net: folds 
ista6: folds 
IlyaFD: folds 
Uncalled bet (250) returned to mitto1989
mitto1989 collected 500 from pot
mitto1989: doesn't show hand 
*** SUMMARY ***
Total pot 500 | Rake 0 
Seat 3: mitto1989 collected (500)
Seat 4: eliasfleitas folded before Flop (didn't bet)
Seat 5: dfcastro.net (button) folded before Flop (didn't bet)
Seat 6: ista6 (small blind) folded before Flop
Seat 7: IlyaFD (big blind) folded before Flop
Seat 8: andedik folded before Flop (didn't bet)



PokerStars Hand #97778437859: Tournament #725058424, $0.23+$0.02 USD Hold'em No Limit - Level VI (100/200) - 2013/04/27 16:38:27 BRT [2013/04/27 15:38:27 ET]
Table '725058424 1' 9-max Seat #6 is the button
Seat 3: mitto1989 (3707 in chips) 
Seat 4: eliasfleitas (7305 in chips) 
Seat 5: dfcastro.net (4936 in chips) 
Seat 6: ista6 (922 in chips) 
Seat 7: IlyaFD (5012 in chips) 
Seat 8: andedik (5755 in chips) 
IlyaFD: posts small blind 100
andedik: posts big blind 200
*** HOLE CARDS ***
Dealt to dfcastro.net [3s 4h]
mitto1989: raises 250 to 450
eliasfleitas: folds 
dfcastro.net: folds 
ista6: folds 
IlyaFD: folds 
andedik: folds 
Uncalled bet (250) returned to mitto1989
mitto1989 collected 500 from pot
mitto1989: doesn't show hand 
*** SUMMARY ***
Total pot 500 | Rake 0 
Seat 3: mitto1989 collected (500)
Seat 4: eliasfleitas folded before Flop (didn't bet)
Seat 5: dfcastro.net folded before Flop (didn't bet)
Seat 6: ista6 (button) folded before Flop (didn't bet)
Seat 7: IlyaFD (small blind) folded before Flop
Seat 8: andedik (big blind) folded before Flop



PokerStars Hand #97778454212: Tournament #725058424, $0.23+$0.02 USD Hold'em No Limit - Level VI (100/200) - 2013/04/27 16:38:45 BRT [2013/04/27 15:38:45 ET]
Table '725058424 1' 9-max Seat #7 is the button
Seat 3: mitto1989 (4007 in chips) 
Seat 4: eliasfleitas (7305 in chips) 
Seat 5: dfcastro.net (4936 in chips) 
Seat 6: ista6 (922 in chips) 
Seat 7: IlyaFD (4912 in chips) 
Seat 8: andedik (5555 in chips) 
andedik: posts small blind 100
mitto1989: posts big blind 200
*** HOLE CARDS ***
Dealt to dfcastro.net [Qs 5h]
eliasfleitas: folds 
dfcastro.net: folds 
ista6: folds 
IlyaFD: raises 200 to 400
andedik: folds 
mitto1989: calls 200
*** FLOP *** [5d Kc 8s]
mitto1989: checks 
IlyaFD: bets 200
mitto1989: raises 429 to 629
IlyaFD: calls 429
*** TURN *** [5d Kc 8s] [As]
mitto1989: bets 712
IlyaFD: calls 712
*** RIVER *** [5d Kc 8s As] [4h]
mitto1989: checks 
IlyaFD: checks 
*** SHOW DOWN ***
mitto1989: shows [Kd Qc] (a pair of Kings)
IlyaFD: shows [5c Ks] (two pair, Kings and Fives)
IlyaFD collected 3582 from pot
*** SUMMARY ***
Total pot 3582 | Rake 0 
Board [5d Kc 8s As 4h]
Seat 3: mitto1989 (big blind) showed [Kd Qc] and lost with a pair of Kings
Seat 4: eliasfleitas folded before Flop (didn't bet)
Seat 5: dfcastro.net folded before Flop (didn't bet)
Seat 6: ista6 folded before Flop (didn't bet)
Seat 7: IlyaFD (button) showed [5c Ks] and won (3582) with two pair, Kings and Fives
Seat 8: andedik (small blind) folded before Flop



PokerStars Hand #97778499811: Tournament #725058424, $0.23+$0.02 USD Hold'em No Limit - Level VI (100/200) - 2013/04/27 16:39:33 BRT [2013/04/27 15:39:33 ET]
Table '725058424 1' 9-max Seat #8 is the button
Seat 3: mitto1989 (2266 in chips) 
Seat 5: dfcastro.net (4936 in chips) 
Seat 6: ista6 (922 in chips) 
Seat 7: IlyaFD (6753 in chips) 
Seat 8: andedik (5455 in chips) 
mitto1989: posts small blind 100
dfcastro.net: posts big blind 200
*** HOLE CARDS ***
Dealt to dfcastro.net [3h 2c]
ista6: folds 
IlyaFD: folds 
andedik: folds 
mitto1989: folds 
Uncalled bet (100) returned to dfcastro.net
dfcastro.net collected 200 from pot
dfcastro.net: doesn't show hand 
*** SUMMARY ***
Total pot 200 | Rake 0 
Seat 3: mitto1989 (small blind) folded before Flop
Seat 5: dfcastro.net (big blind) collected (200)
Seat 6: ista6 folded before Flop (didn't bet)
Seat 7: IlyaFD folded before Flop (didn't bet)
Seat 8: andedik (button) folded before Flop (didn't bet)



PokerStars Hand #97778510963: Tournament #725058424, $0.23+$0.02 USD Hold'em No Limit - Level VI (100/200) - 2013/04/27 16:39:45 BRT [2013/04/27 15:39:45 ET]
Table '725058424 1' 9-max Seat #3 is the button
Seat 3: mitto1989 (2166 in chips) 
Seat 5: dfcastro.net (5036 in chips) 
Seat 6: ista6 (922 in chips) 
Seat 7: IlyaFD (6753 in chips) 
Seat 8: andedik (5455 in chips) 
dfcastro.net: posts small blind 100
ista6: posts big blind 200
*** HOLE CARDS ***
Dealt to dfcastro.net [Jh 3d]
IlyaFD: raises 200 to 400
andedik: folds 
mitto1989: folds 
dfcastro.net: folds 
ista6: folds 
Uncalled bet (200) returned to IlyaFD
IlyaFD collected 500 from pot
*** SUMMARY ***
Total pot 500 | Rake 0 
Seat 3: mitto1989 (button) folded before Flop (didn't bet)
Seat 5: dfcastro.net (small blind) folded before Flop
Seat 6: ista6 (big blind) folded before Flop
Seat 7: IlyaFD collected (500)
Seat 8: andedik folded before Flop (didn't bet)



PokerStars Hand #97778530313: Tournament #725058424, $0.23+$0.02 USD Hold'em No Limit - Level VI (100/200) - 2013/04/27 16:40:06 BRT [2013/04/27 15:40:06 ET]
Table '725058424 1' 9-max Seat #5 is the button
Seat 3: mitto1989 (2166 in chips) 
Seat 5: dfcastro.net (4936 in chips) 
Seat 6: ista6 (722 in chips) 
Seat 7: IlyaFD (7053 in chips) 
Seat 8: andedik (5455 in chips) 
ista6: posts small blind 100
IlyaFD: posts big blind 200
*** HOLE CARDS ***
Dealt to dfcastro.net [8c Qs]
andedik: raises 400 to 600
mitto1989: folds 
dfcastro.net: folds 
ista6: folds 
IlyaFD: calls 400
*** FLOP *** [4c 6h Ah]
IlyaFD: checks 
andedik: bets 600
IlyaFD: raises 600 to 1200
andedik: raises 3655 to 4855 and is all-in
IlyaFD: folds 
Uncalled bet (3655) returned to andedik
andedik collected 3700 from pot
andedik: doesn't show hand 
*** SUMMARY ***
Total pot 3700 | Rake 0 
Board [4c 6h Ah]
Seat 3: mitto1989 folded before Flop (didn't bet)
Seat 5: dfcastro.net (button) folded before Flop (didn't bet)
Seat 6: ista6 (small blind) folded before Flop
Seat 7: IlyaFD (big blind) folded on the Flop
Seat 8: andedik collected (3700)



PokerStars Hand #97778555890: Tournament #725058424, $0.23+$0.02 USD Hold'em No Limit - Level VI (100/200) - 2013/04/27 16:40:33 BRT [2013/04/27 15:40:33 ET]
Table '725058424 1' 9-max Seat #6 is the button
Seat 3: mitto1989 (2166 in chips) 
Seat 5: dfcastro.net (4936 in chips) 
Seat 6: ista6 (622 in chips) 
Seat 7: IlyaFD (5253 in chips) 
Seat 8: andedik (7355 in chips) 
IlyaFD: posts small blind 100
andedik: posts big blind 200
*** HOLE CARDS ***
Dealt to dfcastro.net [4s Qc]
mitto1989: folds 
dfcastro.net: folds 
ista6: raises 422 to 622 and is all-in
IlyaFD: calls 522
andedik: folds 
*** FLOP *** [5h Qh 6c]
*** TURN *** [5h Qh 6c] [4c]
*** RIVER *** [5h Qh 6c 4c] [As]
*** SHOW DOWN ***
IlyaFD: shows [3s Ah] (a pair of Aces)
ista6: shows [3c Ac] (a pair of Aces)
IlyaFD collected 722 from pot
ista6 collected 722 from pot
*** SUMMARY ***
Total pot 1444 | Rake 0 
Board [5h Qh 6c 4c As]
Seat 3: mitto1989 folded before Flop (didn't bet)
Seat 5: dfcastro.net folded before Flop (didn't bet)
Seat 6: ista6 (button) showed [3c Ac] and won (722) with a pair of Aces
Seat 7: IlyaFD (small blind) showed [3s Ah] and won (722) with a pair of Aces
Seat 8: andedik (big blind) folded before Flop



PokerStars Hand #97778579231: Tournament #725058424, $0.23+$0.02 USD Hold'em No Limit - Level VI (100/200) - 2013/04/27 16:40:58 BRT [2013/04/27 15:40:58 ET]
Table '725058424 1' 9-max Seat #7 is the button
Seat 3: mitto1989 (2166 in chips) 
Seat 5: dfcastro.net (4936 in chips) 
Seat 6: ista6 (722 in chips) 
Seat 7: IlyaFD (5353 in chips) 
Seat 8: andedik (7155 in chips) 
andedik: posts small blind 100
mitto1989: posts big blind 200
*** HOLE CARDS ***
Dealt to dfcastro.net [2h 9h]
dfcastro.net: folds 
ista6: folds 
IlyaFD: raises 200 to 400
andedik: folds 
mitto1989: folds 
Uncalled bet (200) returned to IlyaFD
IlyaFD collected 500 from pot
*** SUMMARY ***
Total pot 500 | Rake 0 
Seat 3: mitto1989 (big blind) folded before Flop
Seat 5: dfcastro.net folded before Flop (didn't bet)
Seat 6: ista6 folded before Flop (didn't bet)
Seat 7: IlyaFD (button) collected (500)
Seat 8: andedik (small blind) folded before Flop



PokerStars Hand #97778591754: Tournament #725058424, $0.23+$0.02 USD Hold'em No Limit - Level VI (100/200) - 2013/04/27 16:41:11 BRT [2013/04/27 15:41:11 ET]
Table '725058424 1' 9-max Seat #8 is the button
Seat 3: mitto1989 (1966 in chips) 
Seat 5: dfcastro.net (4936 in chips) 
Seat 6: ista6 (722 in chips) 
Seat 7: IlyaFD (5653 in chips) 
Seat 8: andedik (7055 in chips) 
mitto1989: posts small blind 100
dfcastro.net: posts big blind 200
*** HOLE CARDS ***
Dealt to dfcastro.net [2s 3s]
ista6: raises 522 to 722 and is all-in
IlyaFD has timed out
IlyaFD: folds 
IlyaFD is sitting out
IlyaFD has returned
andedik: folds 
mitto1989: raises 1244 to 1966 and is all-in
dfcastro.net: folds 
Uncalled bet (1244) returned to mitto1989
*** FLOP *** [5c Ks 4h]
*** TURN *** [5c Ks 4h] [9c]
*** RIVER *** [5c Ks 4h 9c] [4s]
*** SHOW DOWN ***
mitto1989: shows [Th Qd] (a pair of Fours)
ista6: shows [Js Qc] (a pair of Fours - King+Queen+Jack kicker)
ista6 collected 1644 from pot
*** SUMMARY ***
Total pot 1644 | Rake 0 
Board [5c Ks 4h 9c 4s]
Seat 3: mitto1989 (small blind) showed [Th Qd] and lost with a pair of Fours
Seat 5: dfcastro.net (big blind) folded before Flop
Seat 6: ista6 showed [Js Qc] and won (1644) with a pair of Fours
Seat 7: IlyaFD folded before Flop (didn't bet)
Seat 8: andedik (button) folded before Flop (didn't bet)



PokerStars Hand #97778633613: Tournament #725058424, $0.23+$0.02 USD Hold'em No Limit - Level VI (100/200) - 2013/04/27 16:41:56 BRT [2013/04/27 15:41:56 ET]
Table '725058424 1' 9-max Seat #3 is the button
Seat 3: mitto1989 (1244 in chips) 
Seat 5: dfcastro.net (4736 in chips) 
Seat 6: ista6 (1644 in chips) 
Seat 7: IlyaFD (5653 in chips) 
Seat 8: andedik (7055 in chips) 
dfcastro.net: posts small blind 100
ista6: posts big blind 200
*** HOLE CARDS ***
Dealt to dfcastro.net [8d Qh]
IlyaFD: raises 200 to 400
andedik: folds 
mitto1989: folds 
dfcastro.net: folds 
ista6: folds 
Uncalled bet (200) returned to IlyaFD
IlyaFD collected 500 from pot
*** SUMMARY ***
Total pot 500 | Rake 0 
Seat 3: mitto1989 (button) folded before Flop (didn't bet)
Seat 5: dfcastro.net (small blind) folded before Flop
Seat 6: ista6 (big blind) folded before Flop
Seat 7: IlyaFD collected (500)
Seat 8: andedik folded before Flop (didn't bet)



PokerStars Hand #97778646205: Tournament #725058424, $0.23+$0.02 USD Hold'em No Limit - Level VI (100/200) - 2013/04/27 16:42:10 BRT [2013/04/27 15:42:10 ET]
Table '725058424 1' 9-max Seat #5 is the button
Seat 3: mitto1989 (1244 in chips) 
Seat 5: dfcastro.net (4636 in chips) 
Seat 6: ista6 (1444 in chips) 
Seat 7: IlyaFD (5953 in chips) 
Seat 8: andedik (7055 in chips) 
ista6: posts small blind 100
IlyaFD: posts big blind 200
*** HOLE CARDS ***
Dealt to dfcastro.net [6h 7d]
andedik: folds 
mitto1989: folds 
dfcastro.net: folds 
ista6: folds 
Uncalled bet (100) returned to IlyaFD
IlyaFD collected 200 from pot
*** SUMMARY ***
Total pot 200 | Rake 0 
Seat 3: mitto1989 folded before Flop (didn't bet)
Seat 5: dfcastro.net (button) folded before Flop (didn't bet)
Seat 6: ista6 (small blind) folded before Flop
Seat 7: IlyaFD (big blind) collected (200)
Seat 8: andedik folded before Flop (didn't bet)



PokerStars Hand #97778660754: Tournament #725058424, $0.23+$0.02 USD Hold'em No Limit - Level VI (100/200) - 2013/04/27 16:42:26 BRT [2013/04/27 15:42:26 ET]
Table '725058424 1' 9-max Seat #6 is the button
Seat 3: mitto1989 (1244 in chips) 
Seat 5: dfcastro.net (4636 in chips) 
Seat 6: ista6 (1344 in chips) 
Seat 7: IlyaFD (6053 in chips) 
Seat 8: andedik (7055 in chips) 
IlyaFD: posts small blind 100
andedik: posts big blind 200
*** HOLE CARDS ***
Dealt to dfcastro.net [Kd Jd]
mitto1989: folds 
dfcastro.net: folds 
ista6: folds 
IlyaFD: folds 
Uncalled bet (100) returned to andedik
andedik collected 200 from pot
andedik: doesn't show hand 
*** SUMMARY ***
Total pot 200 | Rake 0 
Seat 3: mitto1989 folded before Flop (didn't bet)
Seat 5: dfcastro.net folded before Flop (didn't bet)
Seat 6: ista6 (button) folded before Flop (didn't bet)
Seat 7: IlyaFD (small blind) folded before Flop
Seat 8: andedik (big blind) collected (200)



PokerStars Hand #97778683031: Tournament #725058424, $0.23+$0.02 USD Hold'em No Limit - Level VI (100/200) - 2013/04/27 16:42:50 BRT [2013/04/27 15:42:50 ET]
Table '725058424 1' 9-max Seat #7 is the button
Seat 3: mitto1989 (1244 in chips) 
Seat 5: dfcastro.net (4636 in chips) 
Seat 6: ista6 (1344 in chips) 
Seat 7: IlyaFD (5953 in chips) 
Seat 8: andedik (7155 in chips) 
andedik: posts small blind 100
mitto1989: posts big blind 200
*** HOLE CARDS ***
Dealt to dfcastro.net [7c Qs]
dfcastro.net: folds 
ista6: raises 1144 to 1344 and is all-in
IlyaFD: folds 
andedik: folds 
mitto1989: folds 
Uncalled bet (1144) returned to ista6
ista6 collected 500 from pot
*** SUMMARY ***
Total pot 500 | Rake 0 
Seat 3: mitto1989 (big blind) folded before Flop
Seat 5: dfcastro.net folded before Flop (didn't bet)
Seat 6: ista6 collected (500)
Seat 7: IlyaFD (button) folded before Flop (didn't bet)
Seat 8: andedik (small blind) folded before Flop



PokerStars Hand #97778709243: Tournament #725058424, $0.23+$0.02 USD Hold'em No Limit - Level VI (100/200) - 2013/04/27 16:43:18 BRT [2013/04/27 15:43:18 ET]
Table '725058424 1' 9-max Seat #8 is the button
Seat 3: mitto1989 (1044 in chips) 
Seat 5: dfcastro.net (4636 in chips) 
Seat 6: ista6 (1644 in chips) 
Seat 7: IlyaFD (5953 in chips) 
Seat 8: andedik (7055 in chips) 
mitto1989: posts small blind 100
dfcastro.net: posts big blind 200
*** HOLE CARDS ***
Dealt to dfcastro.net [3c Ac]
ista6: folds 
IlyaFD: raises 200 to 400
andedik: folds 
mitto1989: raises 644 to 1044 and is all-in
dfcastro.net: folds 
IlyaFD: calls 644
*** FLOP *** [9d 9s Qs]
*** TURN *** [9d 9s Qs] [Kc]
*** RIVER *** [9d 9s Qs Kc] [8h]
*** SHOW DOWN ***
mitto1989: shows [8c Js] (two pair, Nines and Eights)
IlyaFD: shows [Ah 4h] (a pair of Nines)
mitto1989 collected 2288 from pot
*** SUMMARY ***
Total pot 2288 | Rake 0 
Board [9d 9s Qs Kc 8h]
Seat 3: mitto1989 (small blind) showed [8c Js] and won (2288) with two pair, Nines and Eights
Seat 5: dfcastro.net (big blind) folded before Flop
Seat 6: ista6 folded before Flop (didn't bet)
Seat 7: IlyaFD showed [Ah 4h] and lost with a pair of Nines
Seat 8: andedik (button) folded before Flop (didn't bet)



PokerStars Hand #97778730731: Tournament #725058424, $0.23+$0.02 USD Hold'em No Limit - Level VI (100/200) - 2013/04/27 16:43:41 BRT [2013/04/27 15:43:41 ET]
Table '725058424 1' 9-max Seat #3 is the button
Seat 3: mitto1989 (2288 in chips) 
Seat 5: dfcastro.net (4436 in chips) 
Seat 6: ista6 (1644 in chips) 
Seat 7: IlyaFD (4909 in chips) 
Seat 8: andedik (7055 in chips) 
dfcastro.net: posts small blind 100
ista6: posts big blind 200
*** HOLE CARDS ***
Dealt to dfcastro.net [4h 5h]
IlyaFD: folds 
andedik: folds 
mitto1989: folds 
dfcastro.net: folds 
Uncalled bet (100) returned to ista6
ista6 collected 200 from pot
*** SUMMARY ***
Total pot 200 | Rake 0 
Seat 3: mitto1989 (button) folded before Flop (didn't bet)
Seat 5: dfcastro.net (small blind) folded before Flop
Seat 6: ista6 (big blind) collected (200)
Seat 7: IlyaFD folded before Flop (didn't bet)
Seat 8: andedik folded before Flop (didn't bet)



PokerStars Hand #97778743235: Tournament #725058424, $0.23+$0.02 USD Hold'em No Limit - Level VI (100/200) - 2013/04/27 16:43:55 BRT [2013/04/27 15:43:55 ET]
Table '725058424 1' 9-max Seat #5 is the button
Seat 3: mitto1989 (2288 in chips) 
Seat 5: dfcastro.net (4336 in chips) 
Seat 6: ista6 (1744 in chips) 
Seat 7: IlyaFD (4909 in chips) 
Seat 8: andedik (7055 in chips) 
ista6: posts small blind 100
IlyaFD: posts big blind 200
*** HOLE CARDS ***
Dealt to dfcastro.net [4d 7d]
andedik: folds 
mitto1989: raises 2088 to 2288 and is all-in
dfcastro.net: folds 
ista6: folds 
IlyaFD: folds 
Uncalled bet (2088) returned to mitto1989
mitto1989 collected 500 from pot
mitto1989: doesn't show hand 
*** SUMMARY ***
Total pot 500 | Rake 0 
Seat 3: mitto1989 collected (500)
Seat 5: dfcastro.net (button) folded before Flop (didn't bet)
Seat 6: ista6 (small blind) folded before Flop
Seat 7: IlyaFD (big blind) folded before Flop
Seat 8: andedik folded before Flop (didn't bet)



PokerStars Hand #97778754858: Tournament #725058424, $0.23+$0.02 USD Hold'em No Limit - Level VI (100/200) - 2013/04/27 16:44:07 BRT [2013/04/27 15:44:07 ET]
Table '725058424 1' 9-max Seat #6 is the button
Seat 3: mitto1989 (2588 in chips) 
Seat 5: dfcastro.net (4336 in chips) 
Seat 6: ista6 (1644 in chips) 
Seat 7: IlyaFD (4709 in chips) 
Seat 8: andedik (7055 in chips) 
IlyaFD: posts small blind 100
andedik: posts big blind 200
*** HOLE CARDS ***
Dealt to dfcastro.net [8s Kd]
mitto1989: folds 
dfcastro.net: folds 
ista6: raises 1444 to 1644 and is all-in
IlyaFD: folds 
andedik: folds 
Uncalled bet (1444) returned to ista6
ista6 collected 500 from pot
*** SUMMARY ***
Total pot 500 | Rake 0 
Seat 3: mitto1989 folded before Flop (didn't bet)
Seat 5: dfcastro.net folded before Flop (didn't bet)
Seat 6: ista6 (button) collected (500)
Seat 7: IlyaFD (small blind) folded before Flop
Seat 8: andedik (big blind) folded before Flop



PokerStars Hand #97778769785: Tournament #725058424, $0.23+$0.02 USD Hold'em No Limit - Level VI (100/200) - 2013/04/27 16:44:23 BRT [2013/04/27 15:44:23 ET]
Table '725058424 1' 9-max Seat #7 is the button
Seat 3: mitto1989 (2588 in chips) 
Seat 5: dfcastro.net (4336 in chips) 
Seat 6: ista6 (1944 in chips) 
Seat 7: IlyaFD (4609 in chips) 
Seat 8: andedik (6855 in chips) 
andedik: posts small blind 100
mitto1989: posts big blind 200
*** HOLE CARDS ***
Dealt to dfcastro.net [Th Ac]
dfcastro.net: raises 4136 to 4336 and is all-in
ista6: folds 
IlyaFD: folds 
andedik: folds 
mitto1989: folds 
Uncalled bet (4136) returned to dfcastro.net
dfcastro.net collected 500 from pot
dfcastro.net: doesn't show hand 
*** SUMMARY ***
Total pot 500 | Rake 0 
Seat 3: mitto1989 (big blind) folded before Flop
Seat 5: dfcastro.net collected (500)
Seat 6: ista6 folded before Flop (didn't bet)
Seat 7: IlyaFD (button) folded before Flop (didn't bet)
Seat 8: andedik (small blind) folded before Flop



PokerStars Hand #97778788537: Tournament #725058424, $0.23+$0.02 USD Hold'em No Limit - Level VI (100/200) - 2013/04/27 16:44:43 BRT [2013/04/27 15:44:43 ET]
Table '725058424 1' 9-max Seat #8 is the button
Seat 3: mitto1989 (2388 in chips) 
Seat 5: dfcastro.net (4636 in chips) 
Seat 6: ista6 (1944 in chips) 
Seat 7: IlyaFD (4609 in chips) 
Seat 8: andedik (6755 in chips) 
mitto1989: posts small blind 100
dfcastro.net: posts big blind 200
*** HOLE CARDS ***
Dealt to dfcastro.net [3c 9c]
ista6: folds 
IlyaFD: folds 
andedik: folds 
mitto1989: raises 2188 to 2388 and is all-in
dfcastro.net: folds 
Uncalled bet (2188) returned to mitto1989
mitto1989 collected 400 from pot
mitto1989: doesn't show hand 
*** SUMMARY ***
Total pot 400 | Rake 0 
Seat 3: mitto1989 (small blind) collected (400)
Seat 5: dfcastro.net (big blind) folded before Flop
Seat 6: ista6 folded before Flop (didn't bet)
Seat 7: IlyaFD folded before Flop (didn't bet)
Seat 8: andedik (button) folded before Flop (didn't bet)



PokerStars Hand #97778801608: Tournament #725058424, $0.23+$0.02 USD Hold'em No Limit - Level VI (100/200) - 2013/04/27 16:44:57 BRT [2013/04/27 15:44:57 ET]
Table '725058424 1' 9-max Seat #3 is the button
Seat 3: mitto1989 (2588 in chips) 
Seat 5: dfcastro.net (4436 in chips) 
Seat 6: ista6 (1944 in chips) 
Seat 7: IlyaFD (4609 in chips) 
Seat 8: andedik (6755 in chips) 
dfcastro.net: posts small blind 100
ista6: posts big blind 200
*** HOLE CARDS ***
Dealt to dfcastro.net [Qs 3d]
IlyaFD: folds 
andedik: raises 400 to 600
mitto1989: raises 1988 to 2588 and is all-in
dfcastro.net: folds 
ista6: folds 
andedik: calls 1988
*** FLOP *** [6d Jd 6h]
*** TURN *** [6d Jd 6h] [8h]
*** RIVER *** [6d Jd 6h 8h] [Ac]
*** SHOW DOWN ***
andedik: shows [Ks Kc] (two pair, Kings and Sixes)
mitto1989: shows [Qd As] (two pair, Aces and Sixes)
mitto1989 collected 5476 from pot
*** SUMMARY ***
Total pot 5476 | Rake 0 
Board [6d Jd 6h 8h Ac]
Seat 3: mitto1989 (button) showed [Qd As] and won (5476) with two pair, Aces and Sixes
Seat 5: dfcastro.net (small blind) folded before Flop
Seat 6: ista6 (big blind) folded before Flop
Seat 7: IlyaFD folded before Flop (didn't bet)
Seat 8: andedik showed [Ks Kc] and lost with two pair, Kings and Sixes



PokerStars Hand #97778827472: Tournament #725058424, $0.23+$0.02 USD Hold'em No Limit - Level VII (100/200) - 2013/04/27 16:45:24 BRT [2013/04/27 15:45:24 ET]
Table '725058424 1' 9-max Seat #5 is the button
Seat 3: mitto1989 (5476 in chips) 
Seat 5: dfcastro.net (4336 in chips) 
Seat 6: ista6 (1744 in chips) 
Seat 7: IlyaFD (4609 in chips) 
Seat 8: andedik (4167 in chips) 
mitto1989: posts the ante 25
dfcastro.net: posts the ante 25
ista6: posts the ante 25
IlyaFD: posts the ante 25
andedik: posts the ante 25
ista6: posts small blind 100
IlyaFD: posts big blind 200
*** HOLE CARDS ***
Dealt to dfcastro.net [6c Jd]
andedik: folds 
mitto1989: folds 
dfcastro.net: folds 
ista6: raises 268 to 468
IlyaFD: calls 268
*** FLOP *** [9d Th Qs]
ista6: bets 1251 and is all-in
IlyaFD: folds 
Uncalled bet (1251) returned to ista6
ista6 collected 1061 from pot
*** SUMMARY ***
Total pot 1061 | Rake 0 
Board [9d Th Qs]
Seat 3: mitto1989 folded before Flop (didn't bet)
Seat 5: dfcastro.net (button) folded before Flop (didn't bet)
Seat 6: ista6 (small blind) collected (1061)
Seat 7: IlyaFD (big blind) folded on the Flop
Seat 8: andedik folded before Flop (didn't bet)



PokerStars Hand #97778861675: Tournament #725058424, $0.23+$0.02 USD Hold'em No Limit - Level VII (100/200) - 2013/04/27 16:46:01 BRT [2013/04/27 15:46:01 ET]
Table '725058424 1' 9-max Seat #6 is the button
Seat 3: mitto1989 (5451 in chips) 
Seat 5: dfcastro.net (4311 in chips) 
Seat 6: ista6 (2312 in chips) 
Seat 7: IlyaFD (4116 in chips) 
Seat 8: andedik (4142 in chips) 
mitto1989: posts the ante 25
dfcastro.net: posts the ante 25
ista6: posts the ante 25
IlyaFD: posts the ante 25
andedik: posts the ante 25
IlyaFD: posts small blind 100
andedik: posts big blind 200
*** HOLE CARDS ***
Dealt to dfcastro.net [Ks 3s]
mitto1989: folds 
dfcastro.net: folds 
ista6: folds 
IlyaFD: calls 100
andedik: checks 
*** FLOP *** [Kh 7d 8s]
IlyaFD: bets 200
andedik: raises 200 to 400
IlyaFD: calls 200
*** TURN *** [Kh 7d 8s] [Ts]
IlyaFD: checks 
andedik: bets 600
IlyaFD: folds 
Uncalled bet (600) returned to andedik
andedik collected 1325 from pot
andedik: doesn't show hand 
*** SUMMARY ***
Total pot 1325 | Rake 0 
Board [Kh 7d 8s Ts]
Seat 3: mitto1989 folded before Flop (didn't bet)
Seat 5: dfcastro.net folded before Flop (didn't bet)
Seat 6: ista6 (button) folded before Flop (didn't bet)
Seat 7: IlyaFD (small blind) folded on the Turn
Seat 8: andedik (big blind) collected (1325)



PokerStars Hand #97778912413: Tournament #725058424, $0.23+$0.02 USD Hold'em No Limit - Level VII (100/200) - 2013/04/27 16:46:55 BRT [2013/04/27 15:46:55 ET]
Table '725058424 1' 9-max Seat #7 is the button
Seat 3: mitto1989 (5426 in chips) 
Seat 5: dfcastro.net (4286 in chips) 
Seat 6: ista6 (2287 in chips) 
Seat 7: IlyaFD (3491 in chips) 
Seat 8: andedik (4842 in chips) 
mitto1989: posts the ante 25
dfcastro.net: posts the ante 25
ista6: posts the ante 25
IlyaFD: posts the ante 25
andedik: posts the ante 25
andedik: posts small blind 100
mitto1989: posts big blind 200
*** HOLE CARDS ***
Dealt to dfcastro.net [Ac 3h]
dfcastro.net: folds 
ista6: folds 
IlyaFD: folds 
andedik: folds 
Uncalled bet (100) returned to mitto1989
mitto1989 collected 325 from pot
mitto1989: doesn't show hand 
*** SUMMARY ***
Total pot 325 | Rake 0 
Seat 3: mitto1989 (big blind) collected (325)
Seat 5: dfcastro.net folded before Flop (didn't bet)
Seat 6: ista6 folded before Flop (didn't bet)
Seat 7: IlyaFD (button) folded before Flop (didn't bet)
Seat 8: andedik (small blind) folded before Flop



PokerStars Hand #97778923490: Tournament #725058424, $0.23+$0.02 USD Hold'em No Limit - Level VII (100/200) - 2013/04/27 16:47:06 BRT [2013/04/27 15:47:06 ET]
Table '725058424 1' 9-max Seat #8 is the button
Seat 3: mitto1989 (5626 in chips) 
Seat 5: dfcastro.net (4261 in chips) 
Seat 6: ista6 (2262 in chips) 
Seat 7: IlyaFD (3466 in chips) 
Seat 8: andedik (4717 in chips) 
mitto1989: posts the ante 25
dfcastro.net: posts the ante 25
ista6: posts the ante 25
IlyaFD: posts the ante 25
andedik: posts the ante 25
mitto1989: posts small blind 100
dfcastro.net: posts big blind 200
*** HOLE CARDS ***
Dealt to dfcastro.net [9c 2h]
ista6: folds 
IlyaFD: calls 200
andedik: raises 600 to 800
mitto1989: folds 
dfcastro.net: folds 
IlyaFD: folds 
Uncalled bet (600) returned to andedik
andedik collected 825 from pot
andedik: doesn't show hand 
*** SUMMARY ***
Total pot 825 | Rake 0 
Seat 3: mitto1989 (small blind) folded before Flop
Seat 5: dfcastro.net (big blind) folded before Flop
Seat 6: ista6 folded before Flop (didn't bet)
Seat 7: IlyaFD folded before Flop
Seat 8: andedik (button) collected (825)



PokerStars Hand #97778954934: Tournament #725058424, $0.23+$0.02 USD Hold'em No Limit - Level VII (100/200) - 2013/04/27 16:47:40 BRT [2013/04/27 15:47:40 ET]
Table '725058424 1' 9-max Seat #3 is the button
Seat 3: mitto1989 (5501 in chips) 
Seat 5: dfcastro.net (4036 in chips) 
Seat 6: ista6 (2237 in chips) 
Seat 7: IlyaFD (3241 in chips) 
Seat 8: andedik (5317 in chips) 
mitto1989: posts the ante 25
dfcastro.net: posts the ante 25
ista6: posts the ante 25
IlyaFD: posts the ante 25
andedik: posts the ante 25
dfcastro.net: posts small blind 100
ista6: posts big blind 200
*** HOLE CARDS ***
Dealt to dfcastro.net [4s 8h]
IlyaFD: folds 
andedik: folds 
mitto1989: folds 
dfcastro.net: folds 
Uncalled bet (100) returned to ista6
ista6 collected 325 from pot
*** SUMMARY ***
Total pot 325 | Rake 0 
Seat 3: mitto1989 (button) folded before Flop (didn't bet)
Seat 5: dfcastro.net (small blind) folded before Flop
Seat 6: ista6 (big blind) collected (325)
Seat 7: IlyaFD folded before Flop (didn't bet)
Seat 8: andedik folded before Flop (didn't bet)



PokerStars Hand #97778975087: Tournament #725058424, $0.23+$0.02 USD Hold'em No Limit - Level VII (100/200) - 2013/04/27 16:48:02 BRT [2013/04/27 15:48:02 ET]
Table '725058424 1' 9-max Seat #5 is the button
Seat 3: mitto1989 (5476 in chips) 
Seat 5: dfcastro.net (3911 in chips) 
Seat 6: ista6 (2437 in chips) 
Seat 7: IlyaFD (3216 in chips) 
Seat 8: andedik (5292 in chips) 
mitto1989: posts the ante 25
dfcastro.net: posts the ante 25
ista6: posts the ante 25
IlyaFD: posts the ante 25
andedik: posts the ante 25
ista6: posts small blind 100
IlyaFD: posts big blind 200
*** HOLE CARDS ***
Dealt to dfcastro.net [5c 6h]
andedik: calls 200
mitto1989: folds 
dfcastro.net: folds 
ista6: folds 
IlyaFD: checks 
*** FLOP *** [5h Kd 2s]
IlyaFD: checks 
andedik: checks 
*** TURN *** [5h Kd 2s] [Ah]
IlyaFD: checks 
andedik: checks 
*** RIVER *** [5h Kd 2s Ah] [Js]
IlyaFD: checks 
andedik: bets 200
IlyaFD: folds 
Uncalled bet (200) returned to andedik
andedik collected 625 from pot
andedik: doesn't show hand 
*** SUMMARY ***
Total pot 625 | Rake 0 
Board [5h Kd 2s Ah Js]
Seat 3: mitto1989 folded before Flop (didn't bet)
Seat 5: dfcastro.net (button) folded before Flop (didn't bet)
Seat 6: ista6 (small blind) folded before Flop
Seat 7: IlyaFD (big blind) folded on the River
Seat 8: andedik collected (625)



PokerStars Hand #97779007748: Tournament #725058424, $0.23+$0.02 USD Hold'em No Limit - Level VII (100/200) - 2013/04/27 16:48:37 BRT [2013/04/27 15:48:37 ET]
Table '725058424 1' 9-max Seat #6 is the button
Seat 3: mitto1989 (5451 in chips) 
Seat 5: dfcastro.net (3886 in chips) 
Seat 6: ista6 (2312 in chips) 
Seat 7: IlyaFD (2991 in chips) 
Seat 8: andedik (5692 in chips) 
mitto1989: posts the ante 25
dfcastro.net: posts the ante 25
ista6: posts the ante 25
IlyaFD: posts the ante 25
andedik: posts the ante 25
IlyaFD: posts small blind 100
andedik: posts big blind 200
*** HOLE CARDS ***
Dealt to dfcastro.net [Ts 5c]
mitto1989: folds 
dfcastro.net: folds 
ista6: folds 
IlyaFD: folds 
Uncalled bet (100) returned to andedik
andedik collected 325 from pot
andedik: doesn't show hand 
*** SUMMARY ***
Total pot 325 | Rake 0 
Seat 3: mitto1989 folded before Flop (didn't bet)
Seat 5: dfcastro.net folded before Flop (didn't bet)
Seat 6: ista6 (button) folded before Flop (didn't bet)
Seat 7: IlyaFD (small blind) folded before Flop
Seat 8: andedik (big blind) collected (325)



PokerStars Hand #97779034886: Tournament #725058424, $0.23+$0.02 USD Hold'em No Limit - Level VII (100/200) - 2013/04/27 16:49:06 BRT [2013/04/27 15:49:06 ET]
Table '725058424 1' 9-max Seat #7 is the button
Seat 3: mitto1989 (5426 in chips) 
Seat 5: dfcastro.net (3861 in chips) 
Seat 6: ista6 (2287 in chips) 
Seat 7: IlyaFD (2866 in chips) 
Seat 8: andedik (5892 in chips) 
mitto1989: posts the ante 25
dfcastro.net: posts the ante 25
ista6: posts the ante 25
IlyaFD: posts the ante 25
andedik: posts the ante 25
andedik: posts small blind 100
mitto1989: posts big blind 200
*** HOLE CARDS ***
Dealt to dfcastro.net [3h 5d]
dfcastro.net: folds 
ista6: raises 2062 to 2262 and is all-in
IlyaFD: folds 
andedik: folds 
mitto1989: folds 
Uncalled bet (2062) returned to ista6
ista6 collected 625 from pot
*** SUMMARY ***
Total pot 625 | Rake 0 
Seat 3: mitto1989 (big blind) folded before Flop
Seat 5: dfcastro.net folded before Flop (didn't bet)
Seat 6: ista6 collected (625)
Seat 7: IlyaFD (button) folded before Flop (didn't bet)
Seat 8: andedik (small blind) folded before Flop



PokerStars Hand #97779052048: Tournament #725058424, $0.23+$0.02 USD Hold'em No Limit - Level VII (100/200) - 2013/04/27 16:49:25 BRT [2013/04/27 15:49:25 ET]
Table '725058424 1' 9-max Seat #8 is the button
Seat 3: mitto1989 (5201 in chips) 
Seat 5: dfcastro.net (3836 in chips) 
Seat 6: ista6 (2687 in chips) 
Seat 7: IlyaFD (2841 in chips) 
Seat 8: andedik (5767 in chips) 
mitto1989: posts the ante 25
dfcastro.net: posts the ante 25
ista6: posts the ante 25
IlyaFD: posts the ante 25
andedik: posts the ante 25
mitto1989: posts small blind 100
dfcastro.net: posts big blind 200
*** HOLE CARDS ***
Dealt to dfcastro.net [Ac 8d]
ista6: folds 
IlyaFD: folds 
andedik: folds 
mitto1989: raises 250 to 450
dfcastro.net: raises 3361 to 3811 and is all-in
mitto1989: folds 
Uncalled bet (3361) returned to dfcastro.net
dfcastro.net collected 1025 from pot
dfcastro.net: doesn't show hand 
*** SUMMARY ***
Total pot 1025 | Rake 0 
Seat 3: mitto1989 (small blind) folded before Flop
Seat 5: dfcastro.net (big blind) collected (1025)
Seat 6: ista6 folded before Flop (didn't bet)
Seat 7: IlyaFD folded before Flop (didn't bet)
Seat 8: andedik (button) folded before Flop (didn't bet)



PokerStars Hand #97779072999: Tournament #725058424, $0.23+$0.02 USD Hold'em No Limit - Level VII (100/200) - 2013/04/27 16:49:47 BRT [2013/04/27 15:49:47 ET]
Table '725058424 1' 9-max Seat #3 is the button
Seat 3: mitto1989 (4726 in chips) 
Seat 5: dfcastro.net (4386 in chips) 
Seat 6: ista6 (2662 in chips) 
Seat 7: IlyaFD (2816 in chips) 
Seat 8: andedik (5742 in chips) 
mitto1989: posts the ante 25
dfcastro.net: posts the ante 25
ista6: posts the ante 25
IlyaFD: posts the ante 25
andedik: posts the ante 25
dfcastro.net: posts small blind 100
ista6: posts big blind 200
*** HOLE CARDS ***
Dealt to dfcastro.net [Ad Ks]
IlyaFD: folds 
andedik: folds 
mitto1989: raises 250 to 450
dfcastro.net: raises 3911 to 4361 and is all-in
ista6: folds 
mitto1989: calls 3911
*** FLOP *** [Ah Qc Qs]
*** TURN *** [Ah Qc Qs] [Jd]
*** RIVER *** [Ah Qc Qs Jd] [As]
*** SHOW DOWN ***
dfcastro.net: shows [Ad Ks] (a full house, Aces full of Queens)
mitto1989: shows [4d 4h] (two pair, Aces and Queens)
dfcastro.net collected 9047 from pot
*** SUMMARY ***
Total pot 9047 | Rake 0 
Board [Ah Qc Qs Jd As]
Seat 3: mitto1989 (button) showed [4d 4h] and lost with two pair, Aces and Queens
Seat 5: dfcastro.net (small blind) showed [Ad Ks] and won (9047) with a full house, Aces full of Queens
Seat 6: ista6 (big blind) folded before Flop
Seat 7: IlyaFD folded before Flop (didn't bet)
Seat 8: andedik folded before Flop (didn't bet)



PokerStars Hand #97779108138: Tournament #725058424, $0.23+$0.02 USD Hold'em No Limit - Level VII (100/200) - 2013/04/27 16:50:25 BRT [2013/04/27 15:50:25 ET]
Table '725058424 1' 9-max Seat #5 is the button
Seat 3: mitto1989 (340 in chips) 
Seat 5: dfcastro.net (9047 in chips) 
Seat 6: ista6 (2437 in chips) 
Seat 7: IlyaFD (2791 in chips) 
Seat 8: andedik (5717 in chips) 
mitto1989: posts the ante 25
dfcastro.net: posts the ante 25
ista6: posts the ante 25
IlyaFD: posts the ante 25
andedik: posts the ante 25
ista6: posts small blind 100
IlyaFD: posts big blind 200
*** HOLE CARDS ***
Dealt to dfcastro.net [Ts 2h]
andedik: folds 
mitto1989: raises 115 to 315 and is all-in
dfcastro.net: folds 
ista6: folds 
IlyaFD: calls 115
*** FLOP *** [4d 5h 4s]
*** TURN *** [4d 5h 4s] [9d]
*** RIVER *** [4d 5h 4s 9d] [6h]
*** SHOW DOWN ***
IlyaFD: shows [5s 9s] (two pair, Nines and Fives)
mitto1989: shows [As Ks] (a pair of Fours)
IlyaFD collected 855 from pot
*** SUMMARY ***
Total pot 855 | Rake 0 
Board [4d 5h 4s 9d 6h]
Seat 3: mitto1989 showed [As Ks] and lost with a pair of Fours
Seat 5: dfcastro.net (button) folded before Flop (didn't bet)
Seat 6: ista6 (small blind) folded before Flop
Seat 7: IlyaFD (big blind) showed [5s 9s] and won (855) with two pair, Nines and Fives
Seat 8: andedik folded before Flop (didn't bet)



PokerStars Hand #97779157440: Tournament #725058424, $0.23+$0.02 USD Hold'em No Limit - Level VII (100/200) - 2013/04/27 16:51:19 BRT [2013/04/27 15:51:19 ET]
Table '725058424 4' 9-max Seat #5 is the button
Seat 1: Krpnsk (5060 in chips) 
Seat 2: eliasfleitas (2914 in chips) 
Seat 3: dfcastro.net (9022 in chips) 
Seat 4: andedik (5692 in chips) 
Seat 5: thunderbluf7 (19636 in chips) 
Seat 6: johe62 (8839 in chips) 
Seat 7: Orkaanstorm (10769 in chips) 
Seat 8: IlyaFD (3281 in chips) 
Seat 9: ista6 (2287 in chips) 
Krpnsk: posts the ante 25
eliasfleitas: posts the ante 25
dfcastro.net: posts the ante 25
andedik: posts the ante 25
thunderbluf7: posts the ante 25
johe62: posts the ante 25
Orkaanstorm: posts the ante 25
IlyaFD: posts the ante 25
ista6: posts the ante 25
johe62: posts small blind 100
Orkaanstorm: posts big blind 200
*** HOLE CARDS ***
Dealt to dfcastro.net [7d 7s]
IlyaFD: folds 
ista6: folds 
Krpnsk: folds 
eliasfleitas: folds 
thunderbluf7 said, "ty u2"
dfcastro.net: raises 240 to 440
andedik: folds 
thunderbluf7: folds 
johe62: calls 340
Orkaanstorm: folds 
*** FLOP *** [Td 3h 6h]
johe62: checks 
dfcastro.net: checks 
*** TURN *** [Td 3h 6h] [2c]
johe62: bets 800
dfcastro.net: raises 7757 to 8557 and is all-in
johe62: folds 
Uncalled bet (7757) returned to dfcastro.net
dfcastro.net collected 2905 from pot
dfcastro.net: doesn't show hand 
*** SUMMARY ***
Total pot 2905 | Rake 0 
Board [Td 3h 6h 2c]
Seat 1: Krpnsk folded before Flop (didn't bet)
Seat 2: eliasfleitas folded before Flop (didn't bet)
Seat 3: dfcastro.net collected (2905)
Seat 4: andedik folded before Flop (didn't bet)
Seat 5: thunderbluf7 (button) folded before Flop (didn't bet)
Seat 6: johe62 (small blind) folded on the Turn
Seat 7: Orkaanstorm (big blind) folded before Flop
Seat 8: IlyaFD folded before Flop (didn't bet)
Seat 9: ista6 folded before Flop (didn't bet)



PokerStars Hand #97779226106: Tournament #725058424, $0.23+$0.02 USD Hold'em No Limit - Level VII (100/200) - 2013/04/27 16:52:34 BRT [2013/04/27 15:52:34 ET]
Table '725058424 4' 9-max Seat #6 is the button
Seat 1: Krpnsk (5035 in chips) 
Seat 2: eliasfleitas (2889 in chips) 
Seat 3: dfcastro.net (10662 in chips) 
Seat 4: andedik (5667 in chips) 
Seat 5: thunderbluf7 (19611 in chips) 
Seat 6: johe62 (7574 in chips) 
Seat 7: Orkaanstorm (10544 in chips) 
Seat 8: IlyaFD (3256 in chips) 
Seat 9: ista6 (2262 in chips) 
Krpnsk: posts the ante 25
eliasfleitas: posts the ante 25
dfcastro.net: posts the ante 25
andedik: posts the ante 25
thunderbluf7: posts the ante 25
johe62: posts the ante 25
Orkaanstorm: posts the ante 25
IlyaFD: posts the ante 25
ista6: posts the ante 25
Orkaanstorm: posts small blind 100
IlyaFD: posts big blind 200
*** HOLE CARDS ***
Dealt to dfcastro.net [7d 4s]
ista6: folds 
Krpnsk: folds 
eliasfleitas: folds 
dfcastro.net: folds 
andedik: folds 
thunderbluf7: folds 
johe62: folds 
Orkaanstorm: folds 
Uncalled bet (100) returned to IlyaFD
IlyaFD collected 425 from pot
*** SUMMARY ***
Total pot 425 | Rake 0 
Seat 1: Krpnsk folded before Flop (didn't bet)
Seat 2: eliasfleitas folded before Flop (didn't bet)
Seat 3: dfcastro.net folded before Flop (didn't bet)
Seat 4: andedik folded before Flop (didn't bet)
Seat 5: thunderbluf7 folded before Flop (didn't bet)
Seat 6: johe62 (button) folded before Flop (didn't bet)
Seat 7: Orkaanstorm (small blind) folded before Flop
Seat 8: IlyaFD (big blind) collected (425)
Seat 9: ista6 folded before Flop (didn't bet)



PokerStars Hand #97779238105: Tournament #725058424, $0.23+$0.02 USD Hold'em No Limit - Level VII (100/200) - 2013/04/27 16:52:47 BRT [2013/04/27 15:52:47 ET]
Table '725058424 4' 9-max Seat #7 is the button
Seat 1: Krpnsk (5010 in chips) 
Seat 2: eliasfleitas (2864 in chips) 
Seat 3: dfcastro.net (10637 in chips) 
Seat 4: andedik (5642 in chips) 
Seat 5: thunderbluf7 (19586 in chips) 
Seat 6: johe62 (7549 in chips) 
Seat 7: Orkaanstorm (10419 in chips) 
Seat 8: IlyaFD (3556 in chips) 
Seat 9: ista6 (2237 in chips) 
Krpnsk: posts the ante 25
eliasfleitas: posts the ante 25
dfcastro.net: posts the ante 25
andedik: posts the ante 25
thunderbluf7: posts the ante 25
johe62: posts the ante 25
Orkaanstorm: posts the ante 25
IlyaFD: posts the ante 25
ista6: posts the ante 25
IlyaFD: posts small blind 100
ista6: posts big blind 200
*** HOLE CARDS ***
Dealt to dfcastro.net [Jh 7h]
Krpnsk: folds 
eliasfleitas: folds 
dfcastro.net: folds 
andedik: folds 
thunderbluf7: raises 1000 to 1200
johe62: folds 
Orkaanstorm: folds 
IlyaFD: folds 
ista6: folds 
Uncalled bet (1000) returned to thunderbluf7
thunderbluf7 collected 725 from pot
thunderbluf7: doesn't show hand 
*** SUMMARY ***
Total pot 725 | Rake 0 
Seat 1: Krpnsk folded before Flop (didn't bet)
Seat 2: eliasfleitas folded before Flop (didn't bet)
Seat 3: dfcastro.net folded before Flop (didn't bet)
Seat 4: andedik folded before Flop (didn't bet)
Seat 5: thunderbluf7 collected (725)
Seat 6: johe62 folded before Flop (didn't bet)
Seat 7: Orkaanstorm (button) folded before Flop (didn't bet)
Seat 8: IlyaFD (small blind) folded before Flop
Seat 9: ista6 (big blind) folded before Flop



PokerStars Hand #97779268392: Tournament #725058424, $0.23+$0.02 USD Hold'em No Limit - Level VII (100/200) - 2013/04/27 16:53:20 BRT [2013/04/27 15:53:20 ET]
Table '725058424 4' 9-max Seat #8 is the button
Seat 1: Krpnsk (4985 in chips) 
Seat 2: eliasfleitas (2839 in chips) 
Seat 3: dfcastro.net (10612 in chips) 
Seat 4: andedik (5617 in chips) 
Seat 5: thunderbluf7 (20086 in chips) 
Seat 6: johe62 (7524 in chips) 
Seat 7: Orkaanstorm (10394 in chips) 
Seat 8: IlyaFD (3431 in chips) 
Seat 9: ista6 (2012 in chips) 
Krpnsk: posts the ante 25
eliasfleitas: posts the ante 25
dfcastro.net: posts the ante 25
andedik: posts the ante 25
thunderbluf7: posts the ante 25
johe62: posts the ante 25
Orkaanstorm: posts the ante 25
IlyaFD: posts the ante 25
ista6: posts the ante 25
ista6: posts small blind 100
Krpnsk: posts big blind 200
*** HOLE CARDS ***
Dealt to dfcastro.net [4d 7c]
eliasfleitas: raises 400 to 600
dfcastro.net: folds 
andedik: calls 600
thunderbluf7: calls 600
johe62: folds 
Orkaanstorm: folds 
IlyaFD: folds 
ista6: folds 
Krpnsk: folds 
*** FLOP *** [7h 6d 7d]
eliasfleitas: bets 1000
andedik: folds 
thunderbluf7: calls 1000
*** TURN *** [7h 6d 7d] [Th]
eliasfleitas: bets 1214 and is all-in
thunderbluf7: calls 1214
*** RIVER *** [7h 6d 7d Th] [Td]
*** SHOW DOWN ***
eliasfleitas: shows [9s Ah] (two pair, Tens and Sevens)
thunderbluf7: shows [Jh Qd] (two pair, Tens and Sevens - lower kicker)
eliasfleitas collected 6753 from pot
*** SUMMARY ***
Total pot 6753 | Rake 0 
Board [7h 6d 7d Th Td]
Seat 1: Krpnsk (big blind) folded before Flop
Seat 2: eliasfleitas showed [9s Ah] and won (6753) with two pair, Tens and Sevens
Seat 3: dfcastro.net folded before Flop (didn't bet)
Seat 4: andedik folded on the Flop
Seat 5: thunderbluf7 showed [Jh Qd] and lost with two pair, Tens and Sevens
Seat 6: johe62 folded before Flop (didn't bet)
Seat 7: Orkaanstorm folded before Flop (didn't bet)
Seat 8: IlyaFD (button) folded before Flop (didn't bet)
Seat 9: ista6 (small blind) folded before Flop



PokerStars Hand #97779307288: Tournament #725058424, $0.23+$0.02 USD Hold'em No Limit - Level VII (100/200) - 2013/04/27 16:54:04 BRT [2013/04/27 15:54:04 ET]
Table '725058424 4' 9-max Seat #9 is the button
Seat 1: Krpnsk (4760 in chips) 
Seat 2: eliasfleitas (6753 in chips) 
Seat 3: dfcastro.net (10587 in chips) 
Seat 4: andedik (4992 in chips) 
Seat 5: thunderbluf7 (17247 in chips) 
Seat 6: johe62 (7499 in chips) 
Seat 7: Orkaanstorm (10369 in chips) 
Seat 8: IlyaFD (3406 in chips) 
Seat 9: ista6 (1887 in chips) 
Krpnsk: posts the ante 25
eliasfleitas: posts the ante 25
dfcastro.net: posts the ante 25
andedik: posts the ante 25
thunderbluf7: posts the ante 25
johe62: posts the ante 25
Orkaanstorm: posts the ante 25
IlyaFD: posts the ante 25
ista6: posts the ante 25
Krpnsk: posts small blind 100
eliasfleitas: posts big blind 200
*** HOLE CARDS ***
Dealt to dfcastro.net [9c 8s]
dfcastro.net: folds 
andedik: folds 
thunderbluf7: folds 
johe62: raises 200 to 400
Orkaanstorm: folds 
IlyaFD: folds 
thunderbluf7 said, "only called cus hes a muppet"
ista6: raises 1462 to 1862 and is all-in
Krpnsk: folds 
eliasfleitas: folds 
johe62: calls 1462
*** FLOP *** [Kh 2c Qh]
*** TURN *** [Kh 2c Qh] [7d]
*** RIVER *** [Kh 2c Qh 7d] [9s]
*** SHOW DOWN ***
johe62: shows [5s 5d] (a pair of Fives)
ista6: shows [Qs Ks] (two pair, Kings and Queens)
ista6 collected 4249 from pot
*** SUMMARY ***
Total pot 4249 | Rake 0 
Board [Kh 2c Qh 7d 9s]
Seat 1: Krpnsk (small blind) folded before Flop
Seat 2: eliasfleitas (big blind) folded before Flop
Seat 3: dfcastro.net folded before Flop (didn't bet)
Seat 4: andedik folded before Flop (didn't bet)
Seat 5: thunderbluf7 folded before Flop (didn't bet)
Seat 6: johe62 showed [5s 5d] and lost with a pair of Fives
Seat 7: Orkaanstorm folded before Flop (didn't bet)
Seat 8: IlyaFD folded before Flop (didn't bet)
Seat 9: ista6 (button) showed [Qs Ks] and won (4249) with two pair, Kings and Queens



PokerStars Hand #97779351525: Tournament #725058424, $0.23+$0.02 USD Hold'em No Limit - Level VII (100/200) - 2013/04/27 16:54:54 BRT [2013/04/27 15:54:54 ET]
Table '725058424 4' 9-max Seat #1 is the button
Seat 1: Krpnsk (4635 in chips) 
Seat 2: eliasfleitas (6528 in chips) 
Seat 3: dfcastro.net (10562 in chips) 
Seat 4: andedik (4967 in chips) 
Seat 5: thunderbluf7 (17222 in chips) 
Seat 6: johe62 (5612 in chips) 
Seat 7: Orkaanstorm (10344 in chips) 
Seat 8: IlyaFD (3381 in chips) 
Seat 9: ista6 (4249 in chips) 
Krpnsk: posts the ante 25
eliasfleitas: posts the ante 25
dfcastro.net: posts the ante 25
andedik: posts the ante 25
thunderbluf7: posts the ante 25
johe62: posts the ante 25
Orkaanstorm: posts the ante 25
IlyaFD: posts the ante 25
ista6: posts the ante 25
eliasfleitas: posts small blind 100
dfcastro.net: posts big blind 200
*** HOLE CARDS ***
Dealt to dfcastro.net [4h Kd]
andedik: folds 
thunderbluf7: raises 200 to 400
johe62: folds 
Orkaanstorm: folds 
IlyaFD is connected 
IlyaFD: raises 200 to 600
ista6: folds 
Krpnsk: folds 
eliasfleitas: folds 
dfcastro.net: folds 
thunderbluf7: calls 200
*** FLOP *** [6s 3s 7s]
thunderbluf7: checks 
IlyaFD: bets 2756 and is all-in
thunderbluf7: folds 
Uncalled bet (2756) returned to IlyaFD
IlyaFD collected 1725 from pot
*** SUMMARY ***
Total pot 1725 | Rake 0 
Board [6s 3s 7s]
Seat 1: Krpnsk (button) folded before Flop (didn't bet)
Seat 2: eliasfleitas (small blind) folded before Flop
Seat 3: dfcastro.net (big blind) folded before Flop
Seat 4: andedik folded before Flop (didn't bet)
Seat 5: thunderbluf7 folded on the Flop
Seat 6: johe62 folded before Flop (didn't bet)
Seat 7: Orkaanstorm folded before Flop (didn't bet)
Seat 8: IlyaFD collected (1725)
Seat 9: ista6 folded before Flop (didn't bet)



PokerStars Hand #97779541796: Tournament #725058424, $0.23+$0.02 USD Hold'em No Limit - Level VII (100/200) - 2013/04/27 17:00:15 BRT [2013/04/27 16:00:15 ET]
Table '725058424 4' 9-max Seat #2 is the button
Seat 1: Krpnsk (4610 in chips) 
Seat 2: eliasfleitas (6403 in chips) 
Seat 3: dfcastro.net (10337 in chips) 
Seat 4: andedik (4942 in chips) 
Seat 5: thunderbluf7 (16597 in chips) 
Seat 6: johe62 (5587 in chips) 
Seat 7: Orkaanstorm (10319 in chips) 
Seat 8: IlyaFD (4481 in chips) 
Seat 9: ista6 (4224 in chips) 
Krpnsk: posts the ante 25
eliasfleitas: posts the ante 25
dfcastro.net: posts the ante 25
andedik: posts the ante 25
thunderbluf7: posts the ante 25
johe62: posts the ante 25
Orkaanstorm: posts the ante 25
IlyaFD: posts the ante 25
ista6: posts the ante 25
dfcastro.net: posts small blind 100
andedik: posts big blind 200
*** HOLE CARDS ***
Dealt to dfcastro.net [7c 3c]
thunderbluf7: folds 
johe62: folds 
Orkaanstorm: folds 
IlyaFD: calls 200
ista6: folds 
Krpnsk: folds 
eliasfleitas: raises 400 to 600
dfcastro.net: folds 
andedik: folds 
IlyaFD: calls 400
*** FLOP *** [5s 4d Th]
IlyaFD: bets 800
eliasfleitas: raises 800 to 1600
IlyaFD: calls 800
*** TURN *** [5s 4d Th] [Td]
IlyaFD: checks 
eliasfleitas: bets 1000
IlyaFD: raises 1256 to 2256 and is all-in
eliasfleitas: calls 1256
*** RIVER *** [5s 4d Th Td] [Kh]
*** SHOW DOWN ***
IlyaFD: shows [7h 7d] (two pair, Tens and Sevens)
eliasfleitas: shows [Ad 6d] (a pair of Tens)
IlyaFD collected 9437 from pot
*** SUMMARY ***
Total pot 9437 | Rake 0 
Board [5s 4d Th Td Kh]
Seat 1: Krpnsk folded before Flop (didn't bet)
Seat 2: eliasfleitas (button) showed [Ad 6d] and lost with a pair of Tens
Seat 3: dfcastro.net (small blind) folded before Flop
Seat 4: andedik (big blind) folded before Flop
Seat 5: thunderbluf7 folded before Flop (didn't bet)
Seat 6: johe62 folded before Flop (didn't bet)
Seat 7: Orkaanstorm folded before Flop (didn't bet)
Seat 8: IlyaFD showed [7h 7d] and won (9437) with two pair, Tens and Sevens
Seat 9: ista6 folded before Flop (didn't bet)



PokerStars Hand #97779592497: Tournament #725058424, $0.23+$0.02 USD Hold'em No Limit - Level VIII (150/300) - 2013/04/27 17:01:28 BRT [2013/04/27 16:01:28 ET]
Table '725058424 4' 9-max Seat #3 is the button
Seat 1: Krpnsk (4585 in chips) 
Seat 2: eliasfleitas (1922 in chips) 
Seat 3: dfcastro.net (10212 in chips) 
Seat 4: andedik (4717 in chips) 
Seat 5: thunderbluf7 (16572 in chips) 
Seat 6: johe62 (5562 in chips) 
Seat 7: Orkaanstorm (10294 in chips) 
Seat 8: IlyaFD (9437 in chips) 
Seat 9: ista6 (4199 in chips) 
Krpnsk: posts the ante 25
eliasfleitas: posts the ante 25
dfcastro.net: posts the ante 25
andedik: posts the ante 25
thunderbluf7: posts the ante 25
johe62: posts the ante 25
Orkaanstorm: posts the ante 25
IlyaFD: posts the ante 25
ista6: posts the ante 25
andedik: posts small blind 150
thunderbluf7: posts big blind 300
*** HOLE CARDS ***
Dealt to dfcastro.net [8c 8d]
johe62: folds 
Orkaanstorm: folds 
IlyaFD said, "what a donk call"
IlyaFD: folds 
ista6: folds 
Krpnsk: raises 600 to 900
eliasfleitas: folds 
dfcastro.net: raises 1800 to 2700
andedik: folds 
thunderbluf7: folds 
Krpnsk: folds 
Uncalled bet (1800) returned to dfcastro.net
dfcastro.net collected 2475 from pot
dfcastro.net: doesn't show hand 
*** SUMMARY ***
Total pot 2475 | Rake 0 
Seat 1: Krpnsk folded before Flop
Seat 2: eliasfleitas folded before Flop (didn't bet)
Seat 3: dfcastro.net (button) collected (2475)
Seat 4: andedik (small blind) folded before Flop
Seat 5: thunderbluf7 (big blind) folded before Flop
Seat 6: johe62 folded before Flop (didn't bet)
Seat 7: Orkaanstorm folded before Flop (didn't bet)
Seat 8: IlyaFD folded before Flop (didn't bet)
Seat 9: ista6 folded before Flop (didn't bet)



PokerStars Hand #97779641668: Tournament #725058424, $0.23+$0.02 USD Hold'em No Limit - Level VIII (150/300) - 2013/04/27 17:02:26 BRT [2013/04/27 16:02:26 ET]
Table '725058424 4' 9-max Seat #4 is the button
Seat 1: Krpnsk (3660 in chips) 
Seat 2: eliasfleitas (1897 in chips) 
Seat 3: dfcastro.net (11762 in chips) 
Seat 4: andedik (4542 in chips) 
Seat 5: thunderbluf7 (16247 in chips) 
Seat 6: johe62 (5537 in chips) 
Seat 7: Orkaanstorm (10269 in chips) 
Seat 8: IlyaFD (9412 in chips) 
Seat 9: ista6 (4174 in chips) 
Krpnsk: posts the ante 25
eliasfleitas: posts the ante 25
dfcastro.net: posts the ante 25
andedik: posts the ante 25
thunderbluf7: posts the ante 25
johe62: posts the ante 25
Orkaanstorm: posts the ante 25
IlyaFD: posts the ante 25
ista6: posts the ante 25
thunderbluf7: posts small blind 150
johe62: posts big blind 300
*** HOLE CARDS ***
Dealt to dfcastro.net [8d 7c]
Orkaanstorm: folds 
IlyaFD: raises 300 to 600
ista6: folds 
Krpnsk: folds 
eliasfleitas: folds 
dfcastro.net: folds 
andedik: folds 
thunderbluf7: calls 450
johe62: folds 
*** FLOP *** [9d 6c Ts]
thunderbluf7: checks 
IlyaFD: bets 900
thunderbluf7: calls 900
*** TURN *** [9d 6c Ts] [Qc]
thunderbluf7: checks 
IlyaFD: bets 1800
thunderbluf7: raises 7200 to 9000
IlyaFD: folds [Td Kd]
Uncalled bet (7200) returned to thunderbluf7
thunderbluf7 collected 7125 from pot
thunderbluf7: shows [Js Ks] (a straight, Nine to King)
*** SUMMARY ***
Total pot 7125 | Rake 0 
Board [9d 6c Ts Qc]
Seat 1: Krpnsk folded before Flop (didn't bet)
Seat 2: eliasfleitas folded before Flop (didn't bet)
Seat 3: dfcastro.net folded before Flop (didn't bet)
Seat 4: andedik (button) folded before Flop (didn't bet)
Seat 5: thunderbluf7 (small blind) collected (7125)
Seat 6: johe62 (big blind) folded before Flop
Seat 7: Orkaanstorm folded before Flop (didn't bet)
Seat 8: IlyaFD folded on the Turn
Seat 9: ista6 folded before Flop (didn't bet)



PokerStars Hand #97779699053: Tournament #725058424, $0.23+$0.02 USD Hold'em No Limit - Level VIII (150/300) - 2013/04/27 17:03:29 BRT [2013/04/27 16:03:29 ET]
Table '725058424 4' 9-max Seat #5 is the button
Seat 1: Krpnsk (3635 in chips) 
Seat 2: eliasfleitas (1872 in chips) 
Seat 3: dfcastro.net (11737 in chips) 
Seat 4: andedik (4517 in chips) 
Seat 5: thunderbluf7 (20047 in chips) 
Seat 6: johe62 (5212 in chips) 
Seat 7: Orkaanstorm (10244 in chips) 
Seat 8: IlyaFD (6087 in chips) 
Seat 9: ista6 (4149 in chips) 
Krpnsk: posts the ante 25
eliasfleitas: posts the ante 25
dfcastro.net: posts the ante 25
andedik: posts the ante 25
thunderbluf7: posts the ante 25
johe62: posts the ante 25
Orkaanstorm: posts the ante 25
IlyaFD: posts the ante 25
ista6: posts the ante 25
johe62: posts small blind 150
Orkaanstorm: posts big blind 300
*** HOLE CARDS ***
Dealt to dfcastro.net [Kc 4h]
IlyaFD: calls 300
ista6: folds 
Krpnsk: folds 
eliasfleitas: raises 600 to 900
dfcastro.net: folds 
andedik: folds 
thunderbluf7: folds 
johe62: folds 
Orkaanstorm: folds 
IlyaFD: calls 600
*** FLOP *** [9c 7h Ks]
IlyaFD: bets 900
eliasfleitas: raises 47 to 947 and is all-in
IlyaFD: calls 47
*** TURN *** [9c 7h Ks] [9s]
*** RIVER *** [9c 7h Ks 9s] [5h]
*** SHOW DOWN ***
IlyaFD: shows [Td 8d] (a pair of Nines)
eliasfleitas: shows [Kh Jc] (two pair, Kings and Nines)
eliasfleitas collected 4369 from pot
*** SUMMARY ***
Total pot 4369 | Rake 0 
Board [9c 7h Ks 9s 5h]
Seat 1: Krpnsk folded before Flop (didn't bet)
Seat 2: eliasfleitas showed [Kh Jc] and won (4369) with two pair, Kings and Nines
Seat 3: dfcastro.net folded before Flop (didn't bet)
Seat 4: andedik folded before Flop (didn't bet)
Seat 5: thunderbluf7 (button) folded before Flop (didn't bet)
Seat 6: johe62 (small blind) folded before Flop
Seat 7: Orkaanstorm (big blind) folded before Flop
Seat 8: IlyaFD showed [Td 8d] and lost with a pair of Nines
Seat 9: ista6 folded before Flop (didn't bet)



PokerStars Hand #97779738328: Tournament #725058424, $0.23+$0.02 USD Hold'em No Limit - Level VIII (150/300) - 2013/04/27 17:04:11 BRT [2013/04/27 16:04:11 ET]
Table '725058424 4' 9-max Seat #6 is the button
Seat 1: Krpnsk (3610 in chips) 
Seat 2: eliasfleitas (4369 in chips) 
Seat 3: dfcastro.net (11712 in chips) 
Seat 4: andedik (4492 in chips) 
Seat 5: thunderbluf7 (20022 in chips) 
Seat 6: johe62 (5037 in chips) 
Seat 7: Orkaanstorm (9919 in chips) 
Seat 8: IlyaFD (4215 in chips) 
Seat 9: ista6 (4124 in chips) 
Krpnsk: posts the ante 25
eliasfleitas: posts the ante 25
dfcastro.net: posts the ante 25
andedik: posts the ante 25
thunderbluf7: posts the ante 25
johe62: posts the ante 25
Orkaanstorm: posts the ante 25
IlyaFD: posts the ante 25
ista6: posts the ante 25
Orkaanstorm: posts small blind 150
IlyaFD: posts big blind 300
*** HOLE CARDS ***
Dealt to dfcastro.net [Ts 9s]
ista6: folds 
Krpnsk: folds 
eliasfleitas: raises 600 to 900
dfcastro.net: folds 
andedik: folds 
thunderbluf7: folds 
johe62: folds 
Orkaanstorm: folds 
IlyaFD: folds 
Uncalled bet (600) returned to eliasfleitas
eliasfleitas collected 975 from pot
*** SUMMARY ***
Total pot 975 | Rake 0 
Seat 1: Krpnsk folded before Flop (didn't bet)
Seat 2: eliasfleitas collected (975)
Seat 3: dfcastro.net folded before Flop (didn't bet)
Seat 4: andedik folded before Flop (didn't bet)
Seat 5: thunderbluf7 folded before Flop (didn't bet)
Seat 6: johe62 (button) folded before Flop (didn't bet)
Seat 7: Orkaanstorm (small blind) folded before Flop
Seat 8: IlyaFD (big blind) folded before Flop
Seat 9: ista6 folded before Flop (didn't bet)



PokerStars Hand #97779757357: Tournament #725058424, $0.23+$0.02 USD Hold'em No Limit - Level VIII (150/300) - 2013/04/27 17:04:31 BRT [2013/04/27 16:04:31 ET]
Table '725058424 4' 9-max Seat #7 is the button
Seat 1: Krpnsk (3585 in chips) 
Seat 2: eliasfleitas (5019 in chips) 
Seat 3: dfcastro.net (11687 in chips) 
Seat 4: andedik (4467 in chips) 
Seat 5: thunderbluf7 (19997 in chips) 
Seat 6: johe62 (5012 in chips) 
Seat 7: Orkaanstorm (9744 in chips) 
Seat 8: IlyaFD (3890 in chips) 
Seat 9: ista6 (4099 in chips) 
Krpnsk: posts the ante 25
eliasfleitas: posts the ante 25
dfcastro.net: posts the ante 25
andedik: posts the ante 25
thunderbluf7: posts the ante 25
johe62: posts the ante 25
Orkaanstorm: posts the ante 25
IlyaFD: posts the ante 25
ista6: posts the ante 25
IlyaFD: posts small blind 150
ista6: posts big blind 300
*** HOLE CARDS ***
Dealt to dfcastro.net [Ac 9d]
Krpnsk: folds 
eliasfleitas: folds 
dfcastro.net: raises 360 to 660
andedik: folds 
thunderbluf7: folds 
johe62: folds 
Orkaanstorm: folds 
IlyaFD: calls 510
ista6: calls 360
*** FLOP *** [8s Qd 4c]
IlyaFD: checks 
ista6: checks 
dfcastro.net: checks 
*** TURN *** [8s Qd 4c] [5h]
IlyaFD: bets 1200
ista6: folds 
dfcastro.net: raises 1200 to 2400
IlyaFD: folds 
Uncalled bet (1200) returned to dfcastro.net
dfcastro.net collected 4605 from pot
dfcastro.net: doesn't show hand 
*** SUMMARY ***
Total pot 4605 | Rake 0 
Board [8s Qd 4c 5h]
Seat 1: Krpnsk folded before Flop (didn't bet)
Seat 2: eliasfleitas folded before Flop (didn't bet)
Seat 3: dfcastro.net collected (4605)
Seat 4: andedik folded before Flop (didn't bet)
Seat 5: thunderbluf7 folded before Flop (didn't bet)
Seat 6: johe62 folded before Flop (didn't bet)
Seat 7: Orkaanstorm (button) folded before Flop (didn't bet)
Seat 8: IlyaFD (small blind) folded on the Turn
Seat 9: ista6 (big blind) folded on the Turn



PokerStars Hand #97779826545: Tournament #725058424, $0.23+$0.02 USD Hold'em No Limit - Level VIII (150/300) - 2013/04/27 17:05:44 BRT [2013/04/27 16:05:44 ET]
Table '725058424 4' 9-max Seat #8 is the button
Seat 1: Krpnsk (3560 in chips) 
Seat 2: eliasfleitas (4994 in chips) 
Seat 3: dfcastro.net (14407 in chips) 
Seat 4: andedik (4442 in chips) 
Seat 5: thunderbluf7 (19972 in chips) 
Seat 6: johe62 (4987 in chips) 
Seat 7: Orkaanstorm (9719 in chips) 
Seat 8: IlyaFD (2005 in chips) 
Seat 9: ista6 (3414 in chips) 
Krpnsk: posts the ante 25
eliasfleitas: posts the ante 25
dfcastro.net: posts the ante 25
andedik: posts the ante 25
thunderbluf7: posts the ante 25
johe62: posts the ante 25
Orkaanstorm: posts the ante 25
IlyaFD: posts the ante 25
ista6: posts the ante 25
ista6: posts small blind 150
Krpnsk: posts big blind 300
*** HOLE CARDS ***
Dealt to dfcastro.net [9c 5h]
eliasfleitas: folds 
dfcastro.net: folds 
andedik: folds 
thunderbluf7: raises 900 to 1200
johe62: folds 
Orkaanstorm: folds 
IlyaFD: folds 
ista6: folds 
Krpnsk: folds 
Uncalled bet (900) returned to thunderbluf7
thunderbluf7 collected 975 from pot
thunderbluf7: doesn't show hand 
*** SUMMARY ***
Total pot 975 | Rake 0 
Seat 1: Krpnsk (big blind) folded before Flop
Seat 2: eliasfleitas folded before Flop (didn't bet)
Seat 3: dfcastro.net folded before Flop (didn't bet)
Seat 4: andedik folded before Flop (didn't bet)
Seat 5: thunderbluf7 collected (975)
Seat 6: johe62 folded before Flop (didn't bet)
Seat 7: Orkaanstorm folded before Flop (didn't bet)
Seat 8: IlyaFD (button) folded before Flop (didn't bet)
Seat 9: ista6 (small blind) folded before Flop



PokerStars Hand #97779859430: Tournament #725058424, $0.23+$0.02 USD Hold'em No Limit - Level VIII (150/300) - 2013/04/27 17:06:18 BRT [2013/04/27 16:06:18 ET]
Table '725058424 4' 9-max Seat #9 is the button
Seat 1: Krpnsk (3235 in chips) 
Seat 2: eliasfleitas (4969 in chips) 
Seat 3: dfcastro.net (14382 in chips) 
Seat 4: andedik (4417 in chips) 
Seat 5: thunderbluf7 (20622 in chips) 
Seat 6: johe62 (4962 in chips) 
Seat 7: Orkaanstorm (9694 in chips) 
Seat 8: IlyaFD (1980 in chips) 
Seat 9: ista6 (3239 in chips) 
Krpnsk: posts the ante 25
eliasfleitas: posts the ante 25
dfcastro.net: posts the ante 25
andedik: posts the ante 25
thunderbluf7: posts the ante 25
johe62: posts the ante 25
Orkaanstorm: posts the ante 25
IlyaFD: posts the ante 25
ista6: posts the ante 25
Krpnsk: posts small blind 150
eliasfleitas: posts big blind 300
*** HOLE CARDS ***
Dealt to dfcastro.net [5d Jd]
dfcastro.net: folds 
andedik: folds 
thunderbluf7: folds 
johe62: folds 
Orkaanstorm: folds 
IlyaFD: raises 1655 to 1955 and is all-in
ista6: folds 
Krpnsk: folds 
eliasfleitas: folds 
Uncalled bet (1655) returned to IlyaFD
IlyaFD collected 975 from pot
*** SUMMARY ***
Total pot 975 | Rake 0 
Seat 1: Krpnsk (small blind) folded before Flop
Seat 2: eliasfleitas (big blind) folded before Flop
Seat 3: dfcastro.net folded before Flop (didn't bet)
Seat 4: andedik folded before Flop (didn't bet)
Seat 5: thunderbluf7 folded before Flop (didn't bet)
Seat 6: johe62 folded before Flop (didn't bet)
Seat 7: Orkaanstorm folded before Flop (didn't bet)
Seat 8: IlyaFD collected (975)
Seat 9: ista6 (button) folded before Flop (didn't bet)



PokerStars Hand #97779885381: Tournament #725058424, $0.23+$0.02 USD Hold'em No Limit - Level VIII (150/300) - 2013/04/27 17:06:45 BRT [2013/04/27 16:06:45 ET]
Table '725058424 4' 9-max Seat #1 is the button
Seat 1: Krpnsk (3060 in chips) 
Seat 2: eliasfleitas (4644 in chips) 
Seat 3: dfcastro.net (14357 in chips) 
Seat 4: andedik (4392 in chips) 
Seat 5: thunderbluf7 (20597 in chips) 
Seat 6: johe62 (4937 in chips) 
Seat 7: Orkaanstorm (9669 in chips) 
Seat 8: IlyaFD (2630 in chips) 
Seat 9: ista6 (3214 in chips) 
Krpnsk: posts the ante 25
eliasfleitas: posts the ante 25
dfcastro.net: posts the ante 25
andedik: posts the ante 25
thunderbluf7: posts the ante 25
johe62: posts the ante 25
Orkaanstorm: posts the ante 25
IlyaFD: posts the ante 25
ista6: posts the ante 25
eliasfleitas: posts small blind 150
dfcastro.net: posts big blind 300
*** HOLE CARDS ***
Dealt to dfcastro.net [3d 7d]
andedik: raises 600 to 900
thunderbluf7: folds 
johe62: folds 
Orkaanstorm: folds 
IlyaFD: folds 
ista6: folds 
Krpnsk: folds 
eliasfleitas: folds 
dfcastro.net: folds 
Uncalled bet (600) returned to andedik
andedik collected 975 from pot
andedik: doesn't show hand 
*** SUMMARY ***
Total pot 975 | Rake 0 
Seat 1: Krpnsk (button) folded before Flop (didn't bet)
Seat 2: eliasfleitas (small blind) folded before Flop
Seat 3: dfcastro.net (big blind) folded before Flop
Seat 4: andedik collected (975)
Seat 5: thunderbluf7 folded before Flop (didn't bet)
Seat 6: johe62 folded before Flop (didn't bet)
Seat 7: Orkaanstorm folded before Flop (didn't bet)
Seat 8: IlyaFD folded before Flop (didn't bet)
Seat 9: ista6 folded before Flop (didn't bet)



PokerStars Hand #97779907044: Tournament #725058424, $0.23+$0.02 USD Hold'em No Limit - Level VIII (150/300) - 2013/04/27 17:07:07 BRT [2013/04/27 16:07:07 ET]
Table '725058424 4' 9-max Seat #2 is the button
Seat 1: Krpnsk (3035 in chips) 
Seat 2: eliasfleitas (4469 in chips) 
Seat 3: dfcastro.net (14032 in chips) 
Seat 4: andedik (5042 in chips) 
Seat 5: thunderbluf7 (20572 in chips) 
Seat 6: johe62 (4912 in chips) 
Seat 7: Orkaanstorm (9644 in chips) 
Seat 8: IlyaFD (2605 in chips) 
Seat 9: ista6 (3189 in chips) 
Krpnsk: posts the ante 25
eliasfleitas: posts the ante 25
dfcastro.net: posts the ante 25
andedik: posts the ante 25
thunderbluf7: posts the ante 25
johe62: posts the ante 25
Orkaanstorm: posts the ante 25
IlyaFD: posts the ante 25
ista6: posts the ante 25
dfcastro.net: posts small blind 150
andedik: posts big blind 300
*** HOLE CARDS ***
Dealt to dfcastro.net [7c Qs]
thunderbluf7: raises 900 to 1200
johe62: folds 
Orkaanstorm: folds 
IlyaFD: raises 1380 to 2580 and is all-in
ista6: folds 
Krpnsk: folds 
eliasfleitas: folds 
dfcastro.net: folds 
andedik: folds 
thunderbluf7: calls 1380
*** FLOP *** [5s Ts 2d]
*** TURN *** [5s Ts 2d] [7d]
*** RIVER *** [5s Ts 2d 7d] [8s]
*** SHOW DOWN ***
thunderbluf7: shows [Tc Td] (three of a kind, Tens)
IlyaFD: shows [As Ac] (a pair of Aces)
thunderbluf7 collected 5835 from pot
IlyaFD finished the tournament in 9th place
thunderbluf7 said, "ul"
*** SUMMARY ***
Total pot 5835 | Rake 0 
Board [5s Ts 2d 7d 8s]
Seat 1: Krpnsk folded before Flop (didn't bet)
Seat 2: eliasfleitas (button) folded before Flop (didn't bet)
Seat 3: dfcastro.net (small blind) folded before Flop
Seat 4: andedik (big blind) folded before Flop
Seat 5: thunderbluf7 showed [Tc Td] and won (5835) with three of a kind, Tens
Seat 6: johe62 folded before Flop (didn't bet)
Seat 7: Orkaanstorm folded before Flop (didn't bet)
Seat 8: IlyaFD showed [As Ac] and lost with a pair of Aces
Seat 9: ista6 folded before Flop (didn't bet)



PokerStars Hand #97779932644: Tournament #725058424, $0.23+$0.02 USD Hold'em No Limit - Level VIII (150/300) - 2013/04/27 17:07:34 BRT [2013/04/27 16:07:34 ET]
Table '725058424 4' 9-max Seat #3 is the button
Seat 1: Krpnsk (3010 in chips) 
Seat 2: eliasfleitas (4444 in chips) 
Seat 3: dfcastro.net (13857 in chips) 
Seat 4: andedik (4717 in chips) 
Seat 5: thunderbluf7 (23802 in chips) 
Seat 6: johe62 (4887 in chips) 
Seat 7: Orkaanstorm (9619 in chips) 
Seat 9: ista6 (3164 in chips) 
Krpnsk: posts the ante 25
eliasfleitas: posts the ante 25
dfcastro.net: posts the ante 25
andedik: posts the ante 25
thunderbluf7: posts the ante 25
johe62: posts the ante 25
Orkaanstorm: posts the ante 25
ista6: posts the ante 25
andedik: posts small blind 150
thunderbluf7: posts big blind 300
*** HOLE CARDS ***
Dealt to dfcastro.net [Qs Ks]
Orkaanstorm said, "al"
johe62: folds 
Orkaanstorm said, "nh"
Orkaanstorm: folds 
ista6: folds 
Krpnsk: folds 
eliasfleitas: folds 
dfcastro.net: raises 360 to 660
andedik: folds 
thunderbluf7: calls 360
*** FLOP *** [Jh 3d 3s]
thunderbluf7: checks 
dfcastro.net: checks 
*** TURN *** [Jh 3d 3s] [9d]
thunderbluf7: checks 
dfcastro.net: checks 
*** RIVER *** [Jh 3d 3s 9d] [4d]
thunderbluf7: checks 
dfcastro.net: checks 
*** SHOW DOWN ***
thunderbluf7: shows [5s 7s] (a pair of Threes)
dfcastro.net: shows [Qs Ks] (a pair of Threes - King kicker)
dfcastro.net collected 1670 from pot
*** SUMMARY ***
Total pot 1670 | Rake 0 
Board [Jh 3d 3s 9d 4d]
Seat 1: Krpnsk folded before Flop (didn't bet)
Seat 2: eliasfleitas folded before Flop (didn't bet)
Seat 3: dfcastro.net (button) showed [Qs Ks] and won (1670) with a pair of Threes
Seat 4: andedik (small blind) folded before Flop
Seat 5: thunderbluf7 (big blind) showed [5s 7s] and lost with a pair of Threes
Seat 6: johe62 folded before Flop (didn't bet)
Seat 7: Orkaanstorm folded before Flop (didn't bet)
Seat 9: ista6 folded before Flop (didn't bet)



PokerStars Hand #97779985492: Tournament #725058424, $0.23+$0.02 USD Hold'em No Limit - Level VIII (150/300) - 2013/04/27 17:08:30 BRT [2013/04/27 16:08:30 ET]
Table '725058424 4' 9-max Seat #4 is the button
Seat 1: Krpnsk (2985 in chips) 
Seat 2: eliasfleitas (4419 in chips) 
Seat 3: dfcastro.net (14842 in chips) 
Seat 4: andedik (4542 in chips) 
Seat 5: thunderbluf7 (23117 in chips) 
Seat 6: johe62 (4862 in chips) 
Seat 7: Orkaanstorm (9594 in chips) 
Seat 9: ista6 (3139 in chips) 
Krpnsk: posts the ante 25
eliasfleitas: posts the ante 25
dfcastro.net: posts the ante 25
andedik: posts the ante 25
thunderbluf7: posts the ante 25
johe62: posts the ante 25
Orkaanstorm: posts the ante 25
ista6: posts the ante 25
thunderbluf7: posts small blind 150
johe62: posts big blind 300
*** HOLE CARDS ***
Dealt to dfcastro.net [Kh 4c]
Orkaanstorm: folds 
ista6: folds 
Krpnsk: folds 
eliasfleitas: folds 
dfcastro.net: folds 
andedik: folds 
thunderbluf7: folds 
Uncalled bet (150) returned to johe62
johe62 collected 500 from pot
*** SUMMARY ***
Total pot 500 | Rake 0 
Seat 1: Krpnsk folded before Flop (didn't bet)
Seat 2: eliasfleitas folded before Flop (didn't bet)
Seat 3: dfcastro.net folded before Flop (didn't bet)
Seat 4: andedik (button) folded before Flop (didn't bet)
Seat 5: thunderbluf7 (small blind) folded before Flop
Seat 6: johe62 (big blind) collected (500)
Seat 7: Orkaanstorm folded before Flop (didn't bet)
Seat 9: ista6 folded before Flop (didn't bet)



PokerStars Hand #97780001319: Tournament #725058424, $0.23+$0.02 USD Hold'em No Limit - Level VIII (150/300) - 2013/04/27 17:08:46 BRT [2013/04/27 16:08:46 ET]
Table '725058424 4' 9-max Seat #5 is the button
Seat 1: Krpnsk (2960 in chips) 
Seat 2: eliasfleitas (4394 in chips) 
Seat 3: dfcastro.net (14817 in chips) 
Seat 4: andedik (4517 in chips) 
Seat 5: thunderbluf7 (22942 in chips) 
Seat 6: johe62 (5187 in chips) 
Seat 7: Orkaanstorm (9569 in chips) 
Seat 9: ista6 (3114 in chips) 
Krpnsk: posts the ante 25
eliasfleitas: posts the ante 25
dfcastro.net: posts the ante 25
andedik: posts the ante 25
thunderbluf7: posts the ante 25
johe62: posts the ante 25
Orkaanstorm: posts the ante 25
ista6: posts the ante 25
johe62: posts small blind 150
Orkaanstorm: posts big blind 300
*** HOLE CARDS ***
Dealt to dfcastro.net [5c Kh]
ista6: folds 
Krpnsk: folds 
eliasfleitas: folds 
dfcastro.net: folds 
andedik: folds 
thunderbluf7: folds 
johe62: folds 
Uncalled bet (150) returned to Orkaanstorm
Orkaanstorm collected 500 from pot
*** SUMMARY ***
Total pot 500 | Rake 0 
Seat 1: Krpnsk folded before Flop (didn't bet)
Seat 2: eliasfleitas folded before Flop (didn't bet)
Seat 3: dfcastro.net folded before Flop (didn't bet)
Seat 4: andedik folded before Flop (didn't bet)
Seat 5: thunderbluf7 (button) folded before Flop (didn't bet)
Seat 6: johe62 (small blind) folded before Flop
Seat 7: Orkaanstorm (big blind) collected (500)
Seat 9: ista6 folded before Flop (didn't bet)



PokerStars Hand #97780024192: Tournament #725058424, $0.23+$0.02 USD Hold'em No Limit - Level VIII (150/300) - 2013/04/27 17:09:11 BRT [2013/04/27 16:09:11 ET]
Table '725058424 4' 9-max Seat #6 is the button
Seat 1: Krpnsk (2935 in chips) 
Seat 2: eliasfleitas (4369 in chips) 
Seat 3: dfcastro.net (14792 in chips) 
Seat 4: andedik (4492 in chips) 
Seat 5: thunderbluf7 (22917 in chips) 
Seat 6: johe62 (5012 in chips) 
Seat 7: Orkaanstorm (9894 in chips) 
Seat 9: ista6 (3089 in chips) 
Krpnsk: posts the ante 25
eliasfleitas: posts the ante 25
dfcastro.net: posts the ante 25
andedik: posts the ante 25
thunderbluf7: posts the ante 25
johe62: posts the ante 25
Orkaanstorm: posts the ante 25
ista6: posts the ante 25
Orkaanstorm: posts small blind 150
ista6: posts big blind 300
*** HOLE CARDS ***
Dealt to dfcastro.net [9s 2h]
Krpnsk: folds 
eliasfleitas: folds 
dfcastro.net: folds 
andedik: folds 
thunderbluf7: folds 
johe62: folds 
Orkaanstorm: folds 
Uncalled bet (150) returned to ista6
ista6 collected 500 from pot
*** SUMMARY ***
Total pot 500 | Rake 0 
Seat 1: Krpnsk folded before Flop (didn't bet)
Seat 2: eliasfleitas folded before Flop (didn't bet)
Seat 3: dfcastro.net folded before Flop (didn't bet)
Seat 4: andedik folded before Flop (didn't bet)
Seat 5: thunderbluf7 folded before Flop (didn't bet)
Seat 6: johe62 (button) folded before Flop (didn't bet)
Seat 7: Orkaanstorm (small blind) folded before Flop
Seat 9: ista6 (big blind) collected (500)



PokerStars Hand #97780045597: Tournament #725058424, $0.23+$0.02 USD Hold'em No Limit - Level VIII (150/300) - 2013/04/27 17:09:33 BRT [2013/04/27 16:09:33 ET]
Table '725058424 4' 9-max Seat #7 is the button
Seat 1: Krpnsk (2910 in chips) 
Seat 2: eliasfleitas (4344 in chips) 
Seat 3: dfcastro.net (14767 in chips) 
Seat 4: andedik (4467 in chips) 
Seat 5: thunderbluf7 (22892 in chips) 
Seat 6: johe62 (4987 in chips) 
Seat 7: Orkaanstorm (9719 in chips) 
Seat 9: ista6 (3414 in chips) 
Krpnsk: posts the ante 25
eliasfleitas: posts the ante 25
dfcastro.net: posts the ante 25
andedik: posts the ante 25
thunderbluf7: posts the ante 25
johe62: posts the ante 25
Orkaanstorm: posts the ante 25
ista6: posts the ante 25
ista6: posts small blind 150
Krpnsk: posts big blind 300
*** HOLE CARDS ***
Dealt to dfcastro.net [Td 8h]
eliasfleitas: folds 
dfcastro.net: folds 
andedik: folds 
thunderbluf7: folds 
johe62: folds 
Orkaanstorm: folds 
ista6: raises 3089 to 3389 and is all-in
Krpnsk: calls 2585 and is all-in
Uncalled bet (504) returned to ista6
*** FLOP *** [Kc Tc 6h]
*** TURN *** [Kc Tc 6h] [5c]
*** RIVER *** [Kc Tc 6h 5c] [Kh]
*** SHOW DOWN ***
ista6: shows [9h 9s] (two pair, Kings and Nines)
Krpnsk: shows [Jd Qh] (a pair of Kings)
ista6 collected 5970 from pot
Krpnsk finished the tournament in 8th place
*** SUMMARY ***
Total pot 5970 | Rake 0 
Board [Kc Tc 6h 5c Kh]
Seat 1: Krpnsk (big blind) showed [Jd Qh] and lost with a pair of Kings
Seat 2: eliasfleitas folded before Flop (didn't bet)
Seat 3: dfcastro.net folded before Flop (didn't bet)
Seat 4: andedik folded before Flop (didn't bet)
Seat 5: thunderbluf7 folded before Flop (didn't bet)
Seat 6: johe62 folded before Flop (didn't bet)
Seat 7: Orkaanstorm (button) folded before Flop (didn't bet)
Seat 9: ista6 (small blind) showed [9h 9s] and won (5970) with two pair, Kings and Nines



PokerStars Hand #97780079091: Tournament #725058424, $0.23+$0.02 USD Hold'em No Limit - Level VIII (150/300) - 2013/04/27 17:10:09 BRT [2013/04/27 16:10:09 ET]
Table '725058424 4' 9-max Seat #9 is the button
Seat 2: eliasfleitas (4319 in chips) 
Seat 3: dfcastro.net (14742 in chips) 
Seat 4: andedik (4442 in chips) 
Seat 5: thunderbluf7 (22867 in chips) 
Seat 6: johe62 (4962 in chips) 
Seat 7: Orkaanstorm (9694 in chips) 
Seat 9: ista6 (6474 in chips) 
eliasfleitas: posts the ante 25
dfcastro.net: posts the ante 25
andedik: posts the ante 25
thunderbluf7: posts the ante 25
johe62: posts the ante 25
Orkaanstorm: posts the ante 25
ista6: posts the ante 25
eliasfleitas: posts small blind 150
dfcastro.net: posts big blind 300
*** HOLE CARDS ***
Dealt to dfcastro.net [Qh 4d]
andedik: folds 
thunderbluf7: folds 
johe62: folds 
Orkaanstorm: folds 
ista6: folds 
eliasfleitas: folds 
Uncalled bet (150) returned to dfcastro.net
dfcastro.net collected 475 from pot
dfcastro.net: doesn't show hand 
*** SUMMARY ***
Total pot 475 | Rake 0 
Seat 2: eliasfleitas (small blind) folded before Flop
Seat 3: dfcastro.net (big blind) collected (475)
Seat 4: andedik folded before Flop (didn't bet)
Seat 5: thunderbluf7 folded before Flop (didn't bet)
Seat 6: johe62 folded before Flop (didn't bet)
Seat 7: Orkaanstorm folded before Flop (didn't bet)
Seat 9: ista6 (button) folded before Flop (didn't bet)



PokerStars Hand #97780092588: Tournament #725058424, $0.23+$0.02 USD Hold'em No Limit - Level VIII (150/300) - 2013/04/27 17:10:24 BRT [2013/04/27 16:10:24 ET]
Table '725058424 4' 9-max Seat #2 is the button
Seat 2: eliasfleitas (4144 in chips) 
Seat 3: dfcastro.net (15042 in chips) 
Seat 4: andedik (4417 in chips) 
Seat 5: thunderbluf7 (22842 in chips) 
Seat 6: johe62 (4937 in chips) 
Seat 7: Orkaanstorm (9669 in chips) 
Seat 9: ista6 (6449 in chips) 
eliasfleitas: posts the ante 25
dfcastro.net: posts the ante 25
andedik: posts the ante 25
thunderbluf7: posts the ante 25
johe62: posts the ante 25
Orkaanstorm: posts the ante 25
ista6: posts the ante 25
dfcastro.net: posts small blind 150
andedik: posts big blind 300
*** HOLE CARDS ***
Dealt to dfcastro.net [9d 2c]
thunderbluf7: folds 
johe62: folds 
Orkaanstorm: folds 
ista6: folds 
eliasfleitas: folds 
dfcastro.net: folds 
Uncalled bet (150) returned to andedik
andedik collected 475 from pot
andedik: doesn't show hand 
*** SUMMARY ***
Total pot 475 | Rake 0 
Seat 2: eliasfleitas (button) folded before Flop (didn't bet)
Seat 3: dfcastro.net (small blind) folded before Flop
Seat 4: andedik (big blind) collected (475)
Seat 5: thunderbluf7 folded before Flop (didn't bet)
Seat 6: johe62 folded before Flop (didn't bet)
Seat 7: Orkaanstorm folded before Flop (didn't bet)
Seat 9: ista6 folded before Flop (didn't bet)



PokerStars Hand #97780112102: Tournament #725058424, $0.23+$0.02 USD Hold'em No Limit - Level IX (200/400) - 2013/04/27 17:10:45 BRT [2013/04/27 16:10:45 ET]
Table '725058424 4' 9-max Seat #3 is the button
Seat 2: eliasfleitas (4119 in chips) 
Seat 3: dfcastro.net (14867 in chips) 
Seat 4: andedik (4717 in chips) 
Seat 5: thunderbluf7 (22817 in chips) 
Seat 6: johe62 (4912 in chips) 
Seat 7: Orkaanstorm (9644 in chips) 
Seat 9: ista6 (6424 in chips) 
eliasfleitas: posts the ante 25
dfcastro.net: posts the ante 25
andedik: posts the ante 25
thunderbluf7: posts the ante 25
johe62: posts the ante 25
Orkaanstorm: posts the ante 25
ista6: posts the ante 25
andedik: posts small blind 200
thunderbluf7: posts big blind 400
*** HOLE CARDS ***
Dealt to dfcastro.net [3c Ah]
johe62: folds 
Orkaanstorm: folds 
ista6: folds 
eliasfleitas: folds 
dfcastro.net: folds 
andedik: raises 4292 to 4692 and is all-in
thunderbluf7: folds 
Uncalled bet (4292) returned to andedik
andedik collected 975 from pot
andedik: doesn't show hand 
*** SUMMARY ***
Total pot 975 | Rake 0 
Seat 2: eliasfleitas folded before Flop (didn't bet)
Seat 3: dfcastro.net (button) folded before Flop (didn't bet)
Seat 4: andedik (small blind) collected (975)
Seat 5: thunderbluf7 (big blind) folded before Flop
Seat 6: johe62 folded before Flop (didn't bet)
Seat 7: Orkaanstorm folded before Flop (didn't bet)
Seat 9: ista6 folded before Flop (didn't bet)



PokerStars Hand #97780131690: Tournament #725058424, $0.23+$0.02 USD Hold'em No Limit - Level IX (200/400) - 2013/04/27 17:11:06 BRT [2013/04/27 16:11:06 ET]
Table '725058424 4' 9-max Seat #4 is the button
Seat 2: eliasfleitas (4094 in chips) 
Seat 3: dfcastro.net (14842 in chips) 
Seat 4: andedik (5267 in chips) 
Seat 5: thunderbluf7 (22392 in chips) 
Seat 6: johe62 (4887 in chips) 
Seat 7: Orkaanstorm (9619 in chips) 
Seat 9: ista6 (6399 in chips) 
eliasfleitas: posts the ante 25
dfcastro.net: posts the ante 25
andedik: posts the ante 25
thunderbluf7: posts the ante 25
johe62: posts the ante 25
Orkaanstorm: posts the ante 25
ista6: posts the ante 25
thunderbluf7: posts small blind 200
johe62: posts big blind 400
*** HOLE CARDS ***
Dealt to dfcastro.net [3s 4h]
Orkaanstorm: folds 
ista6: folds 
eliasfleitas: raises 800 to 1200
dfcastro.net: folds 
andedik: folds 
thunderbluf7: raises 21167 to 22367 and is all-in
johe62: calls 4462 and is all-in
eliasfleitas: folds 
Uncalled bet (17505) returned to thunderbluf7
*** FLOP *** [Ts 3c Qc]
*** TURN *** [Ts 3c Qc] [2h]
*** RIVER *** [Ts 3c Qc 2h] [5c]
*** SHOW DOWN ***
thunderbluf7: shows [Ah Qd] (a pair of Queens)
johe62: shows [Ks Kc] (a pair of Kings)
johe62 collected 11099 from pot
thunderbluf7 said, "nh"
*** SUMMARY ***
Total pot 11099 | Rake 0 
Board [Ts 3c Qc 2h 5c]
Seat 2: eliasfleitas folded before Flop
Seat 3: dfcastro.net folded before Flop (didn't bet)
Seat 4: andedik (button) folded before Flop (didn't bet)
Seat 5: thunderbluf7 (small blind) showed [Ah Qd] and lost with a pair of Queens
Seat 6: johe62 (big blind) showed [Ks Kc] and won (11099) with a pair of Kings
Seat 7: Orkaanstorm folded before Flop (didn't bet)
Seat 9: ista6 folded before Flop (didn't bet)



PokerStars Hand #97780156574: Tournament #725058424, $0.23+$0.02 USD Hold'em No Limit - Level IX (200/400) - 2013/04/27 17:11:32 BRT [2013/04/27 16:11:32 ET]
Table '725058424 4' 9-max Seat #5 is the button
Seat 2: eliasfleitas (2869 in chips) 
Seat 3: dfcastro.net (14817 in chips) 
Seat 4: andedik (5242 in chips) 
Seat 5: thunderbluf7 (17505 in chips) 
Seat 6: johe62 (11099 in chips) 
Seat 7: Orkaanstorm (9594 in chips) 
Seat 9: ista6 (6374 in chips) 
eliasfleitas: posts the ante 25
dfcastro.net: posts the ante 25
andedik: posts the ante 25
thunderbluf7: posts the ante 25
johe62: posts the ante 25
Orkaanstorm: posts the ante 25
ista6: posts the ante 25
johe62: posts small blind 200
Orkaanstorm: posts big blind 400
*** HOLE CARDS ***
Dealt to dfcastro.net [6s 7h]
ista6: folds 
eliasfleitas: raises 2400 to 2800
dfcastro.net: folds 
andedik: folds 
thunderbluf7: raises 2400 to 5200
johe62: folds 
Orkaanstorm: folds 
eliasfleitas: calls 44 and is all-in
Uncalled bet (2356) returned to thunderbluf7
*** FLOP *** [Tc Kc Jh]
*** TURN *** [Tc Kc Jh] [3d]
*** RIVER *** [Tc Kc Jh 3d] [5h]
*** SHOW DOWN ***
eliasfleitas: shows [2h 2s] (a pair of Deuces)
thunderbluf7: shows [9d 9h] (a pair of Nines)
thunderbluf7 collected 6463 from pot
eliasfleitas finished the tournament in 7th place and received $0.36.
*** SUMMARY ***
Total pot 6463 | Rake 0 
Board [Tc Kc Jh 3d 5h]
Seat 2: eliasfleitas showed [2h 2s] and lost with a pair of Deuces
Seat 3: dfcastro.net folded before Flop (didn't bet)
Seat 4: andedik folded before Flop (didn't bet)
Seat 5: thunderbluf7 (button) showed [9d 9h] and won (6463) with a pair of Nines
Seat 6: johe62 (small blind) folded before Flop
Seat 7: Orkaanstorm (big blind) folded before Flop
Seat 9: ista6 folded before Flop (didn't bet)



PokerStars Hand #97780179177: Tournament #725058424, $0.23+$0.02 USD Hold'em No Limit - Level IX (200/400) - 2013/04/27 17:11:57 BRT [2013/04/27 16:11:57 ET]
Table '725058424 4' 9-max Seat #6 is the button
Seat 3: dfcastro.net (14792 in chips) 
Seat 4: andedik (5217 in chips) 
Seat 5: thunderbluf7 (21099 in chips) 
Seat 6: johe62 (10874 in chips) 
Seat 7: Orkaanstorm (9169 in chips) 
Seat 9: ista6 (6349 in chips) 
dfcastro.net: posts the ante 25
andedik: posts the ante 25
thunderbluf7: posts the ante 25
johe62: posts the ante 25
Orkaanstorm: posts the ante 25
ista6: posts the ante 25
Orkaanstorm: posts small blind 200
ista6: posts big blind 400
*** HOLE CARDS ***
Dealt to dfcastro.net [Ac 5h]
dfcastro.net: raises 400 to 800
andedik: raises 4392 to 5192 and is all-in
thunderbluf7: folds 
johe62: folds 
Orkaanstorm: folds 
ista6: folds 
dfcastro.net: folds 
Uncalled bet (4392) returned to andedik
andedik collected 2350 from pot
andedik: doesn't show hand 
*** SUMMARY ***
Total pot 2350 | Rake 0 
Seat 3: dfcastro.net folded before Flop
Seat 4: andedik collected (2350)
Seat 5: thunderbluf7 folded before Flop (didn't bet)
Seat 6: johe62 (button) folded before Flop (didn't bet)
Seat 7: Orkaanstorm (small blind) folded before Flop
Seat 9: ista6 (big blind) folded before Flop



PokerStars Hand #97780203527: Tournament #725058424, $0.23+$0.02 USD Hold'em No Limit - Level IX (200/400) - 2013/04/27 17:12:23 BRT [2013/04/27 16:12:23 ET]
Table '725058424 4' 9-max Seat #7 is the button
Seat 3: dfcastro.net (13967 in chips) 
Seat 4: andedik (6742 in chips) 
Seat 5: thunderbluf7 (21074 in chips) 
Seat 6: johe62 (10849 in chips) 
Seat 7: Orkaanstorm (8944 in chips) 
Seat 9: ista6 (5924 in chips) 
dfcastro.net: posts the ante 25
andedik: posts the ante 25
thunderbluf7: posts the ante 25
johe62: posts the ante 25
Orkaanstorm: posts the ante 25
ista6: posts the ante 25
ista6: posts small blind 200
dfcastro.net: posts big blind 400
*** HOLE CARDS ***
Dealt to dfcastro.net [Tc Js]
andedik: folds 
thunderbluf7: raises 400 to 800
johe62: folds 
Orkaanstorm: folds 
ista6: folds 
dfcastro.net: folds 
Uncalled bet (400) returned to thunderbluf7
thunderbluf7 collected 1150 from pot
thunderbluf7: doesn't show hand 
*** SUMMARY ***
Total pot 1150 | Rake 0 
Seat 3: dfcastro.net (big blind) folded before Flop
Seat 4: andedik folded before Flop (didn't bet)
Seat 5: thunderbluf7 collected (1150)
Seat 6: johe62 folded before Flop (didn't bet)
Seat 7: Orkaanstorm (button) folded before Flop (didn't bet)
Seat 9: ista6 (small blind) folded before Flop



PokerStars Hand #97780215387: Tournament #725058424, $0.23+$0.02 USD Hold'em No Limit - Level IX (200/400) - 2013/04/27 17:12:36 BRT [2013/04/27 16:12:36 ET]
Table '725058424 4' 9-max Seat #9 is the button
Seat 3: dfcastro.net (13542 in chips) 
Seat 4: andedik (6717 in chips) 
Seat 5: thunderbluf7 (21799 in chips) 
Seat 6: johe62 (10824 in chips) 
Seat 7: Orkaanstorm (8919 in chips) 
Seat 9: ista6 (5699 in chips) 
dfcastro.net: posts the ante 25
andedik: posts the ante 25
thunderbluf7: posts the ante 25
johe62: posts the ante 25
Orkaanstorm: posts the ante 25
ista6: posts the ante 25
dfcastro.net: posts small blind 200
andedik: posts big blind 400
*** HOLE CARDS ***
Dealt to dfcastro.net [Jd 8h]
thunderbluf7: folds 
johe62: folds 
Orkaanstorm: folds 
ista6: folds 
dfcastro.net: folds 
Uncalled bet (200) returned to andedik
andedik collected 550 from pot
andedik: doesn't show hand 
*** SUMMARY ***
Total pot 550 | Rake 0 
Seat 3: dfcastro.net (small blind) folded before Flop
Seat 4: andedik (big blind) collected (550)
Seat 5: thunderbluf7 folded before Flop (didn't bet)
Seat 6: johe62 folded before Flop (didn't bet)
Seat 7: Orkaanstorm folded before Flop (didn't bet)
Seat 9: ista6 (button) folded before Flop (didn't bet)



PokerStars Hand #97780229082: Tournament #725058424, $0.23+$0.02 USD Hold'em No Limit - Level IX (200/400) - 2013/04/27 17:12:51 BRT [2013/04/27 16:12:51 ET]
Table '725058424 4' 9-max Seat #3 is the button
Seat 3: dfcastro.net (13317 in chips) 
Seat 4: andedik (7042 in chips) 
Seat 5: thunderbluf7 (21774 in chips) 
Seat 6: johe62 (10799 in chips) 
Seat 7: Orkaanstorm (8894 in chips) 
Seat 9: ista6 (5674 in chips) 
dfcastro.net: posts the ante 25
andedik: posts the ante 25
thunderbluf7: posts the ante 25
johe62: posts the ante 25
Orkaanstorm: posts the ante 25
ista6: posts the ante 25
andedik: posts small blind 200
thunderbluf7: posts big blind 400
*** HOLE CARDS ***
Dealt to dfcastro.net [Jd 4c]
johe62: folds 
Orkaanstorm: folds 
ista6: folds 
dfcastro.net: folds 
andedik: folds 
Uncalled bet (200) returned to thunderbluf7
thunderbluf7 collected 550 from pot
thunderbluf7: doesn't show hand 
*** SUMMARY ***
Total pot 550 | Rake 0 
Seat 3: dfcastro.net (button) folded before Flop (didn't bet)
Seat 4: andedik (small blind) folded before Flop
Seat 5: thunderbluf7 (big blind) collected (550)
Seat 6: johe62 folded before Flop (didn't bet)
Seat 7: Orkaanstorm folded before Flop (didn't bet)
Seat 9: ista6 folded before Flop (didn't bet)



PokerStars Hand #97780240013: Tournament #725058424, $0.23+$0.02 USD Hold'em No Limit - Level IX (200/400) - 2013/04/27 17:13:03 BRT [2013/04/27 16:13:03 ET]
Table '725058424 4' 9-max Seat #4 is the button
Seat 3: dfcastro.net (13292 in chips) 
Seat 4: andedik (6817 in chips) 
Seat 5: thunderbluf7 (22099 in chips) 
Seat 6: johe62 (10774 in chips) 
Seat 7: Orkaanstorm (8869 in chips) 
Seat 9: ista6 (5649 in chips) 
dfcastro.net: posts the ante 25
andedik: posts the ante 25
thunderbluf7: posts the ante 25
johe62: posts the ante 25
Orkaanstorm: posts the ante 25
ista6: posts the ante 25
thunderbluf7: posts small blind 200
johe62: posts big blind 400
*** HOLE CARDS ***
Dealt to dfcastro.net [Jh Qc]
Orkaanstorm: folds 
ista6: folds 
dfcastro.net: folds 
andedik: folds 
thunderbluf7: folds 
Uncalled bet (200) returned to johe62
johe62 collected 550 from pot
*** SUMMARY ***
Total pot 550 | Rake 0 
Seat 3: dfcastro.net folded before Flop (didn't bet)
Seat 4: andedik (button) folded before Flop (didn't bet)
Seat 5: thunderbluf7 (small blind) folded before Flop
Seat 6: johe62 (big blind) collected (550)
Seat 7: Orkaanstorm folded before Flop (didn't bet)
Seat 9: ista6 folded before Flop (didn't bet)



PokerStars Hand #97780263616: Tournament #725058424, $0.23+$0.02 USD Hold'em No Limit - Level IX (200/400) - 2013/04/27 17:13:29 BRT [2013/04/27 16:13:29 ET]
Table '725058424 4' 9-max Seat #5 is the button
Seat 3: dfcastro.net (13267 in chips) 
Seat 4: andedik (6792 in chips) 
Seat 5: thunderbluf7 (21874 in chips) 
Seat 6: johe62 (11099 in chips) 
Seat 7: Orkaanstorm (8844 in chips) 
Seat 9: ista6 (5624 in chips) 
dfcastro.net: posts the ante 25
andedik: posts the ante 25
thunderbluf7: posts the ante 25
johe62: posts the ante 25
Orkaanstorm: posts the ante 25
ista6: posts the ante 25
johe62: posts small blind 200
Orkaanstorm: posts big blind 400
*** HOLE CARDS ***
Dealt to dfcastro.net [As Tc]
ista6: folds 
dfcastro.net: raises 400 to 800
andedik: folds 
thunderbluf7: folds 
johe62: folds 
Orkaanstorm: folds 
Uncalled bet (400) returned to dfcastro.net
dfcastro.net collected 1150 from pot
dfcastro.net: doesn't show hand 
*** SUMMARY ***
Total pot 1150 | Rake 0 
Seat 3: dfcastro.net collected (1150)
Seat 4: andedik folded before Flop (didn't bet)
Seat 5: thunderbluf7 (button) folded before Flop (didn't bet)
Seat 6: johe62 (small blind) folded before Flop
Seat 7: Orkaanstorm (big blind) folded before Flop
Seat 9: ista6 folded before Flop (didn't bet)



PokerStars Hand #97780280942: Tournament #725058424, $0.23+$0.02 USD Hold'em No Limit - Level IX (200/400) - 2013/04/27 17:13:48 BRT [2013/04/27 16:13:48 ET]
Table '725058424 4' 9-max Seat #6 is the button
Seat 3: dfcastro.net (13992 in chips) 
Seat 4: andedik (6767 in chips) 
Seat 5: thunderbluf7 (21849 in chips) 
Seat 6: johe62 (10874 in chips) 
Seat 7: Orkaanstorm (8419 in chips) 
Seat 9: ista6 (5599 in chips) 
dfcastro.net: posts the ante 25
andedik: posts the ante 25
thunderbluf7: posts the ante 25
johe62: posts the ante 25
Orkaanstorm: posts the ante 25
ista6: posts the ante 25
Orkaanstorm: posts small blind 200
ista6: posts big blind 400
*** HOLE CARDS ***
Dealt to dfcastro.net [2d Jc]
dfcastro.net: folds 
andedik: folds 
thunderbluf7: raises 800 to 1200
johe62: folds 
Orkaanstorm: folds 
ista6: folds 
Uncalled bet (800) returned to thunderbluf7
thunderbluf7 collected 1150 from pot
thunderbluf7: doesn't show hand 
*** SUMMARY ***
Total pot 1150 | Rake 0 
Seat 3: dfcastro.net folded before Flop (didn't bet)
Seat 4: andedik folded before Flop (didn't bet)
Seat 5: thunderbluf7 collected (1150)
Seat 6: johe62 (button) folded before Flop (didn't bet)
Seat 7: Orkaanstorm (small blind) folded before Flop
Seat 9: ista6 (big blind) folded before Flop



PokerStars Hand #97780294753: Tournament #725058424, $0.23+$0.02 USD Hold'em No Limit - Level IX (200/400) - 2013/04/27 17:14:02 BRT [2013/04/27 16:14:02 ET]
Table '725058424 4' 9-max Seat #7 is the button
Seat 3: dfcastro.net (13967 in chips) 
Seat 4: andedik (6742 in chips) 
Seat 5: thunderbluf7 (22574 in chips) 
Seat 6: johe62 (10849 in chips) 
Seat 7: Orkaanstorm (8194 in chips) 
Seat 9: ista6 (5174 in chips) 
dfcastro.net: posts the ante 25
andedik: posts the ante 25
thunderbluf7: posts the ante 25
johe62: posts the ante 25
Orkaanstorm: posts the ante 25
ista6: posts the ante 25
ista6: posts small blind 200
dfcastro.net: posts big blind 400
*** HOLE CARDS ***
Dealt to dfcastro.net [Ac Qd]
andedik: folds 
thunderbluf7: folds 
johe62: folds 
Orkaanstorm: folds 
ista6: folds 
Uncalled bet (200) returned to dfcastro.net
dfcastro.net collected 550 from pot
dfcastro.net: doesn't show hand 
*** SUMMARY ***
Total pot 550 | Rake 0 
Seat 3: dfcastro.net (big blind) collected (550)
Seat 4: andedik folded before Flop (didn't bet)
Seat 5: thunderbluf7 folded before Flop (didn't bet)
Seat 6: johe62 folded before Flop (didn't bet)
Seat 7: Orkaanstorm (button) folded before Flop (didn't bet)
Seat 9: ista6 (small blind) folded before Flop



PokerStars Hand #97780308295: Tournament #725058424, $0.23+$0.02 USD Hold'em No Limit - Level IX (200/400) - 2013/04/27 17:14:17 BRT [2013/04/27 16:14:17 ET]
Table '725058424 4' 9-max Seat #9 is the button
Seat 3: dfcastro.net (14292 in chips) 
Seat 4: andedik (6717 in chips) 
Seat 5: thunderbluf7 (22549 in chips) 
Seat 6: johe62 (10824 in chips) 
Seat 7: Orkaanstorm (8169 in chips) 
Seat 9: ista6 (4949 in chips) 
dfcastro.net: posts the ante 25
andedik: posts the ante 25
thunderbluf7: posts the ante 25
johe62: posts the ante 25
Orkaanstorm: posts the ante 25
ista6: posts the ante 25
dfcastro.net: posts small blind 200
andedik: posts big blind 400
*** HOLE CARDS ***
Dealt to dfcastro.net [5d 3c]
thunderbluf7: folds 
johe62: folds 
Orkaanstorm: folds 
ista6: folds 
dfcastro.net: folds 
Uncalled bet (200) returned to andedik
andedik collected 550 from pot
andedik: doesn't show hand 
*** SUMMARY ***
Total pot 550 | Rake 0 
Seat 3: dfcastro.net (small blind) folded before Flop
Seat 4: andedik (big blind) collected (550)
Seat 5: thunderbluf7 folded before Flop (didn't bet)
Seat 6: johe62 folded before Flop (didn't bet)
Seat 7: Orkaanstorm folded before Flop (didn't bet)
Seat 9: ista6 (button) folded before Flop (didn't bet)



PokerStars Hand #97780322767: Tournament #725058424, $0.23+$0.02 USD Hold'em No Limit - Level IX (200/400) - 2013/04/27 17:14:33 BRT [2013/04/27 16:14:33 ET]
Table '725058424 4' 9-max Seat #3 is the button
Seat 3: dfcastro.net (14067 in chips) 
Seat 4: andedik (7042 in chips) 
Seat 5: thunderbluf7 (22524 in chips) 
Seat 6: johe62 (10799 in chips) 
Seat 7: Orkaanstorm (8144 in chips) 
Seat 9: ista6 (4924 in chips) 
dfcastro.net: posts the ante 25
andedik: posts the ante 25
thunderbluf7: posts the ante 25
johe62: posts the ante 25
Orkaanstorm: posts the ante 25
ista6: posts the ante 25
andedik: posts small blind 200
thunderbluf7: posts big blind 400
*** HOLE CARDS ***
Dealt to dfcastro.net [Jd Th]
johe62: folds 
Orkaanstorm: folds 
ista6: folds 
dfcastro.net: folds 
andedik: raises 6400 to 6800
thunderbluf7: folds [Ts Jh]
Uncalled bet (6400) returned to andedik
andedik collected 950 from pot
andedik: doesn't show hand 
*** SUMMARY ***
Total pot 950 | Rake 0 
Seat 3: dfcastro.net (button) folded before Flop (didn't bet)
Seat 4: andedik (small blind) collected (950)
Seat 5: thunderbluf7 (big blind) folded before Flop
Seat 6: johe62 folded before Flop (didn't bet)
Seat 7: Orkaanstorm folded before Flop (didn't bet)
Seat 9: ista6 folded before Flop (didn't bet)



PokerStars Hand #97780348439: Tournament #725058424, $0.23+$0.02 USD Hold'em No Limit - Level IX (200/400) - 2013/04/27 17:15:01 BRT [2013/04/27 16:15:01 ET]
Table '725058424 4' 9-max Seat #4 is the button
Seat 3: dfcastro.net (14042 in chips) 
Seat 4: andedik (7567 in chips) 
Seat 5: thunderbluf7 (22099 in chips) 
Seat 6: johe62 (10774 in chips) 
Seat 7: Orkaanstorm (8119 in chips) 
Seat 9: ista6 (4899 in chips) 
dfcastro.net: posts the ante 25
andedik: posts the ante 25
thunderbluf7: posts the ante 25
johe62: posts the ante 25
Orkaanstorm: posts the ante 25
ista6: posts the ante 25
thunderbluf7: posts small blind 200
johe62: posts big blind 400
*** HOLE CARDS ***
Dealt to dfcastro.net [Kh Qs]
Orkaanstorm: folds 
ista6: folds 
dfcastro.net: raises 400 to 800
andedik: raises 6742 to 7542 and is all-in
thunderbluf7: folds 
johe62: folds 
dfcastro.net: calls 6742
*** FLOP *** [Ac 8c Kc]
*** TURN *** [Ac 8c Kc] [5s]
*** RIVER *** [Ac 8c Kc 5s] [5h]
*** SHOW DOWN ***
dfcastro.net: shows [Kh Qs] (two pair, Kings and Fives)
andedik: shows [Th Tc] (two pair, Tens and Fives)
dfcastro.net collected 15834 from pot
andedik finished the tournament in 6th place and received $0.62.
*** SUMMARY ***
Total pot 15834 | Rake 0 
Board [Ac 8c Kc 5s 5h]
Seat 3: dfcastro.net showed [Kh Qs] and won (15834) with two pair, Kings and Fives
Seat 4: andedik (button) showed [Th Tc] and lost with two pair, Tens and Fives
Seat 5: thunderbluf7 (small blind) folded before Flop
Seat 6: johe62 (big blind) folded before Flop
Seat 7: Orkaanstorm folded before Flop (didn't bet)
Seat 9: ista6 folded before Flop (didn't bet)



PokerStars Hand #97780381407: Tournament #725058424, $0.23+$0.02 USD Hold'em No Limit - Level IX (200/400) - 2013/04/27 17:15:35 BRT [2013/04/27 16:15:35 ET]
Table '725058424 4' 9-max Seat #5 is the button
Seat 3: dfcastro.net (22309 in chips) 
Seat 5: thunderbluf7 (21874 in chips) 
Seat 6: johe62 (10349 in chips) 
Seat 7: Orkaanstorm (8094 in chips) 
Seat 9: ista6 (4874 in chips) 
dfcastro.net: posts the ante 25
thunderbluf7: posts the ante 25
johe62: posts the ante 25
Orkaanstorm: posts the ante 25
ista6: posts the ante 25
johe62: posts small blind 200
Orkaanstorm: posts big blind 400
*** HOLE CARDS ***
Dealt to dfcastro.net [Qd Ah]
ista6: folds 
dfcastro.net: raises 400 to 800
thunderbluf7: raises 1600 to 2400
johe62: folds 
Orkaanstorm: folds 
dfcastro.net: raises 3200 to 5600
thunderbluf7: calls 3200
*** FLOP *** [9s 3s 9c]
dfcastro.net: checks 
thunderbluf7: checks 
*** TURN *** [9s 3s 9c] [Qc]
dfcastro.net: bets 6000
thunderbluf7: calls 6000
*** RIVER *** [9s 3s 9c Qc] [Kd]
dfcastro.net: checks 
thunderbluf7: checks 
*** SHOW DOWN ***
dfcastro.net: shows [Qd Ah] (two pair, Queens and Nines)
thunderbluf7: mucks hand 
dfcastro.net collected 23925 from pot
*** SUMMARY ***
Total pot 23925 | Rake 0 
Board [9s 3s 9c Qc Kd]
Seat 3: dfcastro.net showed [Qd Ah] and won (23925) with two pair, Queens and Nines
Seat 5: thunderbluf7 (button) mucked [Ac Tc]
Seat 6: johe62 (small blind) folded before Flop
Seat 7: Orkaanstorm (big blind) folded before Flop
Seat 9: ista6 folded before Flop (didn't bet)



PokerStars Hand #97780442676: Tournament #725058424, $0.23+$0.02 USD Hold'em No Limit - Level IX (200/400) - 2013/04/27 17:16:41 BRT [2013/04/27 16:16:41 ET]
Table '725058424 4' 9-max Seat #6 is the button
Seat 3: dfcastro.net (34609 in chips) 
Seat 5: thunderbluf7 (10249 in chips) 
Seat 6: johe62 (10124 in chips) 
Seat 7: Orkaanstorm (7669 in chips) 
Seat 9: ista6 (4849 in chips) 
dfcastro.net: posts the ante 25
thunderbluf7: posts the ante 25
johe62: posts the ante 25
Orkaanstorm: posts the ante 25
ista6: posts the ante 25
Orkaanstorm: posts small blind 200
ista6: posts big blind 400
*** HOLE CARDS ***
Dealt to dfcastro.net [3h 3c]
dfcastro.net: folds 
thunderbluf7: folds 
johe62: folds 
Orkaanstorm: folds 
Uncalled bet (200) returned to ista6
ista6 collected 525 from pot
*** SUMMARY ***
Total pot 525 | Rake 0 
Seat 3: dfcastro.net folded before Flop (didn't bet)
Seat 5: thunderbluf7 folded before Flop (didn't bet)
Seat 6: johe62 (button) folded before Flop (didn't bet)
Seat 7: Orkaanstorm (small blind) folded before Flop
Seat 9: ista6 (big blind) collected (525)



PokerStars Hand #97780454738: Tournament #725058424, $0.23+$0.02 USD Hold'em No Limit - Level IX (200/400) - 2013/04/27 17:16:54 BRT [2013/04/27 16:16:54 ET]
Table '725058424 4' 9-max Seat #7 is the button
Seat 3: dfcastro.net (34584 in chips) 
Seat 5: thunderbluf7 (10224 in chips) 
Seat 6: johe62 (10099 in chips) 
Seat 7: Orkaanstorm (7444 in chips) 
Seat 9: ista6 (5149 in chips) 
dfcastro.net: posts the ante 25
thunderbluf7: posts the ante 25
johe62: posts the ante 25
Orkaanstorm: posts the ante 25
ista6: posts the ante 25
ista6: posts small blind 200
dfcastro.net: posts big blind 400
*** HOLE CARDS ***
Dealt to dfcastro.net [Qd 2d]
thunderbluf7: folds 
johe62: folds 
Orkaanstorm: folds 
ista6: folds 
Uncalled bet (200) returned to dfcastro.net
dfcastro.net collected 525 from pot
dfcastro.net: doesn't show hand 
*** SUMMARY ***
Total pot 525 | Rake 0 
Seat 3: dfcastro.net (big blind) collected (525)
Seat 5: thunderbluf7 folded before Flop (didn't bet)
Seat 6: johe62 folded before Flop (didn't bet)
Seat 7: Orkaanstorm (button) folded before Flop (didn't bet)
Seat 9: ista6 (small blind) folded before Flop



PokerStars Hand #97780462261: Tournament #725058424, $0.23+$0.02 USD Hold'em No Limit - Level IX (200/400) - 2013/04/27 17:17:02 BRT [2013/04/27 16:17:02 ET]
Table '725058424 4' 9-max Seat #9 is the button
Seat 3: dfcastro.net (34884 in chips) 
Seat 5: thunderbluf7 (10199 in chips) 
Seat 6: johe62 (10074 in chips) 
Seat 7: Orkaanstorm (7419 in chips) 
Seat 9: ista6 (4924 in chips) 
dfcastro.net: posts the ante 25
thunderbluf7: posts the ante 25
johe62: posts the ante 25
Orkaanstorm: posts the ante 25
ista6: posts the ante 25
dfcastro.net: posts small blind 200
thunderbluf7: posts big blind 400
*** HOLE CARDS ***
Dealt to dfcastro.net [2d 7h]
johe62: folds 
Orkaanstorm: folds 
ista6: raises 4499 to 4899 and is all-in
dfcastro.net: folds 
thunderbluf7: folds 
Uncalled bet (4499) returned to ista6
ista6 collected 1125 from pot
*** SUMMARY ***
Total pot 1125 | Rake 0 
Seat 3: dfcastro.net (small blind) folded before Flop
Seat 5: thunderbluf7 (big blind) folded before Flop
Seat 6: johe62 folded before Flop (didn't bet)
Seat 7: Orkaanstorm folded before Flop (didn't bet)
Seat 9: ista6 (button) collected (1125)



PokerStars Hand #97780478277: Tournament #725058424, $0.23+$0.02 USD Hold'em No Limit - Level IX (200/400) - 2013/04/27 17:17:19 BRT [2013/04/27 16:17:19 ET]
Table '725058424 4' 9-max Seat #3 is the button
Seat 3: dfcastro.net (34659 in chips) 
Seat 5: thunderbluf7 (9774 in chips) 
Seat 6: johe62 (10049 in chips) 
Seat 7: Orkaanstorm (7394 in chips) 
Seat 9: ista6 (5624 in chips) 
dfcastro.net: posts the ante 25
thunderbluf7: posts the ante 25
johe62: posts the ante 25
Orkaanstorm: posts the ante 25
ista6: posts the ante 25
thunderbluf7: posts small blind 200
johe62: posts big blind 400
*** HOLE CARDS ***
Dealt to dfcastro.net [5d Js]
Orkaanstorm: folds 
ista6: folds 
dfcastro.net: folds 
thunderbluf7: raises 9349 to 9749 and is all-in
johe62: folds 
Uncalled bet (9349) returned to thunderbluf7
thunderbluf7 collected 925 from pot
thunderbluf7: doesn't show hand 
*** SUMMARY ***
Total pot 925 | Rake 0 
Seat 3: dfcastro.net (button) folded before Flop (didn't bet)
Seat 5: thunderbluf7 (small blind) collected (925)
Seat 6: johe62 (big blind) folded before Flop
Seat 7: Orkaanstorm folded before Flop (didn't bet)
Seat 9: ista6 folded before Flop (didn't bet)



PokerStars Hand #97780492075: Tournament #725058424, $0.23+$0.02 USD Hold'em No Limit - Level IX (200/400) - 2013/04/27 17:17:33 BRT [2013/04/27 16:17:33 ET]
Table '725058424 4' 9-max Seat #5 is the button
Seat 3: dfcastro.net (34634 in chips) 
Seat 5: thunderbluf7 (10274 in chips) 
Seat 6: johe62 (9624 in chips) 
Seat 7: Orkaanstorm (7369 in chips) 
Seat 9: ista6 (5599 in chips) 
dfcastro.net: posts the ante 25
thunderbluf7: posts the ante 25
johe62: posts the ante 25
Orkaanstorm: posts the ante 25
ista6: posts the ante 25
johe62: posts small blind 200
Orkaanstorm: posts big blind 400
*** HOLE CARDS ***
Dealt to dfcastro.net [9d 4s]
ista6: folds 
dfcastro.net: folds 
thunderbluf7: raises 400 to 800
johe62: folds 
Orkaanstorm: folds 
Uncalled bet (400) returned to thunderbluf7
thunderbluf7 collected 1125 from pot
thunderbluf7: doesn't show hand 
*** SUMMARY ***
Total pot 1125 | Rake 0 
Seat 3: dfcastro.net folded before Flop (didn't bet)
Seat 5: thunderbluf7 (button) collected (1125)
Seat 6: johe62 (small blind) folded before Flop
Seat 7: Orkaanstorm (big blind) folded before Flop
Seat 9: ista6 folded before Flop (didn't bet)



PokerStars Hand #97780509495: Tournament #725058424, $0.23+$0.02 USD Hold'em No Limit - Level IX (200/400) - 2013/04/27 17:17:52 BRT [2013/04/27 16:17:52 ET]
Table '725058424 4' 9-max Seat #6 is the button
Seat 3: dfcastro.net (34609 in chips) 
Seat 5: thunderbluf7 (10974 in chips) 
Seat 6: johe62 (9399 in chips) 
Seat 7: Orkaanstorm (6944 in chips) 
Seat 9: ista6 (5574 in chips) 
dfcastro.net: posts the ante 25
thunderbluf7: posts the ante 25
johe62: posts the ante 25
Orkaanstorm: posts the ante 25
ista6: posts the ante 25
Orkaanstorm: posts small blind 200
ista6: posts big blind 400
*** HOLE CARDS ***
Dealt to dfcastro.net [Ks 6s]
dfcastro.net: folds 
thunderbluf7: raises 400 to 800
johe62: folds 
Orkaanstorm: folds 
ista6: folds 
Uncalled bet (400) returned to thunderbluf7
thunderbluf7 collected 1125 from pot
thunderbluf7: doesn't show hand 
*** SUMMARY ***
Total pot 1125 | Rake 0 
Seat 3: dfcastro.net folded before Flop (didn't bet)
Seat 5: thunderbluf7 collected (1125)
Seat 6: johe62 (button) folded before Flop (didn't bet)
Seat 7: Orkaanstorm (small blind) folded before Flop
Seat 9: ista6 (big blind) folded before Flop



PokerStars Hand #97780527006: Tournament #725058424, $0.23+$0.02 USD Hold'em No Limit - Level IX (200/400) - 2013/04/27 17:18:11 BRT [2013/04/27 16:18:11 ET]
Table '725058424 4' 9-max Seat #7 is the button
Seat 3: dfcastro.net (34584 in chips) 
Seat 5: thunderbluf7 (11674 in chips) 
Seat 6: johe62 (9374 in chips) 
Seat 7: Orkaanstorm (6719 in chips) 
Seat 9: ista6 (5149 in chips) 
dfcastro.net: posts the ante 25
thunderbluf7: posts the ante 25
johe62: posts the ante 25
Orkaanstorm: posts the ante 25
ista6: posts the ante 25
ista6: posts small blind 200
dfcastro.net: posts big blind 400
*** HOLE CARDS ***
Dealt to dfcastro.net [8s 5h]
thunderbluf7: raises 600 to 1000
johe62: folds 
Orkaanstorm: folds 
ista6: folds 
dfcastro.net: folds 
Uncalled bet (600) returned to thunderbluf7
thunderbluf7 collected 1125 from pot
thunderbluf7: shows [Ks Kc] (a pair of Kings)
*** SUMMARY ***
Total pot 1125 | Rake 0 
Seat 3: dfcastro.net (big blind) folded before Flop
Seat 5: thunderbluf7 collected (1125)
Seat 6: johe62 folded before Flop (didn't bet)
Seat 7: Orkaanstorm (button) folded before Flop (didn't bet)
Seat 9: ista6 (small blind) folded before Flop



PokerStars Hand #97780541855: Tournament #725058424, $0.23+$0.02 USD Hold'em No Limit - Level IX (200/400) - 2013/04/27 17:18:27 BRT [2013/04/27 16:18:27 ET]
Table '725058424 4' 9-max Seat #9 is the button
Seat 3: dfcastro.net (34159 in chips) 
Seat 5: thunderbluf7 (12374 in chips) 
Seat 6: johe62 (9349 in chips) 
Seat 7: Orkaanstorm (6694 in chips) 
Seat 9: ista6 (4924 in chips) 
dfcastro.net: posts the ante 25
thunderbluf7: posts the ante 25
johe62: posts the ante 25
Orkaanstorm: posts the ante 25
ista6: posts the ante 25
dfcastro.net: posts small blind 200
thunderbluf7: posts big blind 400
*** HOLE CARDS ***
Dealt to dfcastro.net [7d 2s]
johe62: folds 
Orkaanstorm: raises 400 to 800
ista6: folds 
dfcastro.net: folds 
thunderbluf7: raises 11549 to 12349 and is all-in
Orkaanstorm: calls 5869 and is all-in
Uncalled bet (5680) returned to thunderbluf7
*** FLOP *** [9h Qc 7c]
*** TURN *** [9h Qc 7c] [9s]
*** RIVER *** [9h Qc 7c 9s] [8h]
*** SHOW DOWN ***
thunderbluf7: shows [Qh Ad] (two pair, Queens and Nines)
Orkaanstorm: shows [Ah Ac] (two pair, Aces and Nines)
Orkaanstorm collected 13663 from pot
*** SUMMARY ***
Total pot 13663 | Rake 0 
Board [9h Qc 7c 9s 8h]
Seat 3: dfcastro.net (small blind) folded before Flop
Seat 5: thunderbluf7 (big blind) showed [Qh Ad] and lost with two pair, Queens and Nines
Seat 6: johe62 folded before Flop (didn't bet)
Seat 7: Orkaanstorm showed [Ah Ac] and won (13663) with two pair, Aces and Nines
Seat 9: ista6 (button) folded before Flop (didn't bet)



PokerStars Hand #97780562343: Tournament #725058424, $0.23+$0.02 USD Hold'em No Limit - Level IX (200/400) - 2013/04/27 17:18:49 BRT [2013/04/27 16:18:49 ET]
Table '725058424 4' 9-max Seat #3 is the button
Seat 3: dfcastro.net (33934 in chips) 
Seat 5: thunderbluf7 (5680 in chips) 
Seat 6: johe62 (9324 in chips) 
Seat 7: Orkaanstorm (13663 in chips) 
Seat 9: ista6 (4899 in chips) 
dfcastro.net: posts the ante 25
thunderbluf7: posts the ante 25
johe62: posts the ante 25
Orkaanstorm: posts the ante 25
ista6: posts the ante 25
thunderbluf7: posts small blind 200
johe62: posts big blind 400
*** HOLE CARDS ***
Dealt to dfcastro.net [2h Kc]
Orkaanstorm: folds 
ista6: folds 
dfcastro.net: folds 
thunderbluf7: calls 200
johe62: checks 
*** FLOP *** [Jd 9d 5s]
thunderbluf7: checks 
johe62: bets 800
thunderbluf7: calls 800
*** TURN *** [Jd 9d 5s] [As]
thunderbluf7: checks 
johe62: bets 1600
thunderbluf7: folds 
Uncalled bet (1600) returned to johe62
johe62 collected 2525 from pot
*** SUMMARY ***
Total pot 2525 | Rake 0 
Board [Jd 9d 5s As]
Seat 3: dfcastro.net (button) folded before Flop (didn't bet)
Seat 5: thunderbluf7 (small blind) folded on the Turn
Seat 6: johe62 (big blind) collected (2525)
Seat 7: Orkaanstorm folded before Flop (didn't bet)
Seat 9: ista6 folded before Flop (didn't bet)



PokerStars Hand #97780587014: Tournament #725058424, $0.23+$0.02 USD Hold'em No Limit - Level IX (200/400) - 2013/04/27 17:19:14 BRT [2013/04/27 16:19:14 ET]
Table '725058424 4' 9-max Seat #5 is the button
Seat 3: dfcastro.net (33909 in chips) 
Seat 5: thunderbluf7 (4455 in chips) 
Seat 6: johe62 (10624 in chips) 
Seat 7: Orkaanstorm (13638 in chips) 
Seat 9: ista6 (4874 in chips) 
dfcastro.net: posts the ante 25
thunderbluf7: posts the ante 25
johe62: posts the ante 25
Orkaanstorm: posts the ante 25
ista6: posts the ante 25
johe62: posts small blind 200
Orkaanstorm: posts big blind 400
*** HOLE CARDS ***
Dealt to dfcastro.net [Qd 8c]
ista6: folds 
dfcastro.net: folds 
thunderbluf7: raises 4030 to 4430 and is all-in
johe62: calls 4230
Orkaanstorm: folds 
*** FLOP *** [3c 5d Ks]
*** TURN *** [3c 5d Ks] [Kd]
*** RIVER *** [3c 5d Ks Kd] [Ts]
*** SHOW DOWN ***
johe62: shows [6h Ad] (a pair of Kings)
thunderbluf7: shows [Kc 7s] (three of a kind, Kings)
thunderbluf7 collected 9385 from pot
*** SUMMARY ***
Total pot 9385 | Rake 0 
Board [3c 5d Ks Kd Ts]
Seat 3: dfcastro.net folded before Flop (didn't bet)
Seat 5: thunderbluf7 (button) showed [Kc 7s] and won (9385) with three of a kind, Kings
Seat 6: johe62 (small blind) showed [6h Ad] and lost with a pair of Kings
Seat 7: Orkaanstorm (big blind) folded before Flop
Seat 9: ista6 folded before Flop (didn't bet)



PokerStars Hand #97780611363: Tournament #725058424, $0.23+$0.02 USD Hold'em No Limit - Level IX (200/400) - 2013/04/27 17:19:38 BRT [2013/04/27 16:19:38 ET]
Table '725058424 4' 9-max Seat #6 is the button
Seat 3: dfcastro.net (33884 in chips) 
Seat 5: thunderbluf7 (9385 in chips) 
Seat 6: johe62 (6169 in chips) 
Seat 7: Orkaanstorm (13213 in chips) 
Seat 9: ista6 (4849 in chips) 
dfcastro.net: posts the ante 25
thunderbluf7: posts the ante 25
johe62: posts the ante 25
Orkaanstorm: posts the ante 25
ista6: posts the ante 25
Orkaanstorm: posts small blind 200
ista6: posts big blind 400
*** HOLE CARDS ***
Dealt to dfcastro.net [7c 8d]
dfcastro.net: folds 
thunderbluf7: folds 
johe62: folds 
Orkaanstorm: raises 400 to 800
ista6: calls 400
*** FLOP *** [3d As Jc]
Orkaanstorm: checks 
ista6: checks 
*** TURN *** [3d As Jc] [8h]
Orkaanstorm: bets 800
ista6: folds 
Uncalled bet (800) returned to Orkaanstorm
Orkaanstorm collected 1725 from pot
*** SUMMARY ***
Total pot 1725 | Rake 0 
Board [3d As Jc 8h]
Seat 3: dfcastro.net folded before Flop (didn't bet)
Seat 5: thunderbluf7 folded before Flop (didn't bet)
Seat 6: johe62 (button) folded before Flop (didn't bet)
Seat 7: Orkaanstorm (small blind) collected (1725)
Seat 9: ista6 (big blind) folded on the Turn



PokerStars Hand #97780640280: Tournament #725058424, $0.23+$0.02 USD Hold'em No Limit - Level IX (200/400) - 2013/04/27 17:20:07 BRT [2013/04/27 16:20:07 ET]
Table '725058424 4' 9-max Seat #7 is the button
Seat 3: dfcastro.net (33859 in chips) 
Seat 5: thunderbluf7 (9360 in chips) 
Seat 6: johe62 (6144 in chips) 
Seat 7: Orkaanstorm (14113 in chips) 
Seat 9: ista6 (4024 in chips) 
dfcastro.net: posts the ante 25
thunderbluf7: posts the ante 25
johe62: posts the ante 25
Orkaanstorm: posts the ante 25
ista6: posts the ante 25
ista6: posts small blind 200
dfcastro.net: posts big blind 400
*** HOLE CARDS ***
Dealt to dfcastro.net [Ac 9s]
thunderbluf7: folds 
johe62: raises 800 to 1200
Orkaanstorm: folds 
ista6: folds 
dfcastro.net: raises 2400 to 3600
johe62: raises 2400 to 6000
dfcastro.net: calls 2400
*** FLOP *** [8c Tc 3s]
dfcastro.net: checks 
johe62: bets 119 and is all-in
dfcastro.net: calls 119
*** TURN *** [8c Tc 3s] [8h]
*** RIVER *** [8c Tc 3s 8h] [Ks]
*** SHOW DOWN ***
dfcastro.net: shows [Ac 9s] (a pair of Eights)
johe62: shows [4d 4s] (two pair, Eights and Fours)
johe62 collected 12563 from pot
*** SUMMARY ***
Total pot 12563 | Rake 0 
Board [8c Tc 3s 8h Ks]
Seat 3: dfcastro.net (big blind) showed [Ac 9s] and lost with a pair of Eights
Seat 5: thunderbluf7 folded before Flop (didn't bet)
Seat 6: johe62 showed [4d 4s] and won (12563) with two pair, Eights and Fours
Seat 7: Orkaanstorm (button) folded before Flop (didn't bet)
Seat 9: ista6 (small blind) folded before Flop



PokerStars Hand #97780681091: Tournament #725058424, $0.23+$0.02 USD Hold'em No Limit - Level X (300/600) - 2013/04/27 17:20:48 BRT [2013/04/27 16:20:48 ET]
Table '725058424 4' 9-max Seat #9 is the button
Seat 3: dfcastro.net (27715 in chips) 
Seat 5: thunderbluf7 (9335 in chips) 
Seat 6: johe62 (12563 in chips) 
Seat 7: Orkaanstorm (14088 in chips) 
Seat 9: ista6 (3799 in chips) 
dfcastro.net: posts the ante 50
thunderbluf7: posts the ante 50
johe62: posts the ante 50
Orkaanstorm: posts the ante 50
ista6: posts the ante 50
dfcastro.net: posts small blind 300
thunderbluf7: posts big blind 600
*** HOLE CARDS ***
Dealt to dfcastro.net [Kd Jd]
johe62: folds 
Orkaanstorm: folds 
ista6: folds 
dfcastro.net: folds 
Uncalled bet (300) returned to thunderbluf7
thunderbluf7 collected 850 from pot
thunderbluf7: doesn't show hand 
*** SUMMARY ***
Total pot 850 | Rake 0 
Seat 3: dfcastro.net (small blind) folded before Flop
Seat 5: thunderbluf7 (big blind) collected (850)
Seat 6: johe62 folded before Flop (didn't bet)
Seat 7: Orkaanstorm folded before Flop (didn't bet)
Seat 9: ista6 (button) folded before Flop (didn't bet)



PokerStars Hand #97780697429: Tournament #725058424, $0.23+$0.02 USD Hold'em No Limit - Level X (300/600) - 2013/04/27 17:21:05 BRT [2013/04/27 16:21:05 ET]
Table '725058424 4' 9-max Seat #3 is the button
Seat 3: dfcastro.net (27365 in chips) 
Seat 5: thunderbluf7 (9835 in chips) 
Seat 6: johe62 (12513 in chips) 
Seat 7: Orkaanstorm (14038 in chips) 
Seat 9: ista6 (3749 in chips) 
dfcastro.net: posts the ante 50
thunderbluf7: posts the ante 50
johe62: posts the ante 50
Orkaanstorm: posts the ante 50
ista6: posts the ante 50
thunderbluf7: posts small blind 300
johe62: posts big blind 600
*** HOLE CARDS ***
Dealt to dfcastro.net [2c 6s]
Orkaanstorm: folds 
ista6: raises 3099 to 3699 and is all-in
dfcastro.net: folds 
thunderbluf7: folds 
johe62: calls 3099
*** FLOP *** [6h As 7s]
*** TURN *** [6h As 7s] [Jc]
*** RIVER *** [6h As 7s Jc] [Kd]
*** SHOW DOWN ***
johe62: shows [Ac Js] (two pair, Aces and Jacks)
ista6: shows [Qh 4h] (high card Ace)
johe62 collected 7948 from pot
ista6 finished the tournament in 5th place and received $0.93.
*** SUMMARY ***
Total pot 7948 | Rake 0 
Board [6h As 7s Jc Kd]
Seat 3: dfcastro.net (button) folded before Flop (didn't bet)
Seat 5: thunderbluf7 (small blind) folded before Flop
Seat 6: johe62 (big blind) showed [Ac Js] and won (7948) with two pair, Aces and Jacks
Seat 7: Orkaanstorm folded before Flop (didn't bet)
Seat 9: ista6 showed [Qh 4h] and lost with high card Ace



PokerStars Hand #97780719525: Tournament #725058424, $0.23+$0.02 USD Hold'em No Limit - Level X (300/600) - 2013/04/27 17:21:27 BRT [2013/04/27 16:21:27 ET]
Table '725058424 4' 9-max Seat #5 is the button
Seat 3: dfcastro.net (27315 in chips) 
Seat 5: thunderbluf7 (9485 in chips) 
Seat 6: johe62 (16712 in chips) 
Seat 7: Orkaanstorm (13988 in chips) 
dfcastro.net: posts the ante 50
thunderbluf7: posts the ante 50
johe62: posts the ante 50
Orkaanstorm: posts the ante 50
johe62: posts small blind 300
Orkaanstorm: posts big blind 600
*** HOLE CARDS ***
Dealt to dfcastro.net [8c 5c]
dfcastro.net: folds 
thunderbluf7: folds 
johe62: raises 600 to 1200
Orkaanstorm: folds 
Uncalled bet (600) returned to johe62
johe62 collected 1400 from pot
*** SUMMARY ***
Total pot 1400 | Rake 0 
Seat 3: dfcastro.net folded before Flop (didn't bet)
Seat 5: thunderbluf7 (button) folded before Flop (didn't bet)
Seat 6: johe62 (small blind) collected (1400)
Seat 7: Orkaanstorm (big blind) folded before Flop



PokerStars Hand #97780734148: Tournament #725058424, $0.23+$0.02 USD Hold'em No Limit - Level X (300/600) - 2013/04/27 17:21:41 BRT [2013/04/27 16:21:41 ET]
Table '725058424 4' 9-max Seat #6 is the button
Seat 3: dfcastro.net (27265 in chips) 
Seat 5: thunderbluf7 (9435 in chips) 
Seat 6: johe62 (17462 in chips) 
Seat 7: Orkaanstorm (13338 in chips) 
dfcastro.net: posts the ante 50
thunderbluf7: posts the ante 50
johe62: posts the ante 50
Orkaanstorm: posts the ante 50
Orkaanstorm: posts small blind 300
dfcastro.net: posts big blind 600
*** HOLE CARDS ***
Dealt to dfcastro.net [Td Jd]
thunderbluf7: raises 8785 to 9385 and is all-in
johe62: folds 
Orkaanstorm: folds 
dfcastro.net: folds 
Uncalled bet (8785) returned to thunderbluf7
thunderbluf7 collected 1700 from pot
thunderbluf7: doesn't show hand 
*** SUMMARY ***
Total pot 1700 | Rake 0 
Seat 3: dfcastro.net (big blind) folded before Flop
Seat 5: thunderbluf7 collected (1700)
Seat 6: johe62 (button) folded before Flop (didn't bet)
Seat 7: Orkaanstorm (small blind) folded before Flop



PokerStars Hand #97780754087: Tournament #725058424, $0.23+$0.02 USD Hold'em No Limit - Level X (300/600) - 2013/04/27 17:22:01 BRT [2013/04/27 16:22:01 ET]
Table '725058424 4' 9-max Seat #7 is the button
Seat 3: dfcastro.net (26615 in chips) 
Seat 5: thunderbluf7 (10485 in chips) 
Seat 6: johe62 (17412 in chips) 
Seat 7: Orkaanstorm (12988 in chips) 
dfcastro.net: posts the ante 50
thunderbluf7: posts the ante 50
johe62: posts the ante 50
Orkaanstorm: posts the ante 50
dfcastro.net: posts small blind 300
thunderbluf7: posts big blind 600
*** HOLE CARDS ***
Dealt to dfcastro.net [8s 5c]
johe62: folds 
Orkaanstorm: raises 600 to 1200
dfcastro.net: folds 
thunderbluf7: folds 
Uncalled bet (600) returned to Orkaanstorm
Orkaanstorm collected 1700 from pot
*** SUMMARY ***
Total pot 1700 | Rake 0 
Seat 3: dfcastro.net (small blind) folded before Flop
Seat 5: thunderbluf7 (big blind) folded before Flop
Seat 6: johe62 folded before Flop (didn't bet)
Seat 7: Orkaanstorm (button) collected (1700)



PokerStars Hand #97780764936: Tournament #725058424, $0.23+$0.02 USD Hold'em No Limit - Level X (300/600) - 2013/04/27 17:22:12 BRT [2013/04/27 16:22:12 ET]
Table '725058424 4' 9-max Seat #3 is the button
Seat 3: dfcastro.net (26265 in chips) 
Seat 5: thunderbluf7 (9835 in chips) 
Seat 6: johe62 (17362 in chips) 
Seat 7: Orkaanstorm (14038 in chips) 
dfcastro.net: posts the ante 50
thunderbluf7: posts the ante 50
johe62: posts the ante 50
Orkaanstorm: posts the ante 50
thunderbluf7: posts small blind 300
johe62: posts big blind 600
*** HOLE CARDS ***
Dealt to dfcastro.net [4s 8h]
Orkaanstorm: folds 
dfcastro.net: folds 
thunderbluf7: raises 9185 to 9785 and is all-in
johe62: folds 
Uncalled bet (9185) returned to thunderbluf7
thunderbluf7 collected 1400 from pot
thunderbluf7: shows [Ad]
*** SUMMARY ***
Total pot 1400 | Rake 0 
Seat 3: dfcastro.net (button) folded before Flop (didn't bet)
Seat 5: thunderbluf7 (small blind) collected (1400)
Seat 6: johe62 (big blind) folded before Flop
Seat 7: Orkaanstorm folded before Flop (didn't bet)



PokerStars Hand #97780778144: Tournament #725058424, $0.23+$0.02 USD Hold'em No Limit - Level X (300/600) - 2013/04/27 17:22:25 BRT [2013/04/27 16:22:25 ET]
Table '725058424 4' 9-max Seat #5 is the button
Seat 3: dfcastro.net (26215 in chips) 
Seat 5: thunderbluf7 (10585 in chips) 
Seat 6: johe62 (16712 in chips) 
Seat 7: Orkaanstorm (13988 in chips) 
dfcastro.net: posts the ante 50
thunderbluf7: posts the ante 50
johe62: posts the ante 50
Orkaanstorm: posts the ante 50
johe62: posts small blind 300
Orkaanstorm: posts big blind 600
*** HOLE CARDS ***
Dealt to dfcastro.net [7d 9d]
dfcastro.net: folds 
thunderbluf7: folds 
johe62: raises 600 to 1200
Orkaanstorm: calls 600
*** FLOP *** [Ac 6c 3h]
johe62: bets 1200
Orkaanstorm: folds 
Uncalled bet (1200) returned to johe62
johe62 collected 2600 from pot
*** SUMMARY ***
Total pot 2600 | Rake 0 
Board [Ac 6c 3h]
Seat 3: dfcastro.net folded before Flop (didn't bet)
Seat 5: thunderbluf7 (button) folded before Flop (didn't bet)
Seat 6: johe62 (small blind) collected (2600)
Seat 7: Orkaanstorm (big blind) folded on the Flop



PokerStars Hand #97780796361: Tournament #725058424, $0.23+$0.02 USD Hold'em No Limit - Level X (300/600) - 2013/04/27 17:22:44 BRT [2013/04/27 16:22:44 ET]
Table '725058424 4' 9-max Seat #6 is the button
Seat 3: dfcastro.net (26165 in chips) 
Seat 5: thunderbluf7 (10535 in chips) 
Seat 6: johe62 (18062 in chips) 
Seat 7: Orkaanstorm (12738 in chips) 
dfcastro.net: posts the ante 50
thunderbluf7: posts the ante 50
johe62: posts the ante 50
Orkaanstorm: posts the ante 50
Orkaanstorm: posts small blind 300
dfcastro.net: posts big blind 600
*** HOLE CARDS ***
Dealt to dfcastro.net [Ks Qh]
thunderbluf7: folds 
johe62: folds 
Orkaanstorm: folds 
Uncalled bet (300) returned to dfcastro.net
dfcastro.net collected 800 from pot
dfcastro.net: doesn't show hand 
*** SUMMARY ***
Total pot 800 | Rake 0 
Seat 3: dfcastro.net (big blind) collected (800)
Seat 5: thunderbluf7 folded before Flop (didn't bet)
Seat 6: johe62 (button) folded before Flop (didn't bet)
Seat 7: Orkaanstorm (small blind) folded before Flop



PokerStars Hand #97780803605: Tournament #725058424, $0.23+$0.02 USD Hold'em No Limit - Level X (300/600) - 2013/04/27 17:22:51 BRT [2013/04/27 16:22:51 ET]
Table '725058424 4' 9-max Seat #7 is the button
Seat 3: dfcastro.net (26615 in chips) 
Seat 5: thunderbluf7 (10485 in chips) 
Seat 6: johe62 (18012 in chips) 
Seat 7: Orkaanstorm (12388 in chips) 
dfcastro.net: posts the ante 50
thunderbluf7: posts the ante 50
johe62: posts the ante 50
Orkaanstorm: posts the ante 50
dfcastro.net: posts small blind 300
thunderbluf7: posts big blind 600
*** HOLE CARDS ***
Dealt to dfcastro.net [Jc Qc]
johe62: raises 600 to 1200
Orkaanstorm: folds 
dfcastro.net: folds 
thunderbluf7: folds 
Uncalled bet (600) returned to johe62
johe62 collected 1700 from pot
*** SUMMARY ***
Total pot 1700 | Rake 0 
Seat 3: dfcastro.net (small blind) folded before Flop
Seat 5: thunderbluf7 (big blind) folded before Flop
Seat 6: johe62 collected (1700)
Seat 7: Orkaanstorm (button) folded before Flop (didn't bet)



PokerStars Hand #97780815473: Tournament #725058424, $0.23+$0.02 USD Hold'em No Limit - Level X (300/600) - 2013/04/27 17:23:03 BRT [2013/04/27 16:23:03 ET]
Table '725058424 4' 9-max Seat #3 is the button
Seat 3: dfcastro.net (26265 in chips) 
Seat 5: thunderbluf7 (9835 in chips) 
Seat 6: johe62 (19062 in chips) 
Seat 7: Orkaanstorm (12338 in chips) 
dfcastro.net: posts the ante 50
thunderbluf7: posts the ante 50
johe62: posts the ante 50
Orkaanstorm: posts the ante 50
thunderbluf7: posts small blind 300
johe62: posts big blind 600
*** HOLE CARDS ***
Dealt to dfcastro.net [6s 4c]
Orkaanstorm: folds 
dfcastro.net: folds 
thunderbluf7: folds 
Uncalled bet (300) returned to johe62
johe62 collected 800 from pot
*** SUMMARY ***
Total pot 800 | Rake 0 
Seat 3: dfcastro.net (button) folded before Flop (didn't bet)
Seat 5: thunderbluf7 (small blind) folded before Flop
Seat 6: johe62 (big blind) collected (800)
Seat 7: Orkaanstorm folded before Flop (didn't bet)



PokerStars Hand #97780823669: Tournament #725058424, $0.23+$0.02 USD Hold'em No Limit - Level X (300/600) - 2013/04/27 17:23:12 BRT [2013/04/27 16:23:12 ET]
Table '725058424 4' 9-max Seat #5 is the button
Seat 3: dfcastro.net (26215 in chips) 
Seat 5: thunderbluf7 (9485 in chips) 
Seat 6: johe62 (19512 in chips) 
Seat 7: Orkaanstorm (12288 in chips) 
dfcastro.net: posts the ante 50
thunderbluf7: posts the ante 50
johe62: posts the ante 50
Orkaanstorm: posts the ante 50
johe62: posts small blind 300
Orkaanstorm: posts big blind 600
*** HOLE CARDS ***
Dealt to dfcastro.net [9d Ah]
dfcastro.net: raises 600 to 1200
thunderbluf7: calls 1200
johe62: folds 
Orkaanstorm: folds 
*** FLOP *** [3s 3h 8s]
dfcastro.net: bets 2000
thunderbluf7: raises 6235 to 8235 and is all-in
dfcastro.net: calls 6235
*** TURN *** [3s 3h 8s] [Qd]
*** RIVER *** [3s 3h 8s Qd] [9s]
*** SHOW DOWN ***
dfcastro.net: shows [9d Ah] (two pair, Nines and Threes)
thunderbluf7: shows [Qh 8h] (two pair, Queens and Eights)
thunderbluf7 collected 19970 from pot
*** SUMMARY ***
Total pot 19970 | Rake 0 
Board [3s 3h 8s Qd 9s]
Seat 3: dfcastro.net showed [9d Ah] and lost with two pair, Nines and Threes
Seat 5: thunderbluf7 (button) showed [Qh 8h] and won (19970) with two pair, Queens and Eights
Seat 6: johe62 (small blind) folded before Flop
Seat 7: Orkaanstorm (big blind) folded before Flop



PokerStars Hand #97780865331: Tournament #725058424, $0.23+$0.02 USD Hold'em No Limit - Level X (300/600) - 2013/04/27 17:23:55 BRT [2013/04/27 16:23:55 ET]
Table '725058424 4' 9-max Seat #6 is the button
Seat 3: dfcastro.net (16730 in chips) 
Seat 5: thunderbluf7 (19970 in chips) 
Seat 6: johe62 (19162 in chips) 
Seat 7: Orkaanstorm (11638 in chips) 
dfcastro.net: posts the ante 50
thunderbluf7: posts the ante 50
johe62: posts the ante 50
Orkaanstorm: posts the ante 50
Orkaanstorm: posts small blind 300
dfcastro.net: posts big blind 600
*** HOLE CARDS ***
Dealt to dfcastro.net [Jd 3h]
thunderbluf7: folds 
johe62: raises 600 to 1200
Orkaanstorm: folds 
dfcastro.net: folds 
Uncalled bet (600) returned to johe62
johe62 collected 1700 from pot
*** SUMMARY ***
Total pot 1700 | Rake 0 
Seat 3: dfcastro.net (big blind) folded before Flop
Seat 5: thunderbluf7 folded before Flop (didn't bet)
Seat 6: johe62 (button) collected (1700)
Seat 7: Orkaanstorm (small blind) folded before Flop



PokerStars Hand #97780876523: Tournament #725058424, $0.23+$0.02 USD Hold'em No Limit - Level X (300/600) - 2013/04/27 17:24:06 BRT [2013/04/27 16:24:06 ET]
Table '725058424 4' 9-max Seat #7 is the button
Seat 3: dfcastro.net (16080 in chips) 
Seat 5: thunderbluf7 (19920 in chips) 
Seat 6: johe62 (20212 in chips) 
Seat 7: Orkaanstorm (11288 in chips) 
dfcastro.net: posts the ante 50
thunderbluf7: posts the ante 50
johe62: posts the ante 50
Orkaanstorm: posts the ante 50
dfcastro.net: posts small blind 300
thunderbluf7: posts big blind 600
*** HOLE CARDS ***
Dealt to dfcastro.net [4c 5h]
johe62: folds 
Orkaanstorm: raises 600 to 1200
dfcastro.net: folds 
thunderbluf7: folds 
Uncalled bet (600) returned to Orkaanstorm
Orkaanstorm collected 1700 from pot
*** SUMMARY ***
Total pot 1700 | Rake 0 
Seat 3: dfcastro.net (small blind) folded before Flop
Seat 5: thunderbluf7 (big blind) folded before Flop
Seat 6: johe62 folded before Flop (didn't bet)
Seat 7: Orkaanstorm (button) collected (1700)



PokerStars Hand #97780886596: Tournament #725058424, $0.23+$0.02 USD Hold'em No Limit - Level X (300/600) - 2013/04/27 17:24:17 BRT [2013/04/27 16:24:17 ET]
Table '725058424 4' 9-max Seat #3 is the button
Seat 3: dfcastro.net (15730 in chips) 
Seat 5: thunderbluf7 (19270 in chips) 
Seat 6: johe62 (20162 in chips) 
Seat 7: Orkaanstorm (12338 in chips) 
dfcastro.net: posts the ante 50
thunderbluf7: posts the ante 50
johe62: posts the ante 50
Orkaanstorm: posts the ante 50
thunderbluf7: posts small blind 300
johe62: posts big blind 600
*** HOLE CARDS ***
Dealt to dfcastro.net [3h Jd]
Orkaanstorm: folds 
dfcastro.net: folds 
thunderbluf7: raises 18620 to 19220 and is all-in
johe62: folds 
Uncalled bet (18620) returned to thunderbluf7
thunderbluf7 collected 1400 from pot
thunderbluf7: shows [Kd Ad] (high card Ace)
*** SUMMARY ***
Total pot 1400 | Rake 0 
Seat 3: dfcastro.net (button) folded before Flop (didn't bet)
Seat 5: thunderbluf7 (small blind) collected (1400)
Seat 6: johe62 (big blind) folded before Flop
Seat 7: Orkaanstorm folded before Flop (didn't bet)



PokerStars Hand #97780899252: Tournament #725058424, $0.23+$0.02 USD Hold'em No Limit - Level X (300/600) - 2013/04/27 17:24:29 BRT [2013/04/27 16:24:29 ET]
Table '725058424 4' 9-max Seat #5 is the button
Seat 3: dfcastro.net (15680 in chips) 
Seat 5: thunderbluf7 (20020 in chips) 
Seat 6: johe62 (19512 in chips) 
Seat 7: Orkaanstorm (12288 in chips) 
dfcastro.net: posts the ante 50
thunderbluf7: posts the ante 50
johe62: posts the ante 50
Orkaanstorm: posts the ante 50
johe62: posts small blind 300
Orkaanstorm: posts big blind 600
*** HOLE CARDS ***
Dealt to dfcastro.net [Js 4c]
dfcastro.net: folds 
thunderbluf7: raises 600 to 1200
johe62: folds 
Orkaanstorm: raises 600 to 1800
thunderbluf7: calls 600
*** FLOP *** [2c Ah As]
Orkaanstorm: checks 
thunderbluf7: bets 2400
Orkaanstorm: folds 
Uncalled bet (2400) returned to thunderbluf7
thunderbluf7 collected 4100 from pot
thunderbluf7: shows [Qc 7d] (a pair of Aces)
*** SUMMARY ***
Total pot 4100 | Rake 0 
Board [2c Ah As]
Seat 3: dfcastro.net folded before Flop (didn't bet)
Seat 5: thunderbluf7 (button) collected (4100)
Seat 6: johe62 (small blind) folded before Flop
Seat 7: Orkaanstorm (big blind) folded on the Flop



PokerStars Hand #97780920071: Tournament #725058424, $0.23+$0.02 USD Hold'em No Limit - Level X (300/600) - 2013/04/27 17:24:51 BRT [2013/04/27 16:24:51 ET]
Table '725058424 4' 9-max Seat #6 is the button
Seat 3: dfcastro.net (15630 in chips) 
Seat 5: thunderbluf7 (22270 in chips) 
Seat 6: johe62 (19162 in chips) 
Seat 7: Orkaanstorm (10438 in chips) 
dfcastro.net: posts the ante 50
thunderbluf7: posts the ante 50
johe62: posts the ante 50
Orkaanstorm: posts the ante 50
Orkaanstorm: posts small blind 300
dfcastro.net: posts big blind 600
*** HOLE CARDS ***
Dealt to dfcastro.net [5h Qd]
thunderbluf7: raises 600 to 1200
johe62: raises 1200 to 2400
Orkaanstorm: folds 
dfcastro.net: folds 
thunderbluf7: raises 19820 to 22220 and is all-in
johe62: folds 
Uncalled bet (19820) returned to thunderbluf7
thunderbluf7 collected 5900 from pot
thunderbluf7: shows [3c 3d] (a pair of Threes)
*** SUMMARY ***
Total pot 5900 | Rake 0 
Seat 3: dfcastro.net (big blind) folded before Flop
Seat 5: thunderbluf7 collected (5900)
Seat 6: johe62 (button) folded before Flop
Seat 7: Orkaanstorm (small blind) folded before Flop



PokerStars Hand #97780938782: Tournament #725058424, $0.23+$0.02 USD Hold'em No Limit - Level X (300/600) - 2013/04/27 17:25:10 BRT [2013/04/27 16:25:10 ET]
Table '725058424 4' 9-max Seat #7 is the button
Seat 3: dfcastro.net (14980 in chips) 
Seat 5: thunderbluf7 (25720 in chips) 
Seat 6: johe62 (16712 in chips) 
Seat 7: Orkaanstorm (10088 in chips) 
dfcastro.net: posts the ante 50
thunderbluf7: posts the ante 50
johe62: posts the ante 50
Orkaanstorm: posts the ante 50
dfcastro.net: posts small blind 300
thunderbluf7: posts big blind 600
*** HOLE CARDS ***
Dealt to dfcastro.net [As 6h]
johe62: folds 
Orkaanstorm: folds 
dfcastro.net: folds 
Uncalled bet (300) returned to thunderbluf7
thunderbluf7 collected 800 from pot
thunderbluf7: doesn't show hand 
*** SUMMARY ***
Total pot 800 | Rake 0 
Seat 3: dfcastro.net (small blind) folded before Flop
Seat 5: thunderbluf7 (big blind) collected (800)
Seat 6: johe62 folded before Flop (didn't bet)
Seat 7: Orkaanstorm (button) folded before Flop (didn't bet)



PokerStars Hand #97780961616: Tournament #725058424, $0.23+$0.02 USD Hold'em No Limit - Level X (300/600) - 2013/04/27 17:25:34 BRT [2013/04/27 16:25:34 ET]
Table '725058424 4' 9-max Seat #3 is the button
Seat 3: dfcastro.net (14630 in chips) 
Seat 5: thunderbluf7 (26170 in chips) 
Seat 6: johe62 (16662 in chips) 
Seat 7: Orkaanstorm (10038 in chips) 
dfcastro.net: posts the ante 50
thunderbluf7: posts the ante 50
johe62: posts the ante 50
Orkaanstorm: posts the ante 50
thunderbluf7: posts small blind 300
johe62: posts big blind 600
*** HOLE CARDS ***
Dealt to dfcastro.net [7c Qc]
Orkaanstorm: raises 600 to 1200
dfcastro.net: folds 
thunderbluf7: calls 900
johe62: folds 
*** FLOP *** [Ts Jc 3s]
thunderbluf7: checks 
Orkaanstorm: checks 
*** TURN *** [Ts Jc 3s] [8c]
thunderbluf7: bets 1800
Orkaanstorm: folds 
Uncalled bet (1800) returned to thunderbluf7
thunderbluf7 collected 3200 from pot
thunderbluf7: shows [Tc]
*** SUMMARY ***
Total pot 3200 | Rake 0 
Board [Ts Jc 3s 8c]
Seat 3: dfcastro.net (button) folded before Flop (didn't bet)
Seat 5: thunderbluf7 (small blind) collected (3200)
Seat 6: johe62 (big blind) folded before Flop
Seat 7: Orkaanstorm folded on the Turn



PokerStars Hand #97780984396: Tournament #725058424, $0.23+$0.02 USD Hold'em No Limit - Level X (300/600) - 2013/04/27 17:25:57 BRT [2013/04/27 16:25:57 ET]
Table '725058424 4' 9-max Seat #5 is the button
Seat 3: dfcastro.net (14580 in chips) 
Seat 5: thunderbluf7 (28120 in chips) 
Seat 6: johe62 (16012 in chips) 
Seat 7: Orkaanstorm (8788 in chips) 
dfcastro.net: posts the ante 50
thunderbluf7: posts the ante 50
johe62: posts the ante 50
Orkaanstorm: posts the ante 50
johe62: posts small blind 300
Orkaanstorm: posts big blind 600
*** HOLE CARDS ***
Dealt to dfcastro.net [4d 4s]
dfcastro.net: folds 
thunderbluf7: raises 600 to 1200
johe62: raises 1200 to 2400
Orkaanstorm: folds 
thunderbluf7: calls 1200
*** FLOP *** [8s 6d Ks]
johe62: bets 2400
thunderbluf7: folds 
Uncalled bet (2400) returned to johe62
johe62 collected 5600 from pot
*** SUMMARY ***
Total pot 5600 | Rake 0 
Board [8s 6d Ks]
Seat 3: dfcastro.net folded before Flop (didn't bet)
Seat 5: thunderbluf7 (button) folded on the Flop
Seat 6: johe62 (small blind) collected (5600)
Seat 7: Orkaanstorm (big blind) folded before Flop



PokerStars Hand #97781006275: Tournament #725058424, $0.23+$0.02 USD Hold'em No Limit - Level X (300/600) - 2013/04/27 17:26:20 BRT [2013/04/27 16:26:20 ET]
Table '725058424 4' 9-max Seat #6 is the button
Seat 3: dfcastro.net (14530 in chips) 
Seat 5: thunderbluf7 (25670 in chips) 
Seat 6: johe62 (19162 in chips) 
Seat 7: Orkaanstorm (8138 in chips) 
dfcastro.net: posts the ante 50
thunderbluf7: posts the ante 50
johe62: posts the ante 50
Orkaanstorm: posts the ante 50
Orkaanstorm: posts small blind 300
dfcastro.net: posts big blind 600
*** HOLE CARDS ***
Dealt to dfcastro.net [8h 2s]
thunderbluf7: raises 1800 to 2400
johe62: folds 
Orkaanstorm: folds 
dfcastro.net: folds 
Uncalled bet (1800) returned to thunderbluf7
thunderbluf7 collected 1700 from pot
thunderbluf7: doesn't show hand 
*** SUMMARY ***
Total pot 1700 | Rake 0 
Seat 3: dfcastro.net (big blind) folded before Flop
Seat 5: thunderbluf7 collected (1700)
Seat 6: johe62 (button) folded before Flop (didn't bet)
Seat 7: Orkaanstorm (small blind) folded before Flop



PokerStars Hand #97781019447: Tournament #725058424, $0.23+$0.02 USD Hold'em No Limit - Level X (300/600) - 2013/04/27 17:26:34 BRT [2013/04/27 16:26:34 ET]
Table '725058424 4' 9-max Seat #7 is the button
Seat 3: dfcastro.net (13880 in chips) 
Seat 5: thunderbluf7 (26720 in chips) 
Seat 6: johe62 (19112 in chips) 
Seat 7: Orkaanstorm (7788 in chips) 
dfcastro.net: posts the ante 50
thunderbluf7: posts the ante 50
johe62: posts the ante 50
Orkaanstorm: posts the ante 50
dfcastro.net: posts small blind 300
thunderbluf7: posts big blind 600
*** HOLE CARDS ***
Dealt to dfcastro.net [2s 2h]
johe62: folds 
Orkaanstorm: raises 3000 to 3600
dfcastro.net: folds 
thunderbluf7: folds 
Uncalled bet (3000) returned to Orkaanstorm
Orkaanstorm collected 1700 from pot
*** SUMMARY ***
Total pot 1700 | Rake 0 
Seat 3: dfcastro.net (small blind) folded before Flop
Seat 5: thunderbluf7 (big blind) folded before Flop
Seat 6: johe62 folded before Flop (didn't bet)
Seat 7: Orkaanstorm (button) collected (1700)



PokerStars Hand #97781031591: Tournament #725058424, $0.23+$0.02 USD Hold'em No Limit - Level X (300/600) - 2013/04/27 17:26:46 BRT [2013/04/27 16:26:46 ET]
Table '725058424 4' 9-max Seat #3 is the button
Seat 3: dfcastro.net (13530 in chips) 
Seat 5: thunderbluf7 (26070 in chips) 
Seat 6: johe62 (19062 in chips) 
Seat 7: Orkaanstorm (8838 in chips) 
dfcastro.net: posts the ante 50
thunderbluf7: posts the ante 50
johe62: posts the ante 50
Orkaanstorm: posts the ante 50
thunderbluf7: posts small blind 300
johe62: posts big blind 600
*** HOLE CARDS ***
Dealt to dfcastro.net [Td Kh]
Orkaanstorm: folds 
dfcastro.net: folds 
thunderbluf7: folds 
Uncalled bet (300) returned to johe62
johe62 collected 800 from pot
*** SUMMARY ***
Total pot 800 | Rake 0 
Seat 3: dfcastro.net (button) folded before Flop (didn't bet)
Seat 5: thunderbluf7 (small blind) folded before Flop
Seat 6: johe62 (big blind) collected (800)
Seat 7: Orkaanstorm folded before Flop (didn't bet)



PokerStars Hand #97781044841: Tournament #725058424, $0.23+$0.02 USD Hold'em No Limit - Level X (300/600) - 2013/04/27 17:27:00 BRT [2013/04/27 16:27:00 ET]
Table '725058424 4' 9-max Seat #5 is the button
Seat 3: dfcastro.net (13480 in chips) 
Seat 5: thunderbluf7 (25720 in chips) 
Seat 6: johe62 (19512 in chips) 
Seat 7: Orkaanstorm (8788 in chips) 
dfcastro.net: posts the ante 50
thunderbluf7: posts the ante 50
johe62: posts the ante 50
Orkaanstorm: posts the ante 50
johe62: posts small blind 300
Orkaanstorm: posts big blind 600
*** HOLE CARDS ***
Dealt to dfcastro.net [Jh 3s]
dfcastro.net: folds 
thunderbluf7: raises 600 to 1200
johe62: folds 
Orkaanstorm: folds 
Uncalled bet (600) returned to thunderbluf7
thunderbluf7 collected 1700 from pot
thunderbluf7: doesn't show hand 
*** SUMMARY ***
Total pot 1700 | Rake 0 
Seat 3: dfcastro.net folded before Flop (didn't bet)
Seat 5: thunderbluf7 (button) collected (1700)
Seat 6: johe62 (small blind) folded before Flop
Seat 7: Orkaanstorm (big blind) folded before Flop



PokerStars Hand #97781054410: Tournament #725058424, $0.23+$0.02 USD Hold'em No Limit - Level X (300/600) - 2013/04/27 17:27:10 BRT [2013/04/27 16:27:10 ET]
Table '725058424 4' 9-max Seat #6 is the button
Seat 3: dfcastro.net (13430 in chips) 
Seat 5: thunderbluf7 (26770 in chips) 
Seat 6: johe62 (19162 in chips) 
Seat 7: Orkaanstorm (8138 in chips) 
dfcastro.net: posts the ante 50
thunderbluf7: posts the ante 50
johe62: posts the ante 50
Orkaanstorm: posts the ante 50
Orkaanstorm: posts small blind 300
dfcastro.net: posts big blind 600
*** HOLE CARDS ***
Dealt to dfcastro.net [4s As]
thunderbluf7: raises 600 to 1200
johe62: folds 
Orkaanstorm: calls 900
dfcastro.net: folds 
*** FLOP *** [Td 6s 7d]
Orkaanstorm: bets 600
thunderbluf7: raises 600 to 1200
Orkaanstorm: raises 5688 to 6888 and is all-in
thunderbluf7: calls 5688
*** TURN *** [Td 6s 7d] [Jh]
*** RIVER *** [Td 6s 7d Jh] [Jd]
*** SHOW DOWN ***
Orkaanstorm: shows [7c 7h] (a full house, Sevens full of Jacks)
thunderbluf7: shows [8c 9s] (a straight, Seven to Jack)
Orkaanstorm collected 16976 from pot
thunderbluf7 said, "nh"
*** SUMMARY ***
Total pot 16976 | Rake 0 
Board [Td 6s 7d Jh Jd]
Seat 3: dfcastro.net (big blind) folded before Flop
Seat 5: thunderbluf7 showed [8c 9s] and lost with a straight, Seven to Jack
Seat 6: johe62 (button) folded before Flop (didn't bet)
Seat 7: Orkaanstorm (small blind) showed [7c 7h] and won (16976) with a full house, Sevens full of Jacks



PokerStars Hand #97781092560: Tournament #725058424, $0.23+$0.02 USD Hold'em No Limit - Level X (300/600) - 2013/04/27 17:27:50 BRT [2013/04/27 16:27:50 ET]
Table '725058424 4' 9-max Seat #7 is the button
Seat 3: dfcastro.net (12780 in chips) 
Seat 5: thunderbluf7 (18632 in chips) 
Seat 6: johe62 (19112 in chips) 
Seat 7: Orkaanstorm (16976 in chips) 
dfcastro.net: posts the ante 50
thunderbluf7: posts the ante 50
johe62: posts the ante 50
Orkaanstorm: posts the ante 50
dfcastro.net: posts small blind 300
thunderbluf7: posts big blind 600
*** HOLE CARDS ***
Dealt to dfcastro.net [Ad Ac]
Orkaanstorm said, "ty"
johe62: folds 
Orkaanstorm: folds 
dfcastro.net: raises 600 to 1200
thunderbluf7 said, "vn river lol"
thunderbluf7: raises 17382 to 18582 and is all-in
dfcastro.net: calls 11530 and is all-in
Uncalled bet (5852) returned to thunderbluf7
*** FLOP *** [As 2h 2s]
*** TURN *** [As 2h 2s] [3d]
*** RIVER *** [As 2h 2s 3d] [7s]
thunderbluf7 said, "ouch"
*** SHOW DOWN ***
dfcastro.net: shows [Ad Ac] (a full house, Aces full of Deuces)
thunderbluf7: shows [9h 9c] (two pair, Nines and Deuces)
dfcastro.net collected 25660 from pot
*** SUMMARY ***
Total pot 25660 | Rake 0 
Board [As 2h 2s 3d 7s]
Seat 3: dfcastro.net (small blind) showed [Ad Ac] and won (25660) with a full house, Aces full of Deuces
Seat 5: thunderbluf7 (big blind) showed [9h 9c] and lost with two pair, Nines and Deuces
Seat 6: johe62 folded before Flop (didn't bet)
Seat 7: Orkaanstorm (button) folded before Flop (didn't bet)



PokerStars Hand #97781119603: Tournament #725058424, $0.23+$0.02 USD Hold'em No Limit - Level X (300/600) - 2013/04/27 17:28:19 BRT [2013/04/27 16:28:19 ET]
Table '725058424 4' 9-max Seat #3 is the button
Seat 3: dfcastro.net (25660 in chips) 
Seat 5: thunderbluf7 (5852 in chips) 
Seat 6: johe62 (19062 in chips) 
Seat 7: Orkaanstorm (16926 in chips) 
dfcastro.net: posts the ante 50
thunderbluf7: posts the ante 50
johe62: posts the ante 50
Orkaanstorm: posts the ante 50
thunderbluf7: posts small blind 300
johe62: posts big blind 600
*** HOLE CARDS ***
Dealt to dfcastro.net [3s 3d]
Orkaanstorm: raises 3000 to 3600
dfcastro.net: folds 
thunderbluf7: raises 2202 to 5802 and is all-in
johe62: folds 
Orkaanstorm: calls 2202
*** FLOP *** [3c 8d 2s]
*** TURN *** [3c 8d 2s] [Js]
Orkaanstorm said, "nh"
*** RIVER *** [3c 8d 2s Js] [5c]
*** SHOW DOWN ***
thunderbluf7: shows [Kh Kd] (a pair of Kings)
Orkaanstorm: shows [Jd Jh] (three of a kind, Jacks)
Orkaanstorm collected 12404 from pot
thunderbluf7 finished the tournament in 4th place and received $1.29.
*** SUMMARY ***
Total pot 12404 | Rake 0 
Board [3c 8d 2s Js 5c]
Seat 3: dfcastro.net (button) folded before Flop (didn't bet)
Seat 5: thunderbluf7 (small blind) showed [Kh Kd] and lost with a pair of Kings
Seat 6: johe62 (big blind) folded before Flop
Seat 7: Orkaanstorm showed [Jd Jh] and won (12404) with three of a kind, Jacks



PokerStars Hand #97781143633: Tournament #725058424, $0.23+$0.02 USD Hold'em No Limit - Level X (300/600) - 2013/04/27 17:28:44 BRT [2013/04/27 16:28:44 ET]
Table '725058424 4' 9-max Seat #6 is the button
Seat 3: dfcastro.net (25610 in chips) 
Seat 6: johe62 (18412 in chips) 
Seat 7: Orkaanstorm (23478 in chips) 
dfcastro.net: posts the ante 50
johe62: posts the ante 50
Orkaanstorm: posts the ante 50
Orkaanstorm: posts small blind 300
dfcastro.net: posts big blind 600
*** HOLE CARDS ***
Dealt to dfcastro.net [8h Qh]
johe62: folds 
Orkaanstorm: folds 
Uncalled bet (300) returned to dfcastro.net
dfcastro.net collected 750 from pot
dfcastro.net: doesn't show hand 
*** SUMMARY ***
Total pot 750 | Rake 0 
Seat 3: dfcastro.net (big blind) collected (750)
Seat 6: johe62 (button) folded before Flop (didn't bet)
Seat 7: Orkaanstorm (small blind) folded before Flop



PokerStars Hand #97781152195: Tournament #725058424, $0.23+$0.02 USD Hold'em No Limit - Level X (300/600) - 2013/04/27 17:28:53 BRT [2013/04/27 16:28:53 ET]
Table '725058424 4' 9-max Seat #7 is the button
Seat 3: dfcastro.net (26010 in chips) 
Seat 6: johe62 (18362 in chips) 
Seat 7: Orkaanstorm (23128 in chips) 
dfcastro.net: posts the ante 50
johe62: posts the ante 50
Orkaanstorm: posts the ante 50
dfcastro.net: posts small blind 300
johe62: posts big blind 600
*** HOLE CARDS ***
Dealt to dfcastro.net [8s Th]
Orkaanstorm: folds 
dfcastro.net: folds 
Uncalled bet (300) returned to johe62
johe62 collected 750 from pot
*** SUMMARY ***
Total pot 750 | Rake 0 
Seat 3: dfcastro.net (small blind) folded before Flop
Seat 6: johe62 (big blind) collected (750)
Seat 7: Orkaanstorm (button) folded before Flop (didn't bet)



PokerStars Hand #97781162968: Tournament #725058424, $0.23+$0.02 USD Hold'em No Limit - Level X (300/600) - 2013/04/27 17:29:05 BRT [2013/04/27 16:29:05 ET]
Table '725058424 4' 9-max Seat #3 is the button
Seat 3: dfcastro.net (25660 in chips) 
Seat 6: johe62 (18762 in chips) 
Seat 7: Orkaanstorm (23078 in chips) 
dfcastro.net: posts the ante 50
johe62: posts the ante 50
Orkaanstorm: posts the ante 50
johe62: posts small blind 300
Orkaanstorm: posts big blind 600
*** HOLE CARDS ***
Dealt to dfcastro.net [6d 8h]
Orkaanstorm said, "i no"
dfcastro.net: folds 
Orkaanstorm said, "ty"
johe62: raises 600 to 1200
Orkaanstorm: raises 600 to 1800
johe62: calls 600
*** FLOP *** [5h Ah 3c]
johe62: bets 1800
Orkaanstorm: calls 1800
*** TURN *** [5h Ah 3c] [Js]
johe62: bets 2800
Orkaanstorm: calls 2800
*** RIVER *** [5h Ah 3c Js] [Jd]
johe62: checks 
Orkaanstorm: bets 4200
johe62: folds 
Uncalled bet (4200) returned to Orkaanstorm
Orkaanstorm collected 12950 from pot
*** SUMMARY ***
Total pot 12950 | Rake 0 
Board [5h Ah 3c Js Jd]
Seat 3: dfcastro.net (button) folded before Flop (didn't bet)
Seat 6: johe62 (small blind) folded on the River
Seat 7: Orkaanstorm (big blind) collected (12950)



PokerStars Hand #97781211002: Tournament #725058424, $0.23+$0.02 USD Hold'em No Limit - Level X (300/600) - 2013/04/27 17:29:56 BRT [2013/04/27 16:29:56 ET]
Table '725058424 4' 9-max Seat #6 is the button
Seat 3: dfcastro.net (25610 in chips) 
Seat 6: johe62 (12312 in chips) 
Seat 7: Orkaanstorm (29578 in chips) 
dfcastro.net: posts the ante 50
johe62: posts the ante 50
Orkaanstorm: posts the ante 50
Orkaanstorm: posts small blind 300
dfcastro.net: posts big blind 600
*** HOLE CARDS ***
Dealt to dfcastro.net [Ac Ah]
johe62: raises 600 to 1200
Orkaanstorm: folds 
dfcastro.net: raises 2400 to 3600
johe62: folds 
Uncalled bet (2400) returned to dfcastro.net
dfcastro.net collected 2850 from pot
dfcastro.net: doesn't show hand 
*** SUMMARY ***
Total pot 2850 | Rake 0 
Seat 3: dfcastro.net (big blind) collected (2850)
Seat 6: johe62 (button) folded before Flop
Seat 7: Orkaanstorm (small blind) folded before Flop



PokerStars Hand #97781224286: Tournament #725058424, $0.23+$0.02 USD Hold'em No Limit - Level X (300/600) - 2013/04/27 17:30:10 BRT [2013/04/27 16:30:10 ET]
Table '725058424 4' 9-max Seat #7 is the button
Seat 3: dfcastro.net (27210 in chips) 
Seat 6: johe62 (11062 in chips) 
Seat 7: Orkaanstorm (29228 in chips) 
dfcastro.net: posts the ante 50
johe62: posts the ante 50
Orkaanstorm: posts the ante 50
dfcastro.net: posts small blind 300
johe62: posts big blind 600
*** HOLE CARDS ***
Dealt to dfcastro.net [Kc 8h]
Orkaanstorm: folds 
dfcastro.net: folds 
Uncalled bet (300) returned to johe62
johe62 collected 750 from pot
*** SUMMARY ***
Total pot 750 | Rake 0 
Seat 3: dfcastro.net (small blind) folded before Flop
Seat 6: johe62 (big blind) collected (750)
Seat 7: Orkaanstorm (button) folded before Flop (didn't bet)



PokerStars Hand #97781233621: Tournament #725058424, $0.23+$0.02 USD Hold'em No Limit - Level X (300/600) - 2013/04/27 17:30:20 BRT [2013/04/27 16:30:20 ET]
Table '725058424 4' 9-max Seat #3 is the button
Seat 3: dfcastro.net (26860 in chips) 
Seat 6: johe62 (11462 in chips) 
Seat 7: Orkaanstorm (29178 in chips) 
dfcastro.net: posts the ante 50
johe62: posts the ante 50
Orkaanstorm: posts the ante 50
johe62: posts small blind 300
Orkaanstorm: posts big blind 600
*** HOLE CARDS ***
Dealt to dfcastro.net [Tc 9d]
dfcastro.net: folds 
johe62: raises 600 to 1200
Orkaanstorm: calls 600
*** FLOP *** [6s 3s Kh]
johe62: bets 1200
Orkaanstorm: folds 
Uncalled bet (1200) returned to johe62
johe62 collected 2550 from pot
*** SUMMARY ***
Total pot 2550 | Rake 0 
Board [6s 3s Kh]
Seat 3: dfcastro.net (button) folded before Flop (didn't bet)
Seat 6: johe62 (small blind) collected (2550)
Seat 7: Orkaanstorm (big blind) folded on the Flop



PokerStars Hand #97781252777: Tournament #725058424, $0.23+$0.02 USD Hold'em No Limit - Level XI (400/800) - 2013/04/27 17:30:41 BRT [2013/04/27 16:30:41 ET]
Table '725058424 4' 9-max Seat #6 is the button
Seat 3: dfcastro.net (26810 in chips) 
Seat 6: johe62 (12762 in chips) 
Seat 7: Orkaanstorm (27928 in chips) 
dfcastro.net: posts the ante 50
johe62: posts the ante 50
Orkaanstorm: posts the ante 50
Orkaanstorm: posts small blind 400
dfcastro.net: posts big blind 800
*** HOLE CARDS ***
Dealt to dfcastro.net [6d Jh]
johe62: raises 800 to 1600
Orkaanstorm: calls 1200
dfcastro.net: folds 
*** FLOP *** [3d 3s 5s]
Orkaanstorm: bets 4800
johe62: folds 
Uncalled bet (4800) returned to Orkaanstorm
Orkaanstorm collected 4150 from pot
*** SUMMARY ***
Total pot 4150 | Rake 0 
Board [3d 3s 5s]
Seat 3: dfcastro.net (big blind) folded before Flop
Seat 6: johe62 (button) folded on the Flop
Seat 7: Orkaanstorm (small blind) collected (4150)



PokerStars Hand #97781272799: Tournament #725058424, $0.23+$0.02 USD Hold'em No Limit - Level XI (400/800) - 2013/04/27 17:31:02 BRT [2013/04/27 16:31:02 ET]
Table '725058424 4' 9-max Seat #7 is the button
Seat 3: dfcastro.net (25960 in chips) 
Seat 6: johe62 (11112 in chips) 
Seat 7: Orkaanstorm (30428 in chips) 
dfcastro.net: posts the ante 50
johe62: posts the ante 50
Orkaanstorm: posts the ante 50
dfcastro.net: posts small blind 400
johe62: posts big blind 800
*** HOLE CARDS ***
Dealt to dfcastro.net [4c 7h]
Orkaanstorm: raises 800 to 1600
dfcastro.net: folds 
johe62: folds 
Uncalled bet (800) returned to Orkaanstorm
Orkaanstorm collected 2150 from pot
*** SUMMARY ***
Total pot 2150 | Rake 0 
Seat 3: dfcastro.net (small blind) folded before Flop
Seat 6: johe62 (big blind) folded before Flop
Seat 7: Orkaanstorm (button) collected (2150)



PokerStars Hand #97781283638: Tournament #725058424, $0.23+$0.02 USD Hold'em No Limit - Level XI (400/800) - 2013/04/27 17:31:14 BRT [2013/04/27 16:31:14 ET]
Table '725058424 4' 9-max Seat #3 is the button
Seat 3: dfcastro.net (25510 in chips) 
Seat 6: johe62 (10262 in chips) 
Seat 7: Orkaanstorm (31728 in chips) 
dfcastro.net: posts the ante 50
johe62: posts the ante 50
Orkaanstorm: posts the ante 50
johe62: posts small blind 400
Orkaanstorm: posts big blind 800
*** HOLE CARDS ***
Dealt to dfcastro.net [7h 6s]
dfcastro.net: folds 
johe62: folds 
Uncalled bet (400) returned to Orkaanstorm
Orkaanstorm collected 950 from pot
*** SUMMARY ***
Total pot 950 | Rake 0 
Seat 3: dfcastro.net (button) folded before Flop (didn't bet)
Seat 6: johe62 (small blind) folded before Flop
Seat 7: Orkaanstorm (big blind) collected (950)



PokerStars Hand #97781292284: Tournament #725058424, $0.23+$0.02 USD Hold'em No Limit - Level XI (400/800) - 2013/04/27 17:31:23 BRT [2013/04/27 16:31:23 ET]
Table '725058424 4' 9-max Seat #6 is the button
Seat 3: dfcastro.net (25460 in chips) 
Seat 6: johe62 (9812 in chips) 
Seat 7: Orkaanstorm (32228 in chips) 
dfcastro.net: posts the ante 50
johe62: posts the ante 50
Orkaanstorm: posts the ante 50
Orkaanstorm: posts small blind 400
dfcastro.net: posts big blind 800
*** HOLE CARDS ***
Dealt to dfcastro.net [Tc Td]
johe62: folds 
Orkaanstorm: folds 
Uncalled bet (400) returned to dfcastro.net
dfcastro.net collected 950 from pot
dfcastro.net: doesn't show hand 
*** SUMMARY ***
Total pot 950 | Rake 0 
Seat 3: dfcastro.net (big blind) collected (950)
Seat 6: johe62 (button) folded before Flop (didn't bet)
Seat 7: Orkaanstorm (small blind) folded before Flop



PokerStars Hand #97781298686: Tournament #725058424, $0.23+$0.02 USD Hold'em No Limit - Level XI (400/800) - 2013/04/27 17:31:30 BRT [2013/04/27 16:31:30 ET]
Table '725058424 4' 9-max Seat #7 is the button
Seat 3: dfcastro.net (25960 in chips) 
Seat 6: johe62 (9762 in chips) 
Seat 7: Orkaanstorm (31778 in chips) 
dfcastro.net: posts the ante 50
johe62: posts the ante 50
Orkaanstorm: posts the ante 50
dfcastro.net: posts small blind 400
johe62: posts big blind 800
*** HOLE CARDS ***
Dealt to dfcastro.net [3s Jh]
Orkaanstorm: raises 800 to 1600
dfcastro.net: folds 
johe62: folds 
Uncalled bet (800) returned to Orkaanstorm
Orkaanstorm collected 2150 from pot
*** SUMMARY ***
Total pot 2150 | Rake 0 
Seat 3: dfcastro.net (small blind) folded before Flop
Seat 6: johe62 (big blind) folded before Flop
Seat 7: Orkaanstorm (button) collected (2150)



PokerStars Hand #97781314893: Tournament #725058424, $0.23+$0.02 USD Hold'em No Limit - Level XI (400/800) - 2013/04/27 17:31:47 BRT [2013/04/27 16:31:47 ET]
Table '725058424 4' 9-max Seat #3 is the button
Seat 3: dfcastro.net (25510 in chips) 
Seat 6: johe62 (8912 in chips) 
Seat 7: Orkaanstorm (33078 in chips) 
dfcastro.net: posts the ante 50
johe62: posts the ante 50
Orkaanstorm: posts the ante 50
johe62: posts small blind 400
Orkaanstorm: posts big blind 800
*** HOLE CARDS ***
Dealt to dfcastro.net [5d Kd]
dfcastro.net: folds 
johe62: raises 800 to 1600
Orkaanstorm: calls 800
*** FLOP *** [Td Qs Tc]
johe62: checks 
Orkaanstorm: checks 
*** TURN *** [Td Qs Tc] [Ts]
johe62: bets 1600
Orkaanstorm: folds 
Uncalled bet (1600) returned to johe62
johe62 collected 3350 from pot
*** SUMMARY ***
Total pot 3350 | Rake 0 
Board [Td Qs Tc Ts]
Seat 3: dfcastro.net (button) folded before Flop (didn't bet)
Seat 6: johe62 (small blind) collected (3350)
Seat 7: Orkaanstorm (big blind) folded on the Turn



PokerStars Hand #97781343615: Tournament #725058424, $0.23+$0.02 USD Hold'em No Limit - Level XI (400/800) - 2013/04/27 17:32:18 BRT [2013/04/27 16:32:18 ET]
Table '725058424 4' 9-max Seat #6 is the button
Seat 3: dfcastro.net (25460 in chips) 
Seat 6: johe62 (10612 in chips) 
Seat 7: Orkaanstorm (31428 in chips) 
dfcastro.net: posts the ante 50
johe62: posts the ante 50
Orkaanstorm: posts the ante 50
Orkaanstorm: posts small blind 400
dfcastro.net: posts big blind 800
*** HOLE CARDS ***
Dealt to dfcastro.net [Td Jd]
johe62: folds 
Orkaanstorm: calls 400
dfcastro.net: checks 
*** FLOP *** [Kd 8d 3s]
Orkaanstorm: checks 
dfcastro.net: checks 
*** TURN *** [Kd 8d 3s] [6s]
Orkaanstorm: checks 
dfcastro.net: checks 
*** RIVER *** [Kd 8d 3s 6s] [Kc]
Orkaanstorm: bets 5600
dfcastro.net: folds 
Uncalled bet (5600) returned to Orkaanstorm
Orkaanstorm collected 1750 from pot
*** SUMMARY ***
Total pot 1750 | Rake 0 
Board [Kd 8d 3s 6s Kc]
Seat 3: dfcastro.net (big blind) folded on the River
Seat 6: johe62 (button) folded before Flop (didn't bet)
Seat 7: Orkaanstorm (small blind) collected (1750)



PokerStars Hand #97781370347: Tournament #725058424, $0.23+$0.02 USD Hold'em No Limit - Level XI (400/800) - 2013/04/27 17:32:47 BRT [2013/04/27 16:32:47 ET]
Table '725058424 4' 9-max Seat #7 is the button
Seat 3: dfcastro.net (24610 in chips) 
Seat 6: johe62 (10562 in chips) 
Seat 7: Orkaanstorm (32328 in chips) 
dfcastro.net: posts the ante 50
johe62: posts the ante 50
Orkaanstorm: posts the ante 50
dfcastro.net: posts small blind 400
johe62: posts big blind 800
*** HOLE CARDS ***
Dealt to dfcastro.net [5h 3c]
Orkaanstorm: folds 
dfcastro.net: folds 
Uncalled bet (400) returned to johe62
johe62 collected 950 from pot
*** SUMMARY ***
Total pot 950 | Rake 0 
Seat 3: dfcastro.net (small blind) folded before Flop
Seat 6: johe62 (big blind) collected (950)
Seat 7: Orkaanstorm (button) folded before Flop (didn't bet)



PokerStars Hand #97781377784: Tournament #725058424, $0.23+$0.02 USD Hold'em No Limit - Level XI (400/800) - 2013/04/27 17:32:55 BRT [2013/04/27 16:32:55 ET]
Table '725058424 4' 9-max Seat #3 is the button
Seat 3: dfcastro.net (24160 in chips) 
Seat 6: johe62 (11062 in chips) 
Seat 7: Orkaanstorm (32278 in chips) 
dfcastro.net: posts the ante 50
johe62: posts the ante 50
Orkaanstorm: posts the ante 50
johe62: posts small blind 400
Orkaanstorm: posts big blind 800
*** HOLE CARDS ***
Dealt to dfcastro.net [7c 5d]
dfcastro.net: folds 
johe62: raises 800 to 1600
Orkaanstorm: calls 800
*** FLOP *** [Td 7s 6c]
johe62: bets 1600
Orkaanstorm: calls 1600
*** TURN *** [Td 7s 6c] [5h]
johe62: checks 
Orkaanstorm: bets 3200
johe62: folds 
Uncalled bet (3200) returned to Orkaanstorm
Orkaanstorm collected 6550 from pot
*** SUMMARY ***
Total pot 6550 | Rake 0 
Board [Td 7s 6c 5h]
Seat 3: dfcastro.net (button) folded before Flop (didn't bet)
Seat 6: johe62 (small blind) folded on the Turn
Seat 7: Orkaanstorm (big blind) collected (6550)



PokerStars Hand #97781406351: Tournament #725058424, $0.23+$0.02 USD Hold'em No Limit - Level XI (400/800) - 2013/04/27 17:33:27 BRT [2013/04/27 16:33:27 ET]
Table '725058424 4' 9-max Seat #6 is the button
Seat 3: dfcastro.net (24110 in chips) 
Seat 6: johe62 (7812 in chips) 
Seat 7: Orkaanstorm (35578 in chips) 
dfcastro.net: posts the ante 50
johe62: posts the ante 50
Orkaanstorm: posts the ante 50
Orkaanstorm: posts small blind 400
dfcastro.net: posts big blind 800
*** HOLE CARDS ***
Dealt to dfcastro.net [5c 8h]
johe62: folds 
Orkaanstorm: calls 400
dfcastro.net: checks 
*** FLOP *** [Jh Ad 5h]
Orkaanstorm: checks 
dfcastro.net: checks 
*** TURN *** [Jh Ad 5h] [As]
Orkaanstorm: checks 
dfcastro.net: checks 
*** RIVER *** [Jh Ad 5h As] [2s]
Orkaanstorm: checks 
dfcastro.net: checks 
*** SHOW DOWN ***
Orkaanstorm: shows [Qd Ts] (a pair of Aces)
dfcastro.net: shows [5c 8h] (two pair, Aces and Fives)
dfcastro.net collected 1750 from pot
*** SUMMARY ***
Total pot 1750 | Rake 0 
Board [Jh Ad 5h As 2s]
Seat 3: dfcastro.net (big blind) showed [5c 8h] and won (1750) with two pair, Aces and Fives
Seat 6: johe62 (button) folded before Flop (didn't bet)
Seat 7: Orkaanstorm (small blind) showed [Qd Ts] and lost with a pair of Aces



PokerStars Hand #97781430063: Tournament #725058424, $0.23+$0.02 USD Hold'em No Limit - Level XI (400/800) - 2013/04/27 17:33:52 BRT [2013/04/27 16:33:52 ET]
Table '725058424 4' 9-max Seat #7 is the button
Seat 3: dfcastro.net (25010 in chips) 
Seat 6: johe62 (7762 in chips) 
Seat 7: Orkaanstorm (34728 in chips) 
dfcastro.net: posts the ante 50
johe62: posts the ante 50
Orkaanstorm: posts the ante 50
dfcastro.net: posts small blind 400
johe62: posts big blind 800
*** HOLE CARDS ***
Dealt to dfcastro.net [Ts 6s]
Orkaanstorm: folds 
dfcastro.net: folds 
Uncalled bet (400) returned to johe62
johe62 collected 950 from pot
*** SUMMARY ***
Total pot 950 | Rake 0 
Seat 3: dfcastro.net (small blind) folded before Flop
Seat 6: johe62 (big blind) collected (950)
Seat 7: Orkaanstorm (button) folded before Flop (didn't bet)



PokerStars Hand #97781438665: Tournament #725058424, $0.23+$0.02 USD Hold'em No Limit - Level XI (400/800) - 2013/04/27 17:34:02 BRT [2013/04/27 16:34:02 ET]
Table '725058424 4' 9-max Seat #3 is the button
Seat 3: dfcastro.net (24560 in chips) 
Seat 6: johe62 (8262 in chips) 
Seat 7: Orkaanstorm (34678 in chips) 
dfcastro.net: posts the ante 50
johe62: posts the ante 50
Orkaanstorm: posts the ante 50
johe62: posts small blind 400
Orkaanstorm: posts big blind 800
*** HOLE CARDS ***
Dealt to dfcastro.net [2s Jh]
dfcastro.net: folds 
johe62: folds 
Uncalled bet (400) returned to Orkaanstorm
Orkaanstorm collected 950 from pot
*** SUMMARY ***
Total pot 950 | Rake 0 
Seat 3: dfcastro.net (button) folded before Flop (didn't bet)
Seat 6: johe62 (small blind) folded before Flop
Seat 7: Orkaanstorm (big blind) collected (950)



PokerStars Hand #97781445991: Tournament #725058424, $0.23+$0.02 USD Hold'em No Limit - Level XI (400/800) - 2013/04/27 17:34:10 BRT [2013/04/27 16:34:10 ET]
Table '725058424 4' 9-max Seat #6 is the button
Seat 3: dfcastro.net (24510 in chips) 
Seat 6: johe62 (7812 in chips) 
Seat 7: Orkaanstorm (35178 in chips) 
dfcastro.net: posts the ante 50
johe62: posts the ante 50
Orkaanstorm: posts the ante 50
Orkaanstorm: posts small blind 400
dfcastro.net: posts big blind 800
*** HOLE CARDS ***
Dealt to dfcastro.net [3d 8s]
johe62: folds 
Orkaanstorm: raises 800 to 1600
dfcastro.net: folds 
Uncalled bet (800) returned to Orkaanstorm
Orkaanstorm collected 1750 from pot
*** SUMMARY ***
Total pot 1750 | Rake 0 
Seat 3: dfcastro.net (big blind) folded before Flop
Seat 6: johe62 (button) folded before Flop (didn't bet)
Seat 7: Orkaanstorm (small blind) collected (1750)



PokerStars Hand #97781454988: Tournament #725058424, $0.23+$0.02 USD Hold'em No Limit - Level XI (400/800) - 2013/04/27 17:34:20 BRT [2013/04/27 16:34:20 ET]
Table '725058424 4' 9-max Seat #7 is the button
Seat 3: dfcastro.net (23660 in chips) 
Seat 6: johe62 (7762 in chips) 
Seat 7: Orkaanstorm (36078 in chips) 
dfcastro.net: posts the ante 50
johe62: posts the ante 50
Orkaanstorm: posts the ante 50
dfcastro.net: posts small blind 400
johe62: posts big blind 800
*** HOLE CARDS ***
Dealt to dfcastro.net [Qh 3s]
Orkaanstorm: calls 800
dfcastro.net: folds 
johe62: checks 
*** FLOP *** [4h 7d Ac]
johe62: checks 
Orkaanstorm: bets 800
johe62: folds 
Uncalled bet (800) returned to Orkaanstorm
Orkaanstorm collected 2150 from pot
*** SUMMARY ***
Total pot 2150 | Rake 0 
Board [4h 7d Ac]
Seat 3: dfcastro.net (small blind) folded before Flop
Seat 6: johe62 (big blind) folded on the Flop
Seat 7: Orkaanstorm (button) collected (2150)



PokerStars Hand #97781470884: Tournament #725058424, $0.23+$0.02 USD Hold'em No Limit - Level XI (400/800) - 2013/04/27 17:34:37 BRT [2013/04/27 16:34:37 ET]
Table '725058424 4' 9-max Seat #3 is the button
Seat 3: dfcastro.net (23210 in chips) 
Seat 6: johe62 (6912 in chips) 
Seat 7: Orkaanstorm (37378 in chips) 
dfcastro.net: posts the ante 50
johe62: posts the ante 50
Orkaanstorm: posts the ante 50
johe62: posts small blind 400
Orkaanstorm: posts big blind 800
*** HOLE CARDS ***
Dealt to dfcastro.net [Ks 2s]
dfcastro.net: folds 
johe62: folds 
Uncalled bet (400) returned to Orkaanstorm
Orkaanstorm collected 950 from pot
*** SUMMARY ***
Total pot 950 | Rake 0 
Seat 3: dfcastro.net (button) folded before Flop (didn't bet)
Seat 6: johe62 (small blind) folded before Flop
Seat 7: Orkaanstorm (big blind) collected (950)



PokerStars Hand #97781477853: Tournament #725058424, $0.23+$0.02 USD Hold'em No Limit - Level XI (400/800) - 2013/04/27 17:34:45 BRT [2013/04/27 16:34:45 ET]
Table '725058424 4' 9-max Seat #6 is the button
Seat 3: dfcastro.net (23160 in chips) 
Seat 6: johe62 (6462 in chips) 
Seat 7: Orkaanstorm (37878 in chips) 
dfcastro.net: posts the ante 50
johe62: posts the ante 50
Orkaanstorm: posts the ante 50
Orkaanstorm: posts small blind 400
dfcastro.net: posts big blind 800
*** HOLE CARDS ***
Dealt to dfcastro.net [Js 5c]
johe62: folds 
Orkaanstorm: folds 
Uncalled bet (400) returned to dfcastro.net
dfcastro.net collected 950 from pot
dfcastro.net: doesn't show hand 
*** SUMMARY ***
Total pot 950 | Rake 0 
Seat 3: dfcastro.net (big blind) collected (950)
Seat 6: johe62 (button) folded before Flop (didn't bet)
Seat 7: Orkaanstorm (small blind) folded before Flop



PokerStars Hand #97781486039: Tournament #725058424, $0.23+$0.02 USD Hold'em No Limit - Level XI (400/800) - 2013/04/27 17:34:54 BRT [2013/04/27 16:34:54 ET]
Table '725058424 4' 9-max Seat #7 is the button
Seat 3: dfcastro.net (23660 in chips) 
Seat 6: johe62 (6412 in chips) 
Seat 7: Orkaanstorm (37428 in chips) 
dfcastro.net: posts the ante 50
johe62: posts the ante 50
Orkaanstorm: posts the ante 50
dfcastro.net: posts small blind 400
johe62: posts big blind 800
*** HOLE CARDS ***
Dealt to dfcastro.net [Qs Qh]
Orkaanstorm: calls 800
dfcastro.net: raises 800 to 1600
johe62: calls 800
Orkaanstorm: calls 800
*** FLOP *** [Kh Jh Qc]
dfcastro.net: checks 
johe62: checks 
Orkaanstorm: checks 
*** TURN *** [Kh Jh Qc] [4s]
dfcastro.net: bets 800
johe62: raises 800 to 1600
Orkaanstorm: folds 
dfcastro.net: raises 800 to 2400
johe62: raises 2362 to 4762 and is all-in
dfcastro.net: calls 2362
*** RIVER *** [Kh Jh Qc 4s] [7s]
*** SHOW DOWN ***
dfcastro.net: shows [Qs Qh] (three of a kind, Queens)
johe62: shows [Ts 9s] (a straight, Nine to King)
johe62 collected 14474 from pot
*** SUMMARY ***
Total pot 14474 | Rake 0 
Board [Kh Jh Qc 4s 7s]
Seat 3: dfcastro.net (small blind) showed [Qs Qh] and lost with three of a kind, Queens
Seat 6: johe62 (big blind) showed [Ts 9s] and won (14474) with a straight, Nine to King
Seat 7: Orkaanstorm (button) folded on the Turn



PokerStars Hand #97781526201: Tournament #725058424, $0.23+$0.02 USD Hold'em No Limit - Level XI (400/800) - 2013/04/27 17:35:38 BRT [2013/04/27 16:35:38 ET]
Table '725058424 4' 9-max Seat #3 is the button
Seat 3: dfcastro.net (17248 in chips) 
Seat 6: johe62 (14474 in chips) 
Seat 7: Orkaanstorm (35778 in chips) 
dfcastro.net: posts the ante 50
johe62: posts the ante 50
Orkaanstorm: posts the ante 50
johe62: posts small blind 400
Orkaanstorm: posts big blind 800
*** HOLE CARDS ***
Dealt to dfcastro.net [4c 2s]
Orkaanstorm said, "nh"
dfcastro.net: folds 
johe62: folds 
Uncalled bet (400) returned to Orkaanstorm
Orkaanstorm collected 950 from pot
*** SUMMARY ***
Total pot 950 | Rake 0 
Seat 3: dfcastro.net (button) folded before Flop (didn't bet)
Seat 6: johe62 (small blind) folded before Flop
Seat 7: Orkaanstorm (big blind) collected (950)



PokerStars Hand #97781536704: Tournament #725058424, $0.23+$0.02 USD Hold'em No Limit - Level XI (400/800) - 2013/04/27 17:35:50 BRT [2013/04/27 16:35:50 ET]
Table '725058424 4' 9-max Seat #6 is the button
Seat 3: dfcastro.net (17198 in chips) 
Seat 6: johe62 (14024 in chips) 
Seat 7: Orkaanstorm (36278 in chips) 
dfcastro.net: posts the ante 50
johe62: posts the ante 50
Orkaanstorm: posts the ante 50
Orkaanstorm: posts small blind 400
dfcastro.net: posts big blind 800
*** HOLE CARDS ***
Dealt to dfcastro.net [4d Ac]
johe62: raises 800 to 1600
Orkaanstorm: folds 
dfcastro.net: folds 
Uncalled bet (800) returned to johe62
johe62 collected 2150 from pot
*** SUMMARY ***
Total pot 2150 | Rake 0 
Seat 3: dfcastro.net (big blind) folded before Flop
Seat 6: johe62 (button) collected (2150)
Seat 7: Orkaanstorm (small blind) folded before Flop



PokerStars Hand #97781547023: Tournament #725058424, $0.23+$0.02 USD Hold'em No Limit - Level XI (400/800) - 2013/04/27 17:36:01 BRT [2013/04/27 16:36:01 ET]
Table '725058424 4' 9-max Seat #7 is the button
Seat 3: dfcastro.net (16348 in chips) 
Seat 6: johe62 (15324 in chips) 
Seat 7: Orkaanstorm (35828 in chips) 
dfcastro.net: posts the ante 50
johe62: posts the ante 50
Orkaanstorm: posts the ante 50
dfcastro.net: posts small blind 400
johe62: posts big blind 800
*** HOLE CARDS ***
Dealt to dfcastro.net [Kc Jc]
Orkaanstorm: raises 800 to 1600
dfcastro.net: folds 
johe62: calls 800
*** FLOP *** [7d 6c 6h]
johe62: checks 
Orkaanstorm: bets 800
johe62: folds 
Uncalled bet (800) returned to Orkaanstorm
Orkaanstorm collected 3750 from pot
*** SUMMARY ***
Total pot 3750 | Rake 0 
Board [7d 6c 6h]
Seat 3: dfcastro.net (small blind) folded before Flop
Seat 6: johe62 (big blind) folded on the Flop
Seat 7: Orkaanstorm (button) collected (3750)



PokerStars Hand #97781570826: Tournament #725058424, $0.23+$0.02 USD Hold'em No Limit - Level XI (400/800) - 2013/04/27 17:36:27 BRT [2013/04/27 16:36:27 ET]
Table '725058424 4' 9-max Seat #3 is the button
Seat 3: dfcastro.net (15898 in chips) 
Seat 6: johe62 (13674 in chips) 
Seat 7: Orkaanstorm (37928 in chips) 
dfcastro.net: posts the ante 50
johe62: posts the ante 50
Orkaanstorm: posts the ante 50
johe62: posts small blind 400
Orkaanstorm: posts big blind 800
*** HOLE CARDS ***
Dealt to dfcastro.net [Kc Ah]
dfcastro.net: raises 800 to 1600
johe62: folds 
Orkaanstorm: calls 800
*** FLOP *** [As Qs Kh]
Orkaanstorm: checks 
dfcastro.net: bets 1600
Orkaanstorm: folds 
Uncalled bet (1600) returned to dfcastro.net
dfcastro.net collected 3750 from pot
dfcastro.net: doesn't show hand 
*** SUMMARY ***
Total pot 3750 | Rake 0 
Board [As Qs Kh]
Seat 3: dfcastro.net (button) collected (3750)
Seat 6: johe62 (small blind) folded before Flop
Seat 7: Orkaanstorm (big blind) folded on the Flop



PokerStars Hand #97781591941: Tournament #725058424, $0.23+$0.02 USD Hold'em No Limit - Level XI (400/800) - 2013/04/27 17:36:51 BRT [2013/04/27 16:36:51 ET]
Table '725058424 4' 9-max Seat #6 is the button
Seat 3: dfcastro.net (17998 in chips) 
Seat 6: johe62 (13224 in chips) 
Seat 7: Orkaanstorm (36278 in chips) 
dfcastro.net: posts the ante 50
johe62: posts the ante 50
Orkaanstorm: posts the ante 50
Orkaanstorm: posts small blind 400
dfcastro.net: posts big blind 800
*** HOLE CARDS ***
Dealt to dfcastro.net [2c Kd]
johe62: folds 
Orkaanstorm: folds 
Uncalled bet (400) returned to dfcastro.net
dfcastro.net collected 950 from pot
dfcastro.net: doesn't show hand 
*** SUMMARY ***
Total pot 950 | Rake 0 
Seat 3: dfcastro.net (big blind) collected (950)
Seat 6: johe62 (button) folded before Flop (didn't bet)
Seat 7: Orkaanstorm (small blind) folded before Flop



PokerStars Hand #97781602417: Tournament #725058424, $0.23+$0.02 USD Hold'em No Limit - Level XI (400/800) - 2013/04/27 17:37:02 BRT [2013/04/27 16:37:02 ET]
Table '725058424 4' 9-max Seat #7 is the button
Seat 3: dfcastro.net (18498 in chips) 
Seat 6: johe62 (13174 in chips) 
Seat 7: Orkaanstorm (35828 in chips) 
dfcastro.net: posts the ante 50
johe62: posts the ante 50
Orkaanstorm: posts the ante 50
dfcastro.net: posts small blind 400
johe62: posts big blind 800
*** HOLE CARDS ***
Dealt to dfcastro.net [Ad Ks]
Orkaanstorm: folds 
dfcastro.net: raises 800 to 1600
johe62: folds 
Uncalled bet (800) returned to dfcastro.net
dfcastro.net collected 1750 from pot
dfcastro.net: doesn't show hand 
*** SUMMARY ***
Total pot 1750 | Rake 0 
Seat 3: dfcastro.net (small blind) collected (1750)
Seat 6: johe62 (big blind) folded before Flop
Seat 7: Orkaanstorm (button) folded before Flop (didn't bet)



PokerStars Hand #97781610235: Tournament #725058424, $0.23+$0.02 USD Hold'em No Limit - Level XI (400/800) - 2013/04/27 17:37:11 BRT [2013/04/27 16:37:11 ET]
Table '725058424 4' 9-max Seat #3 is the button
Seat 3: dfcastro.net (19398 in chips) 
Seat 6: johe62 (12324 in chips) 
Seat 7: Orkaanstorm (35778 in chips) 
dfcastro.net: posts the ante 50
johe62: posts the ante 50
Orkaanstorm: posts the ante 50
johe62: posts small blind 400
Orkaanstorm: posts big blind 800
*** HOLE CARDS ***
Dealt to dfcastro.net [2h Ts]
dfcastro.net: folds 
johe62: folds 
Uncalled bet (400) returned to Orkaanstorm
Orkaanstorm collected 950 from pot
*** SUMMARY ***
Total pot 950 | Rake 0 
Seat 3: dfcastro.net (button) folded before Flop (didn't bet)
Seat 6: johe62 (small blind) folded before Flop
Seat 7: Orkaanstorm (big blind) collected (950)



PokerStars Hand #97781619272: Tournament #725058424, $0.23+$0.02 USD Hold'em No Limit - Level XI (400/800) - 2013/04/27 17:37:21 BRT [2013/04/27 16:37:21 ET]
Table '725058424 4' 9-max Seat #6 is the button
Seat 3: dfcastro.net (19348 in chips) 
Seat 6: johe62 (11874 in chips) 
Seat 7: Orkaanstorm (36278 in chips) 
dfcastro.net: posts the ante 50
johe62: posts the ante 50
Orkaanstorm: posts the ante 50
Orkaanstorm: posts small blind 400
dfcastro.net: posts big blind 800
*** HOLE CARDS ***
Dealt to dfcastro.net [8d 8h]
johe62: raises 800 to 1600
Orkaanstorm: folds 
dfcastro.net: raises 3000 to 4600
johe62: folds 
Uncalled bet (3000) returned to dfcastro.net
dfcastro.net collected 3750 from pot
dfcastro.net: doesn't show hand 
*** SUMMARY ***
Total pot 3750 | Rake 0 
Seat 3: dfcastro.net (big blind) collected (3750)
Seat 6: johe62 (button) folded before Flop
Seat 7: Orkaanstorm (small blind) folded before Flop



PokerStars Hand #97781640884: Tournament #725058424, $0.23+$0.02 USD Hold'em No Limit - Level XI (400/800) - 2013/04/27 17:37:45 BRT [2013/04/27 16:37:45 ET]
Table '725058424 4' 9-max Seat #7 is the button
Seat 3: dfcastro.net (21448 in chips) 
Seat 6: johe62 (10224 in chips) 
Seat 7: Orkaanstorm (35828 in chips) 
dfcastro.net: posts the ante 50
johe62: posts the ante 50
Orkaanstorm: posts the ante 50
dfcastro.net: posts small blind 400
johe62: posts big blind 800
*** HOLE CARDS ***
Dealt to dfcastro.net [2d 7d]
Orkaanstorm: folds 
dfcastro.net: folds 
Uncalled bet (400) returned to johe62
johe62 collected 950 from pot
*** SUMMARY ***
Total pot 950 | Rake 0 
Seat 3: dfcastro.net (small blind) folded before Flop
Seat 6: johe62 (big blind) collected (950)
Seat 7: Orkaanstorm (button) folded before Flop (didn't bet)



PokerStars Hand #97781648825: Tournament #725058424, $0.23+$0.02 USD Hold'em No Limit - Level XI (400/800) - 2013/04/27 17:37:54 BRT [2013/04/27 16:37:54 ET]
Table '725058424 4' 9-max Seat #3 is the button
Seat 3: dfcastro.net (20998 in chips) 
Seat 6: johe62 (10724 in chips) 
Seat 7: Orkaanstorm (35778 in chips) 
dfcastro.net: posts the ante 50
johe62: posts the ante 50
Orkaanstorm: posts the ante 50
johe62: posts small blind 400
Orkaanstorm: posts big blind 800
*** HOLE CARDS ***
Dealt to dfcastro.net [3c Jd]
dfcastro.net: folds 
johe62: folds 
Uncalled bet (400) returned to Orkaanstorm
Orkaanstorm collected 950 from pot
*** SUMMARY ***
Total pot 950 | Rake 0 
Seat 3: dfcastro.net (button) folded before Flop (didn't bet)
Seat 6: johe62 (small blind) folded before Flop
Seat 7: Orkaanstorm (big blind) collected (950)



PokerStars Hand #97781657385: Tournament #725058424, $0.23+$0.02 USD Hold'em No Limit - Level XI (400/800) - 2013/04/27 17:38:04 BRT [2013/04/27 16:38:04 ET]
Table '725058424 4' 9-max Seat #6 is the button
Seat 3: dfcastro.net (20948 in chips) 
Seat 6: johe62 (10274 in chips) 
Seat 7: Orkaanstorm (36278 in chips) 
dfcastro.net: posts the ante 50
johe62: posts the ante 50
Orkaanstorm: posts the ante 50
Orkaanstorm: posts small blind 400
dfcastro.net: posts big blind 800
*** HOLE CARDS ***
Dealt to dfcastro.net [9s 6d]
johe62: folds 
Orkaanstorm: calls 400
dfcastro.net: checks 
*** FLOP *** [Qh Th Td]
Orkaanstorm: checks 
dfcastro.net: checks 
*** TURN *** [Qh Th Td] [7c]
Orkaanstorm: bets 4000
dfcastro.net: folds 
Uncalled bet (4000) returned to Orkaanstorm
Orkaanstorm collected 1750 from pot
*** SUMMARY ***
Total pot 1750 | Rake 0 
Board [Qh Th Td 7c]
Seat 3: dfcastro.net (big blind) folded on the Turn
Seat 6: johe62 (button) folded before Flop (didn't bet)
Seat 7: Orkaanstorm (small blind) collected (1750)



PokerStars Hand #97781677402: Tournament #725058424, $0.23+$0.02 USD Hold'em No Limit - Level XI (400/800) - 2013/04/27 17:38:26 BRT [2013/04/27 16:38:26 ET]
Table '725058424 4' 9-max Seat #7 is the button
Seat 3: dfcastro.net (20098 in chips) 
Seat 6: johe62 (10224 in chips) 
Seat 7: Orkaanstorm (37178 in chips) 
dfcastro.net: posts the ante 50
johe62: posts the ante 50
Orkaanstorm: posts the ante 50
dfcastro.net: posts small blind 400
johe62: posts big blind 800
*** HOLE CARDS ***
Dealt to dfcastro.net [Ad 4c]
Orkaanstorm: folds 
dfcastro.net: folds 
Uncalled bet (400) returned to johe62
johe62 collected 950 from pot
*** SUMMARY ***
Total pot 950 | Rake 0 
Seat 3: dfcastro.net (small blind) folded before Flop
Seat 6: johe62 (big blind) collected (950)
Seat 7: Orkaanstorm (button) folded before Flop (didn't bet)



PokerStars Hand #97781687956: Tournament #725058424, $0.23+$0.02 USD Hold'em No Limit - Level XI (400/800) - 2013/04/27 17:38:38 BRT [2013/04/27 16:38:38 ET]
Table '725058424 4' 9-max Seat #3 is the button
Seat 3: dfcastro.net (19648 in chips) 
Seat 6: johe62 (10724 in chips) 
Seat 7: Orkaanstorm (37128 in chips) 
dfcastro.net: posts the ante 50
johe62: posts the ante 50
Orkaanstorm: posts the ante 50
johe62: posts small blind 400
Orkaanstorm: posts big blind 800
*** HOLE CARDS ***
Dealt to dfcastro.net [5d 8h]
dfcastro.net: folds 
johe62: folds 
Uncalled bet (400) returned to Orkaanstorm
Orkaanstorm collected 950 from pot
*** SUMMARY ***
Total pot 950 | Rake 0 
Seat 3: dfcastro.net (button) folded before Flop (didn't bet)
Seat 6: johe62 (small blind) folded before Flop
Seat 7: Orkaanstorm (big blind) collected (950)



PokerStars Hand #97781695341: Tournament #725058424, $0.23+$0.02 USD Hold'em No Limit - Level XI (400/800) - 2013/04/27 17:38:46 BRT [2013/04/27 16:38:46 ET]
Table '725058424 4' 9-max Seat #6 is the button
Seat 3: dfcastro.net (19598 in chips) 
Seat 6: johe62 (10274 in chips) 
Seat 7: Orkaanstorm (37628 in chips) 
dfcastro.net: posts the ante 50
johe62: posts the ante 50
Orkaanstorm: posts the ante 50
Orkaanstorm: posts small blind 400
dfcastro.net: posts big blind 800
*** HOLE CARDS ***
Dealt to dfcastro.net [Th 8d]
johe62: folds 
Orkaanstorm: folds 
Uncalled bet (400) returned to dfcastro.net
dfcastro.net collected 950 from pot
dfcastro.net: doesn't show hand 
*** SUMMARY ***
Total pot 950 | Rake 0 
Seat 3: dfcastro.net (big blind) collected (950)
Seat 6: johe62 (button) folded before Flop (didn't bet)
Seat 7: Orkaanstorm (small blind) folded before Flop



PokerStars Hand #97781711712: Tournament #725058424, $0.23+$0.02 USD Hold'em No Limit - Level XI (400/800) - 2013/04/27 17:39:05 BRT [2013/04/27 16:39:05 ET]
Table '725058424 4' 9-max Seat #7 is the button
Seat 3: dfcastro.net (20098 in chips) 
Seat 6: johe62 (10224 in chips) 
Seat 7: Orkaanstorm (37178 in chips) 
dfcastro.net: posts the ante 50
johe62: posts the ante 50
Orkaanstorm: posts the ante 50
dfcastro.net: posts small blind 400
johe62: posts big blind 800
*** HOLE CARDS ***
Dealt to dfcastro.net [5s Jh]
Orkaanstorm: folds 
dfcastro.net: folds 
Uncalled bet (400) returned to johe62
johe62 collected 950 from pot
*** SUMMARY ***
Total pot 950 | Rake 0 
Seat 3: dfcastro.net (small blind) folded before Flop
Seat 6: johe62 (big blind) collected (950)
Seat 7: Orkaanstorm (button) folded before Flop (didn't bet)



PokerStars Hand #97781719192: Tournament #725058424, $0.23+$0.02 USD Hold'em No Limit - Level XI (400/800) - 2013/04/27 17:39:13 BRT [2013/04/27 16:39:13 ET]
Table '725058424 4' 9-max Seat #3 is the button
Seat 3: dfcastro.net (19648 in chips) 
Seat 6: johe62 (10724 in chips) 
Seat 7: Orkaanstorm (37128 in chips) 
dfcastro.net: posts the ante 50
johe62: posts the ante 50
Orkaanstorm: posts the ante 50
johe62: posts small blind 400
Orkaanstorm: posts big blind 800
*** HOLE CARDS ***
Dealt to dfcastro.net [2s 6s]
dfcastro.net: folds 
johe62: raises 800 to 1600
Orkaanstorm: calls 800
*** FLOP *** [2d Kd 9d]
johe62: bets 1600
Orkaanstorm: folds 
Uncalled bet (1600) returned to johe62
johe62 collected 3350 from pot
*** SUMMARY ***
Total pot 3350 | Rake 0 
Board [2d Kd 9d]
Seat 3: dfcastro.net (button) folded before Flop (didn't bet)
Seat 6: johe62 (small blind) collected (3350)
Seat 7: Orkaanstorm (big blind) folded on the Flop



PokerStars Hand #97781731948: Tournament #725058424, $0.23+$0.02 USD Hold'em No Limit - Level XI (400/800) - 2013/04/27 17:39:28 BRT [2013/04/27 16:39:28 ET]
Table '725058424 4' 9-max Seat #6 is the button
Seat 3: dfcastro.net (19598 in chips) 
Seat 6: johe62 (12424 in chips) 
Seat 7: Orkaanstorm (35478 in chips) 
dfcastro.net: posts the ante 50
johe62: posts the ante 50
Orkaanstorm: posts the ante 50
Orkaanstorm: posts small blind 400
dfcastro.net: posts big blind 800
*** HOLE CARDS ***
Dealt to dfcastro.net [7c 4s]
johe62: raises 800 to 1600
Orkaanstorm: folds 
dfcastro.net: folds 
Uncalled bet (800) returned to johe62
johe62 collected 2150 from pot
*** SUMMARY ***
Total pot 2150 | Rake 0 
Seat 3: dfcastro.net (big blind) folded before Flop
Seat 6: johe62 (button) collected (2150)
Seat 7: Orkaanstorm (small blind) folded before Flop



PokerStars Hand #97781740297: Tournament #725058424, $0.23+$0.02 USD Hold'em No Limit - Level XI (400/800) - 2013/04/27 17:39:37 BRT [2013/04/27 16:39:37 ET]
Table '725058424 4' 9-max Seat #7 is the button
Seat 3: dfcastro.net (18748 in chips) 
Seat 6: johe62 (13724 in chips) 
Seat 7: Orkaanstorm (35028 in chips) 
dfcastro.net: posts the ante 50
johe62: posts the ante 50
Orkaanstorm: posts the ante 50
dfcastro.net: posts small blind 400
johe62: posts big blind 800
*** HOLE CARDS ***
Dealt to dfcastro.net [As 2d]
Orkaanstorm: folds 
dfcastro.net: folds 
Uncalled bet (400) returned to johe62
johe62 collected 950 from pot
*** SUMMARY ***
Total pot 950 | Rake 0 
Seat 3: dfcastro.net (small blind) folded before Flop
Seat 6: johe62 (big blind) collected (950)
Seat 7: Orkaanstorm (button) folded before Flop (didn't bet)



PokerStars Hand #97781747985: Tournament #725058424, $0.23+$0.02 USD Hold'em No Limit - Level XI (400/800) - 2013/04/27 17:39:45 BRT [2013/04/27 16:39:45 ET]
Table '725058424 4' 9-max Seat #3 is the button
Seat 3: dfcastro.net (18298 in chips) 
Seat 6: johe62 (14224 in chips) 
Seat 7: Orkaanstorm (34978 in chips) 
dfcastro.net: posts the ante 50
johe62: posts the ante 50
Orkaanstorm: posts the ante 50
johe62: posts small blind 400
Orkaanstorm: posts big blind 800
*** HOLE CARDS ***
Dealt to dfcastro.net [2d Jh]
dfcastro.net: folds 
johe62: raises 800 to 1600
Orkaanstorm: calls 800
*** FLOP *** [Qc Th 8d]
johe62: bets 1600
Orkaanstorm: raises 6400 to 8000
johe62: folds 
Uncalled bet (6400) returned to Orkaanstorm
Orkaanstorm collected 6550 from pot
*** SUMMARY ***
Total pot 6550 | Rake 0 
Board [Qc Th 8d]
Seat 3: dfcastro.net (button) folded before Flop (didn't bet)
Seat 6: johe62 (small blind) folded on the Flop
Seat 7: Orkaanstorm (big blind) collected (6550)



PokerStars Hand #97781773767: Tournament #725058424, $0.23+$0.02 USD Hold'em No Limit - Level XI (400/800) - 2013/04/27 17:40:14 BRT [2013/04/27 16:40:14 ET]
Table '725058424 4' 9-max Seat #6 is the button
Seat 3: dfcastro.net (18248 in chips) 
Seat 6: johe62 (10974 in chips) 
Seat 7: Orkaanstorm (38278 in chips) 
dfcastro.net: posts the ante 50
johe62: posts the ante 50
Orkaanstorm: posts the ante 50
Orkaanstorm: posts small blind 400
dfcastro.net: posts big blind 800
*** HOLE CARDS ***
Dealt to dfcastro.net [3c 7h]
johe62: folds 
Orkaanstorm: folds 
Uncalled bet (400) returned to dfcastro.net
dfcastro.net collected 950 from pot
dfcastro.net: doesn't show hand 
*** SUMMARY ***
Total pot 950 | Rake 0 
Seat 3: dfcastro.net (big blind) collected (950)
Seat 6: johe62 (button) folded before Flop (didn't bet)
Seat 7: Orkaanstorm (small blind) folded before Flop



PokerStars Hand #97781780047: Tournament #725058424, $0.23+$0.02 USD Hold'em No Limit - Level XI (400/800) - 2013/04/27 17:40:21 BRT [2013/04/27 16:40:21 ET]
Table '725058424 4' 9-max Seat #7 is the button
Seat 3: dfcastro.net (18748 in chips) 
Seat 6: johe62 (10924 in chips) 
Seat 7: Orkaanstorm (37828 in chips) 
dfcastro.net: posts the ante 50
johe62: posts the ante 50
Orkaanstorm: posts the ante 50
dfcastro.net: posts small blind 400
johe62: posts big blind 800
*** HOLE CARDS ***
Dealt to dfcastro.net [3d Td]
Orkaanstorm: calls 800
dfcastro.net: folds 
johe62: checks 
*** FLOP *** [9c 9s Qc]
johe62: checks 
Orkaanstorm: bets 800
johe62: calls 800
*** TURN *** [9c 9s Qc] [5d]
johe62: checks 
Orkaanstorm: checks 
*** RIVER *** [9c 9s Qc 5d] [Jd]
johe62: checks 
Orkaanstorm: checks 
*** SHOW DOWN ***
johe62: shows [4s Qs] (two pair, Queens and Nines)
Orkaanstorm: mucks hand 
johe62 collected 3750 from pot
*** SUMMARY ***
Total pot 3750 | Rake 0 
Board [9c 9s Qc 5d Jd]
Seat 3: dfcastro.net (small blind) folded before Flop
Seat 6: johe62 (big blind) showed [4s Qs] and won (3750) with two pair, Queens and Nines
Seat 7: Orkaanstorm (button) mucked [8c Ah]



PokerStars Hand #97781806381: Tournament #725058424, $0.23+$0.02 USD Hold'em No Limit - Level XII (500/1000) - 2013/04/27 17:40:50 BRT [2013/04/27 16:40:50 ET]
Table '725058424 4' 9-max Seat #3 is the button
Seat 3: dfcastro.net (18298 in chips) 
Seat 6: johe62 (13024 in chips) 
Seat 7: Orkaanstorm (36178 in chips) 
dfcastro.net: posts the ante 60
johe62: posts the ante 60
Orkaanstorm: posts the ante 60
johe62: posts small blind 500
Orkaanstorm: posts big blind 1000
*** HOLE CARDS ***
Dealt to dfcastro.net [Kd Qd]
dfcastro.net: raises 1000 to 2000
johe62: folds 
Orkaanstorm: calls 1000
*** FLOP *** [4s 8c 5h]
Orkaanstorm: checks 
dfcastro.net: bets 3000
Orkaanstorm: calls 3000
*** TURN *** [4s 8c 5h] [3h]
Orkaanstorm: checks 
dfcastro.net: checks 
*** RIVER *** [4s 8c 5h 3h] [Ks]
Orkaanstorm: checks 
dfcastro.net: bets 5000
Orkaanstorm: calls 5000
*** SHOW DOWN ***
dfcastro.net: shows [Kd Qd] (a pair of Kings)
Orkaanstorm: mucks hand 
dfcastro.net collected 20680 from pot
*** SUMMARY ***
Total pot 20680 | Rake 0 
Board [4s 8c 5h 3h Ks]
Seat 3: dfcastro.net (button) showed [Kd Qd] and won (20680) with a pair of Kings
Seat 6: johe62 (small blind) folded before Flop
Seat 7: Orkaanstorm (big blind) mucked [Ah Ts]



PokerStars Hand #97781840831: Tournament #725058424, $0.23+$0.02 USD Hold'em No Limit - Level XII (500/1000) - 2013/04/27 17:41:28 BRT [2013/04/27 16:41:28 ET]
Table '725058424 4' 9-max Seat #6 is the button
Seat 3: dfcastro.net (28918 in chips) 
Seat 6: johe62 (12464 in chips) 
Seat 7: Orkaanstorm (26118 in chips) 
dfcastro.net: posts the ante 60
johe62: posts the ante 60
Orkaanstorm: posts the ante 60
Orkaanstorm: posts small blind 500
dfcastro.net: posts big blind 1000
*** HOLE CARDS ***
Dealt to dfcastro.net [2c Ad]
johe62: raises 1000 to 2000
Orkaanstorm: folds 
dfcastro.net: folds 
Uncalled bet (1000) returned to johe62
johe62 collected 2680 from pot
*** SUMMARY ***
Total pot 2680 | Rake 0 
Seat 3: dfcastro.net (big blind) folded before Flop
Seat 6: johe62 (button) collected (2680)
Seat 7: Orkaanstorm (small blind) folded before Flop



PokerStars Hand #97781851589: Tournament #725058424, $0.23+$0.02 USD Hold'em No Limit - Level XII (500/1000) - 2013/04/27 17:41:40 BRT [2013/04/27 16:41:40 ET]
Table '725058424 4' 9-max Seat #7 is the button
Seat 3: dfcastro.net (27858 in chips) 
Seat 6: johe62 (14084 in chips) 
Seat 7: Orkaanstorm (25558 in chips) 
dfcastro.net: posts the ante 60
johe62: posts the ante 60
Orkaanstorm: posts the ante 60
dfcastro.net: posts small blind 500
johe62: posts big blind 1000
*** HOLE CARDS ***
Dealt to dfcastro.net [2d 7s]
Orkaanstorm: raises 1000 to 2000
dfcastro.net: folds 
johe62: folds 
Uncalled bet (1000) returned to Orkaanstorm
Orkaanstorm collected 2680 from pot
*** SUMMARY ***
Total pot 2680 | Rake 0 
Seat 3: dfcastro.net (small blind) folded before Flop
Seat 6: johe62 (big blind) folded before Flop
Seat 7: Orkaanstorm (button) collected (2680)



PokerStars Hand #97781859633: Tournament #725058424, $0.23+$0.02 USD Hold'em No Limit - Level XII (500/1000) - 2013/04/27 17:41:49 BRT [2013/04/27 16:41:49 ET]
Table '725058424 4' 9-max Seat #3 is the button
Seat 3: dfcastro.net (27298 in chips) 
Seat 6: johe62 (13024 in chips) 
Seat 7: Orkaanstorm (27178 in chips) 
dfcastro.net: posts the ante 60
johe62: posts the ante 60
Orkaanstorm: posts the ante 60
johe62: posts small blind 500
Orkaanstorm: posts big blind 1000
*** HOLE CARDS ***
Dealt to dfcastro.net [7c Ts]
dfcastro.net: folds 
johe62: raises 1000 to 2000
Orkaanstorm: raises 6000 to 8000
johe62: folds 
Uncalled bet (6000) returned to Orkaanstorm
Orkaanstorm collected 4180 from pot
*** SUMMARY ***
Total pot 4180 | Rake 0 
Seat 3: dfcastro.net (button) folded before Flop (didn't bet)
Seat 6: johe62 (small blind) folded before Flop
Seat 7: Orkaanstorm (big blind) collected (4180)



PokerStars Hand #97781875288: Tournament #725058424, $0.23+$0.02 USD Hold'em No Limit - Level XII (500/1000) - 2013/04/27 17:42:06 BRT [2013/04/27 16:42:06 ET]
Table '725058424 4' 9-max Seat #6 is the button
Seat 3: dfcastro.net (27238 in chips) 
Seat 6: johe62 (10964 in chips) 
Seat 7: Orkaanstorm (29298 in chips) 
dfcastro.net: posts the ante 60
johe62: posts the ante 60
Orkaanstorm: posts the ante 60
Orkaanstorm: posts small blind 500
dfcastro.net: posts big blind 1000
*** HOLE CARDS ***
Dealt to dfcastro.net [Kd Jc]
johe62: folds 
Orkaanstorm: folds 
Uncalled bet (500) returned to dfcastro.net
dfcastro.net collected 1180 from pot
dfcastro.net: doesn't show hand 
*** SUMMARY ***
Total pot 1180 | Rake 0 
Seat 3: dfcastro.net (big blind) collected (1180)
Seat 6: johe62 (button) folded before Flop (didn't bet)
Seat 7: Orkaanstorm (small blind) folded before Flop



PokerStars Hand #97781880907: Tournament #725058424, $0.23+$0.02 USD Hold'em No Limit - Level XII (500/1000) - 2013/04/27 17:42:12 BRT [2013/04/27 16:42:12 ET]
Table '725058424 4' 9-max Seat #7 is the button
Seat 3: dfcastro.net (27858 in chips) 
Seat 6: johe62 (10904 in chips) 
Seat 7: Orkaanstorm (28738 in chips) 
dfcastro.net: posts the ante 60
johe62: posts the ante 60
Orkaanstorm: posts the ante 60
dfcastro.net: posts small blind 500
johe62: posts big blind 1000
*** HOLE CARDS ***
Dealt to dfcastro.net [4s Th]
Orkaanstorm: folds 
dfcastro.net: folds 
Uncalled bet (500) returned to johe62
johe62 collected 1180 from pot
*** SUMMARY ***
Total pot 1180 | Rake 0 
Seat 3: dfcastro.net (small blind) folded before Flop
Seat 6: johe62 (big blind) collected (1180)
Seat 7: Orkaanstorm (button) folded before Flop (didn't bet)



PokerStars Hand #97781888076: Tournament #725058424, $0.23+$0.02 USD Hold'em No Limit - Level XII (500/1000) - 2013/04/27 17:42:20 BRT [2013/04/27 16:42:20 ET]
Table '725058424 4' 9-max Seat #3 is the button
Seat 3: dfcastro.net (27298 in chips) 
Seat 6: johe62 (11524 in chips) 
Seat 7: Orkaanstorm (28678 in chips) 
dfcastro.net: posts the ante 60
johe62: posts the ante 60
Orkaanstorm: posts the ante 60
johe62: posts small blind 500
Orkaanstorm: posts big blind 1000
*** HOLE CARDS ***
Dealt to dfcastro.net [Kh 4s]
dfcastro.net: folds 
johe62: raises 1000 to 2000
Orkaanstorm: calls 1000
*** FLOP *** [5h 4c 4h]
johe62: bets 2000
Orkaanstorm: raises 10000 to 12000
johe62: folds 
Uncalled bet (10000) returned to Orkaanstorm
Orkaanstorm collected 8180 from pot
*** SUMMARY ***
Total pot 8180 | Rake 0 
Board [5h 4c 4h]
Seat 3: dfcastro.net (button) folded before Flop (didn't bet)
Seat 6: johe62 (small blind) folded on the Flop
Seat 7: Orkaanstorm (big blind) collected (8180)



PokerStars Hand #97781906255: Tournament #725058424, $0.23+$0.02 USD Hold'em No Limit - Level XII (500/1000) - 2013/04/27 17:42:40 BRT [2013/04/27 16:42:40 ET]
Table '725058424 4' 9-max Seat #6 is the button
Seat 3: dfcastro.net (27238 in chips) 
Seat 6: johe62 (7464 in chips) 
Seat 7: Orkaanstorm (32798 in chips) 
dfcastro.net: posts the ante 60
johe62: posts the ante 60
Orkaanstorm: posts the ante 60
Orkaanstorm: posts small blind 500
dfcastro.net: posts big blind 1000
*** HOLE CARDS ***
Dealt to dfcastro.net [7d Ts]
johe62: folds 
Orkaanstorm: folds 
Uncalled bet (500) returned to dfcastro.net
dfcastro.net collected 1180 from pot
dfcastro.net: doesn't show hand 
*** SUMMARY ***
Total pot 1180 | Rake 0 
Seat 3: dfcastro.net (big blind) collected (1180)
Seat 6: johe62 (button) folded before Flop (didn't bet)
Seat 7: Orkaanstorm (small blind) folded before Flop



PokerStars Hand #97781912435: Tournament #725058424, $0.23+$0.02 USD Hold'em No Limit - Level XII (500/1000) - 2013/04/27 17:42:47 BRT [2013/04/27 16:42:47 ET]
Table '725058424 4' 9-max Seat #7 is the button
Seat 3: dfcastro.net (27858 in chips) 
Seat 6: johe62 (7404 in chips) 
Seat 7: Orkaanstorm (32238 in chips) 
dfcastro.net: posts the ante 60
johe62: posts the ante 60
Orkaanstorm: posts the ante 60
dfcastro.net: posts small blind 500
johe62: posts big blind 1000
*** HOLE CARDS ***
Dealt to dfcastro.net [3c Qc]
Orkaanstorm: folds 
dfcastro.net: raises 1000 to 2000
johe62: folds 
Uncalled bet (1000) returned to dfcastro.net
dfcastro.net collected 2180 from pot
dfcastro.net: doesn't show hand 
*** SUMMARY ***
Total pot 2180 | Rake 0 
Seat 3: dfcastro.net (small blind) collected (2180)
Seat 6: johe62 (big blind) folded before Flop
Seat 7: Orkaanstorm (button) folded before Flop (didn't bet)



PokerStars Hand #97781922318: Tournament #725058424, $0.23+$0.02 USD Hold'em No Limit - Level XII (500/1000) - 2013/04/27 17:42:58 BRT [2013/04/27 16:42:58 ET]
Table '725058424 4' 9-max Seat #3 is the button
Seat 3: dfcastro.net (28978 in chips) 
Seat 6: johe62 (6344 in chips) 
Seat 7: Orkaanstorm (32178 in chips) 
dfcastro.net: posts the ante 60
johe62: posts the ante 60
Orkaanstorm: posts the ante 60
johe62: posts small blind 500
Orkaanstorm: posts big blind 1000
*** HOLE CARDS ***
Dealt to dfcastro.net [7d 4d]
dfcastro.net: folds 
johe62: folds 
Uncalled bet (500) returned to Orkaanstorm
Orkaanstorm collected 1180 from pot
*** SUMMARY ***
Total pot 1180 | Rake 0 
Seat 3: dfcastro.net (button) folded before Flop (didn't bet)
Seat 6: johe62 (small blind) folded before Flop
Seat 7: Orkaanstorm (big blind) collected (1180)



PokerStars Hand #97781929709: Tournament #725058424, $0.23+$0.02 USD Hold'em No Limit - Level XII (500/1000) - 2013/04/27 17:43:06 BRT [2013/04/27 16:43:06 ET]
Table '725058424 4' 9-max Seat #6 is the button
Seat 3: dfcastro.net (28918 in chips) 
Seat 6: johe62 (5784 in chips) 
Seat 7: Orkaanstorm (32798 in chips) 
dfcastro.net: posts the ante 60
johe62: posts the ante 60
Orkaanstorm: posts the ante 60
Orkaanstorm: posts small blind 500
dfcastro.net: posts big blind 1000
*** HOLE CARDS ***
Dealt to dfcastro.net [5s Tc]
johe62: raises 1000 to 2000
Orkaanstorm: folds 
dfcastro.net: folds 
Uncalled bet (1000) returned to johe62
johe62 collected 2680 from pot
*** SUMMARY ***
Total pot 2680 | Rake 0 
Seat 3: dfcastro.net (big blind) folded before Flop
Seat 6: johe62 (button) collected (2680)
Seat 7: Orkaanstorm (small blind) folded before Flop



PokerStars Hand #97781942080: Tournament #725058424, $0.23+$0.02 USD Hold'em No Limit - Level XII (500/1000) - 2013/04/27 17:43:20 BRT [2013/04/27 16:43:20 ET]
Table '725058424 4' 9-max Seat #7 is the button
Seat 3: dfcastro.net (27858 in chips) 
Seat 6: johe62 (7404 in chips) 
Seat 7: Orkaanstorm (32238 in chips) 
dfcastro.net: posts the ante 60
johe62: posts the ante 60
Orkaanstorm: posts the ante 60
dfcastro.net: posts small blind 500
johe62: posts big blind 1000
*** HOLE CARDS ***
Dealt to dfcastro.net [9c Ah]
Orkaanstorm: folds 
dfcastro.net: raises 1000 to 2000
johe62: raises 5344 to 7344 and is all-in
dfcastro.net: calls 5344
*** FLOP *** [3h 7h 4s]
*** TURN *** [3h 7h 4s] [Kh]
*** RIVER *** [3h 7h 4s Kh] [9h]
*** SHOW DOWN ***
dfcastro.net: shows [9c Ah] (a flush, Ace high)
johe62: shows [2c 2d] (a pair of Deuces)
dfcastro.net collected 14868 from pot
johe62 finished the tournament in 3rd place and received $1.70.
*** SUMMARY ***
Total pot 14868 | Rake 0 
Board [3h 7h 4s Kh 9h]
Seat 3: dfcastro.net (small blind) showed [9c Ah] and won (14868) with a flush, Ace high
Seat 6: johe62 (big blind) showed [2c 2d] and lost with a pair of Deuces
Seat 7: Orkaanstorm (button) folded before Flop (didn't bet)



PokerStars Hand #97781962491: Tournament #725058424, $0.23+$0.02 USD Hold'em No Limit - Level XII (500/1000) - 2013/04/27 17:43:43 BRT [2013/04/27 16:43:43 ET]
Table '725058424 4' 9-max Seat #3 is the button
Seat 3: dfcastro.net (35322 in chips) 
Seat 7: Orkaanstorm (32178 in chips) 
dfcastro.net: posts the ante 60
Orkaanstorm: posts the ante 60
dfcastro.net: posts small blind 500
Orkaanstorm: posts big blind 1000
*** HOLE CARDS ***
Dealt to dfcastro.net [Ks 8s]
dfcastro.net: raises 1000 to 2000
Orkaanstorm said, "good luck"
Orkaanstorm: folds 
Uncalled bet (1000) returned to dfcastro.net
dfcastro.net collected 2120 from pot
dfcastro.net: doesn't show hand 
*** SUMMARY ***
Total pot 2120 | Rake 0 
Seat 3: dfcastro.net (button) (small blind) collected (2120)
Seat 7: Orkaanstorm (big blind) folded before Flop



PokerStars Hand #97781974494: Tournament #725058424, $0.23+$0.02 USD Hold'em No Limit - Level XII (500/1000) - 2013/04/27 17:43:56 BRT [2013/04/27 16:43:56 ET]
Table '725058424 4' 9-max Seat #7 is the button
Seat 3: dfcastro.net (36382 in chips) 
Seat 7: Orkaanstorm (31118 in chips) 
dfcastro.net: posts the ante 60
Orkaanstorm: posts the ante 60
Orkaanstorm: posts small blind 500
dfcastro.net: posts big blind 1000
*** HOLE CARDS ***
Dealt to dfcastro.net [Kd 5s]
Orkaanstorm: raises 1000 to 2000
dfcastro.net said, "good luck !"
dfcastro.net: folds 
Uncalled bet (1000) returned to Orkaanstorm
Orkaanstorm collected 2120 from pot
Orkaanstorm said, "ty"
*** SUMMARY ***
Total pot 2120 | Rake 0 
Seat 3: dfcastro.net (big blind) folded before Flop
Seat 7: Orkaanstorm (button) (small blind) collected (2120)



PokerStars Hand #97781988138: Tournament #725058424, $0.23+$0.02 USD Hold'em No Limit - Level XII (500/1000) - 2013/04/27 17:44:12 BRT [2013/04/27 16:44:12 ET]
Table '725058424 4' 9-max Seat #3 is the button
Seat 3: dfcastro.net (35322 in chips) 
Seat 7: Orkaanstorm (32178 in chips) 
dfcastro.net: posts the ante 60
Orkaanstorm: posts the ante 60
dfcastro.net: posts small blind 500
Orkaanstorm: posts big blind 1000
*** HOLE CARDS ***
Dealt to dfcastro.net [5c 6d]
dfcastro.net: folds 
Uncalled bet (500) returned to Orkaanstorm
Orkaanstorm collected 1120 from pot
*** SUMMARY ***
Total pot 1120 | Rake 0 
Seat 3: dfcastro.net (button) (small blind) folded before Flop
Seat 7: Orkaanstorm (big blind) collected (1120)



PokerStars Hand #97781993926: Tournament #725058424, $0.23+$0.02 USD Hold'em No Limit - Level XII (500/1000) - 2013/04/27 17:44:19 BRT [2013/04/27 16:44:19 ET]
Table '725058424 4' 9-max Seat #7 is the button
Seat 3: dfcastro.net (34762 in chips) 
Seat 7: Orkaanstorm (32738 in chips) 
dfcastro.net: posts the ante 60
Orkaanstorm: posts the ante 60
Orkaanstorm: posts small blind 500
dfcastro.net: posts big blind 1000
*** HOLE CARDS ***
Dealt to dfcastro.net [Ah 7c]
Orkaanstorm: folds 
Uncalled bet (500) returned to dfcastro.net
dfcastro.net collected 1120 from pot
dfcastro.net: doesn't show hand 
*** SUMMARY ***
Total pot 1120 | Rake 0 
Seat 3: dfcastro.net (big blind) collected (1120)
Seat 7: Orkaanstorm (button) (small blind) folded before Flop



PokerStars Hand #97781999905: Tournament #725058424, $0.23+$0.02 USD Hold'em No Limit - Level XII (500/1000) - 2013/04/27 17:44:25 BRT [2013/04/27 16:44:25 ET]
Table '725058424 4' 9-max Seat #3 is the button
Seat 3: dfcastro.net (35322 in chips) 
Seat 7: Orkaanstorm (32178 in chips) 
dfcastro.net: posts the ante 60
Orkaanstorm: posts the ante 60
dfcastro.net: posts small blind 500
Orkaanstorm: posts big blind 1000
*** HOLE CARDS ***
Dealt to dfcastro.net [As Tc]
dfcastro.net: raises 1000 to 2000
Orkaanstorm: folds 
Uncalled bet (1000) returned to dfcastro.net
dfcastro.net collected 2120 from pot
dfcastro.net: doesn't show hand 
*** SUMMARY ***
Total pot 2120 | Rake 0 
Seat 3: dfcastro.net (button) (small blind) collected (2120)
Seat 7: Orkaanstorm (big blind) folded before Flop



PokerStars Hand #97782006774: Tournament #725058424, $0.23+$0.02 USD Hold'em No Limit - Level XII (500/1000) - 2013/04/27 17:44:33 BRT [2013/04/27 16:44:33 ET]
Table '725058424 4' 9-max Seat #7 is the button
Seat 3: dfcastro.net (36382 in chips) 
Seat 7: Orkaanstorm (31118 in chips) 
dfcastro.net: posts the ante 60
Orkaanstorm: posts the ante 60
Orkaanstorm: posts small blind 500
dfcastro.net: posts big blind 1000
*** HOLE CARDS ***
Dealt to dfcastro.net [6c 5c]
Orkaanstorm: folds 
Uncalled bet (500) returned to dfcastro.net
dfcastro.net collected 1120 from pot
dfcastro.net: doesn't show hand 
*** SUMMARY ***
Total pot 1120 | Rake 0 
Seat 3: dfcastro.net (big blind) collected (1120)
Seat 7: Orkaanstorm (button) (small blind) folded before Flop



PokerStars Hand #97782011962: Tournament #725058424, $0.23+$0.02 USD Hold'em No Limit - Level XII (500/1000) - 2013/04/27 17:44:39 BRT [2013/04/27 16:44:39 ET]
Table '725058424 4' 9-max Seat #3 is the button
Seat 3: dfcastro.net (36942 in chips) 
Seat 7: Orkaanstorm (30558 in chips) 
dfcastro.net: posts the ante 60
Orkaanstorm: posts the ante 60
dfcastro.net: posts small blind 500
Orkaanstorm: posts big blind 1000
*** HOLE CARDS ***
Dealt to dfcastro.net [2s 8d]
dfcastro.net: raises 1000 to 2000
Orkaanstorm: calls 1000
*** FLOP *** [3h 5h 5s]
Orkaanstorm: bets 3000
dfcastro.net: folds 
Uncalled bet (3000) returned to Orkaanstorm
Orkaanstorm collected 4120 from pot
*** SUMMARY ***
Total pot 4120 | Rake 0 
Board [3h 5h 5s]
Seat 3: dfcastro.net (button) (small blind) folded on the Flop
Seat 7: Orkaanstorm (big blind) collected (4120)



PokerStars Hand #97782024945: Tournament #725058424, $0.23+$0.02 USD Hold'em No Limit - Level XII (500/1000) - 2013/04/27 17:44:53 BRT [2013/04/27 16:44:53 ET]
Table '725058424 4' 9-max Seat #7 is the button
Seat 3: dfcastro.net (34882 in chips) 
Seat 7: Orkaanstorm (32618 in chips) 
dfcastro.net: posts the ante 60
Orkaanstorm: posts the ante 60
Orkaanstorm: posts small blind 500
dfcastro.net: posts big blind 1000
*** HOLE CARDS ***
Dealt to dfcastro.net [Jd 4s]
Orkaanstorm: raises 1000 to 2000
dfcastro.net: folds 
Uncalled bet (1000) returned to Orkaanstorm
Orkaanstorm collected 2120 from pot
*** SUMMARY ***
Total pot 2120 | Rake 0 
Seat 3: dfcastro.net (big blind) folded before Flop
Seat 7: Orkaanstorm (button) (small blind) collected (2120)



PokerStars Hand #97782033481: Tournament #725058424, $0.23+$0.02 USD Hold'em No Limit - Level XII (500/1000) - 2013/04/27 17:45:02 BRT [2013/04/27 16:45:02 ET]
Table '725058424 4' 9-max Seat #3 is the button
Seat 3: dfcastro.net (33822 in chips) 
Seat 7: Orkaanstorm (33678 in chips) 
dfcastro.net: posts the ante 60
Orkaanstorm: posts the ante 60
dfcastro.net: posts small blind 500
Orkaanstorm: posts big blind 1000
*** HOLE CARDS ***
Dealt to dfcastro.net [5h Qd]
dfcastro.net: calls 500
Orkaanstorm: checks 
*** FLOP *** [8s Qh 2s]
Orkaanstorm: checks 
dfcastro.net: bets 2000
Orkaanstorm: folds 
Uncalled bet (2000) returned to dfcastro.net
dfcastro.net collected 2120 from pot
dfcastro.net: doesn't show hand 
*** SUMMARY ***
Total pot 2120 | Rake 0 
Board [8s Qh 2s]
Seat 3: dfcastro.net (button) (small blind) collected (2120)
Seat 7: Orkaanstorm (big blind) folded on the Flop



PokerStars Hand #97782049634: Tournament #725058424, $0.23+$0.02 USD Hold'em No Limit - Level XII (500/1000) - 2013/04/27 17:45:21 BRT [2013/04/27 16:45:21 ET]
Table '725058424 4' 9-max Seat #7 is the button
Seat 3: dfcastro.net (34882 in chips) 
Seat 7: Orkaanstorm (32618 in chips) 
dfcastro.net: posts the ante 60
Orkaanstorm: posts the ante 60
Orkaanstorm: posts small blind 500
dfcastro.net: posts big blind 1000
*** HOLE CARDS ***
Dealt to dfcastro.net [Qd 7s]
Orkaanstorm: folds 
Uncalled bet (500) returned to dfcastro.net
dfcastro.net collected 1120 from pot
dfcastro.net: doesn't show hand 
*** SUMMARY ***
Total pot 1120 | Rake 0 
Seat 3: dfcastro.net (big blind) collected (1120)
Seat 7: Orkaanstorm (button) (small blind) folded before Flop



PokerStars Hand #97782054547: Tournament #725058424, $0.23+$0.02 USD Hold'em No Limit - Level XII (500/1000) - 2013/04/27 17:45:26 BRT [2013/04/27 16:45:26 ET]
Table '725058424 4' 9-max Seat #3 is the button
Seat 3: dfcastro.net (35442 in chips) 
Seat 7: Orkaanstorm (32058 in chips) 
dfcastro.net: posts the ante 60
Orkaanstorm: posts the ante 60
dfcastro.net: posts small blind 500
Orkaanstorm: posts big blind 1000
*** HOLE CARDS ***
Dealt to dfcastro.net [9c Js]
dfcastro.net: calls 500
Orkaanstorm: checks 
*** FLOP *** [Tc 5s 2d]
Orkaanstorm: checks 
dfcastro.net: checks 
*** TURN *** [Tc 5s 2d] [5c]
Orkaanstorm: checks 
dfcastro.net: checks 
*** RIVER *** [Tc 5s 2d 5c] [Ts]
Orkaanstorm: bets 3000
dfcastro.net: folds 
Uncalled bet (3000) returned to Orkaanstorm
Orkaanstorm collected 2120 from pot
*** SUMMARY ***
Total pot 2120 | Rake 0 
Board [Tc 5s 2d 5c Ts]
Seat 3: dfcastro.net (button) (small blind) folded on the River
Seat 7: Orkaanstorm (big blind) collected (2120)



PokerStars Hand #97782077666: Tournament #725058424, $0.23+$0.02 USD Hold'em No Limit - Level XII (500/1000) - 2013/04/27 17:45:52 BRT [2013/04/27 16:45:52 ET]
Table '725058424 4' 9-max Seat #7 is the button
Seat 3: dfcastro.net (34382 in chips) 
Seat 7: Orkaanstorm (33118 in chips) 
dfcastro.net: posts the ante 60
Orkaanstorm: posts the ante 60
Orkaanstorm: posts small blind 500
dfcastro.net: posts big blind 1000
*** HOLE CARDS ***
Dealt to dfcastro.net [3d 4s]
Orkaanstorm: calls 500
dfcastro.net: checks 
*** FLOP *** [Kc 6c Th]
dfcastro.net: checks 
Orkaanstorm: checks 
*** TURN *** [Kc 6c Th] [3c]
dfcastro.net: checks 
Orkaanstorm: bets 1000
dfcastro.net: folds 
Uncalled bet (1000) returned to Orkaanstorm
Orkaanstorm collected 2120 from pot
*** SUMMARY ***
Total pot 2120 | Rake 0 
Board [Kc 6c Th 3c]
Seat 3: dfcastro.net (big blind) folded on the Turn
Seat 7: Orkaanstorm (button) (small blind) collected (2120)



PokerStars Hand #97782098096: Tournament #725058424, $0.23+$0.02 USD Hold'em No Limit - Level XII (500/1000) - 2013/04/27 17:46:15 BRT [2013/04/27 16:46:15 ET]
Table '725058424 4' 9-max Seat #3 is the button
Seat 3: dfcastro.net (33322 in chips) 
Seat 7: Orkaanstorm (34178 in chips) 
dfcastro.net: posts the ante 60
Orkaanstorm: posts the ante 60
dfcastro.net: posts small blind 500
Orkaanstorm: posts big blind 1000
*** HOLE CARDS ***
Dealt to dfcastro.net [9s 8h]
dfcastro.net: folds 
Uncalled bet (500) returned to Orkaanstorm
Orkaanstorm collected 1120 from pot
*** SUMMARY ***
Total pot 1120 | Rake 0 
Seat 3: dfcastro.net (button) (small blind) folded before Flop
Seat 7: Orkaanstorm (big blind) collected (1120)



PokerStars Hand #97782107125: Tournament #725058424, $0.23+$0.02 USD Hold'em No Limit - Level XII (500/1000) - 2013/04/27 17:46:25 BRT [2013/04/27 16:46:25 ET]
Table '725058424 4' 9-max Seat #7 is the button
Seat 3: dfcastro.net (32762 in chips) 
Seat 7: Orkaanstorm (34738 in chips) 
dfcastro.net: posts the ante 60
Orkaanstorm: posts the ante 60
Orkaanstorm: posts small blind 500
dfcastro.net: posts big blind 1000
*** HOLE CARDS ***
Dealt to dfcastro.net [Js 2d]
Orkaanstorm: folds 
Uncalled bet (500) returned to dfcastro.net
dfcastro.net collected 1120 from pot
dfcastro.net: doesn't show hand 
*** SUMMARY ***
Total pot 1120 | Rake 0 
Seat 3: dfcastro.net (big blind) collected (1120)
Seat 7: Orkaanstorm (button) (small blind) folded before Flop



PokerStars Hand #97782112749: Tournament #725058424, $0.23+$0.02 USD Hold'em No Limit - Level XII (500/1000) - 2013/04/27 17:46:32 BRT [2013/04/27 16:46:32 ET]
Table '725058424 4' 9-max Seat #3 is the button
Seat 3: dfcastro.net (33322 in chips) 
Seat 7: Orkaanstorm (34178 in chips) 
dfcastro.net: posts the ante 60
Orkaanstorm: posts the ante 60
dfcastro.net: posts small blind 500
Orkaanstorm: posts big blind 1000
*** HOLE CARDS ***
Dealt to dfcastro.net [Ks 4h]
dfcastro.net: calls 500
Orkaanstorm: checks 
*** FLOP *** [Th 5s 2h]
Orkaanstorm: checks 
dfcastro.net: checks 
*** TURN *** [Th 5s 2h] [3s]
Orkaanstorm: checks 
dfcastro.net: checks 
*** RIVER *** [Th 5s 2h 3s] [As]
Orkaanstorm: checks 
dfcastro.net: bets 2000
Orkaanstorm: folds 
Uncalled bet (2000) returned to dfcastro.net
dfcastro.net collected 2120 from pot
dfcastro.net: doesn't show hand 
*** SUMMARY ***
Total pot 2120 | Rake 0 
Board [Th 5s 2h 3s As]
Seat 3: dfcastro.net (button) (small blind) collected (2120)
Seat 7: Orkaanstorm (big blind) folded on the River



PokerStars Hand #97782131866: Tournament #725058424, $0.23+$0.02 USD Hold'em No Limit - Level XII (500/1000) - 2013/04/27 17:46:53 BRT [2013/04/27 16:46:53 ET]
Table '725058424 4' 9-max Seat #7 is the button
Seat 3: dfcastro.net (34382 in chips) 
Seat 7: Orkaanstorm (33118 in chips) 
dfcastro.net: posts the ante 60
Orkaanstorm: posts the ante 60
Orkaanstorm: posts small blind 500
dfcastro.net: posts big blind 1000
*** HOLE CARDS ***
Dealt to dfcastro.net [Th Kc]
Orkaanstorm: folds 
Uncalled bet (500) returned to dfcastro.net
dfcastro.net collected 1120 from pot
dfcastro.net: doesn't show hand 
*** SUMMARY ***
Total pot 1120 | Rake 0 
Seat 3: dfcastro.net (big blind) collected (1120)
Seat 7: Orkaanstorm (button) (small blind) folded before Flop



PokerStars Hand #97782136992: Tournament #725058424, $0.23+$0.02 USD Hold'em No Limit - Level XII (500/1000) - 2013/04/27 17:46:59 BRT [2013/04/27 16:46:59 ET]
Table '725058424 4' 9-max Seat #3 is the button
Seat 3: dfcastro.net (34942 in chips) 
Seat 7: Orkaanstorm (32558 in chips) 
dfcastro.net: posts the ante 60
Orkaanstorm: posts the ante 60
dfcastro.net: posts small blind 500
Orkaanstorm: posts big blind 1000
*** HOLE CARDS ***
Dealt to dfcastro.net [9h Jh]
dfcastro.net: raises 1000 to 2000
Orkaanstorm: calls 1000
*** FLOP *** [3d 8d 8c]
Orkaanstorm: bets 3000
dfcastro.net: folds 
Uncalled bet (3000) returned to Orkaanstorm
Orkaanstorm collected 4120 from pot
*** SUMMARY ***
Total pot 4120 | Rake 0 
Board [3d 8d 8c]
Seat 3: dfcastro.net (button) (small blind) folded on the Flop
Seat 7: Orkaanstorm (big blind) collected (4120)



PokerStars Hand #97782150773: Tournament #725058424, $0.23+$0.02 USD Hold'em No Limit - Level XII (500/1000) - 2013/04/27 17:47:15 BRT [2013/04/27 16:47:15 ET]
Table '725058424 4' 9-max Seat #7 is the button
Seat 3: dfcastro.net (32882 in chips) 
Seat 7: Orkaanstorm (34618 in chips) 
dfcastro.net: posts the ante 60
Orkaanstorm: posts the ante 60
Orkaanstorm: posts small blind 500
dfcastro.net: posts big blind 1000
*** HOLE CARDS ***
Dealt to dfcastro.net [4c 7s]
Orkaanstorm: raises 1000 to 2000
dfcastro.net: folds 
Uncalled bet (1000) returned to Orkaanstorm
Orkaanstorm collected 2120 from pot
*** SUMMARY ***
Total pot 2120 | Rake 0 
Seat 3: dfcastro.net (big blind) folded before Flop
Seat 7: Orkaanstorm (button) (small blind) collected (2120)



PokerStars Hand #97782157755: Tournament #725058424, $0.23+$0.02 USD Hold'em No Limit - Level XII (500/1000) - 2013/04/27 17:47:23 BRT [2013/04/27 16:47:23 ET]
Table '725058424 4' 9-max Seat #3 is the button
Seat 3: dfcastro.net (31822 in chips) 
Seat 7: Orkaanstorm (35678 in chips) 
dfcastro.net: posts the ante 60
Orkaanstorm: posts the ante 60
dfcastro.net: posts small blind 500
Orkaanstorm: posts big blind 1000
*** HOLE CARDS ***
Dealt to dfcastro.net [Ts Jc]
dfcastro.net: calls 500
Orkaanstorm: checks 
*** FLOP *** [Kc 4s Qc]
Orkaanstorm: checks 
dfcastro.net: checks 
*** TURN *** [Kc 4s Qc] [9c]
Orkaanstorm: checks 
dfcastro.net: checks 
*** RIVER *** [Kc 4s Qc 9c] [7c]
Orkaanstorm: checks 
dfcastro.net: bets 2000
Orkaanstorm: folds 
Uncalled bet (2000) returned to dfcastro.net
dfcastro.net collected 2120 from pot
dfcastro.net: doesn't show hand 
*** SUMMARY ***
Total pot 2120 | Rake 0 
Board [Kc 4s Qc 9c 7c]
Seat 3: dfcastro.net (button) (small blind) collected (2120)
Seat 7: Orkaanstorm (big blind) folded on the River



PokerStars Hand #97782180829: Tournament #725058424, $0.23+$0.02 USD Hold'em No Limit - Level XII (500/1000) - 2013/04/27 17:47:50 BRT [2013/04/27 16:47:50 ET]
Table '725058424 4' 9-max Seat #7 is the button
Seat 3: dfcastro.net (32882 in chips) 
Seat 7: Orkaanstorm (34618 in chips) 
dfcastro.net: posts the ante 60
Orkaanstorm: posts the ante 60
Orkaanstorm: posts small blind 500
dfcastro.net: posts big blind 1000
*** HOLE CARDS ***
Dealt to dfcastro.net [Qs 7h]
Orkaanstorm: calls 500
dfcastro.net: checks 
*** FLOP *** [2c 4h 9s]
dfcastro.net: checks 
Orkaanstorm: bets 1000
dfcastro.net: folds 
Uncalled bet (1000) returned to Orkaanstorm
Orkaanstorm collected 2120 from pot
*** SUMMARY ***
Total pot 2120 | Rake 0 
Board [2c 4h 9s]
Seat 3: dfcastro.net (big blind) folded on the Flop
Seat 7: Orkaanstorm (button) (small blind) collected (2120)



PokerStars Hand #97782196498: Tournament #725058424, $0.23+$0.02 USD Hold'em No Limit - Level XII (500/1000) - 2013/04/27 17:48:08 BRT [2013/04/27 16:48:08 ET]
Table '725058424 4' 9-max Seat #3 is the button
Seat 3: dfcastro.net (31822 in chips) 
Seat 7: Orkaanstorm (35678 in chips) 
dfcastro.net: posts the ante 60
Orkaanstorm: posts the ante 60
dfcastro.net: posts small blind 500
Orkaanstorm: posts big blind 1000
*** HOLE CARDS ***
Dealt to dfcastro.net [Td 5s]
dfcastro.net: folds 
Uncalled bet (500) returned to Orkaanstorm
Orkaanstorm collected 1120 from pot
*** SUMMARY ***
Total pot 1120 | Rake 0 
Seat 3: dfcastro.net (button) (small blind) folded before Flop
Seat 7: Orkaanstorm (big blind) collected (1120)



PokerStars Hand #97782202364: Tournament #725058424, $0.23+$0.02 USD Hold'em No Limit - Level XII (500/1000) - 2013/04/27 17:48:15 BRT [2013/04/27 16:48:15 ET]
Table '725058424 4' 9-max Seat #7 is the button
Seat 3: dfcastro.net (31262 in chips) 
Seat 7: Orkaanstorm (36238 in chips) 
dfcastro.net: posts the ante 60
Orkaanstorm: posts the ante 60
Orkaanstorm: posts small blind 500
dfcastro.net: posts big blind 1000
*** HOLE CARDS ***
Dealt to dfcastro.net [Ad 6c]
Orkaanstorm: folds 
Uncalled bet (500) returned to dfcastro.net
dfcastro.net collected 1120 from pot
dfcastro.net: doesn't show hand 
*** SUMMARY ***
Total pot 1120 | Rake 0 
Seat 3: dfcastro.net (big blind) collected (1120)
Seat 7: Orkaanstorm (button) (small blind) folded before Flop



PokerStars Hand #97782207409: Tournament #725058424, $0.23+$0.02 USD Hold'em No Limit - Level XII (500/1000) - 2013/04/27 17:48:21 BRT [2013/04/27 16:48:21 ET]
Table '725058424 4' 9-max Seat #3 is the button
Seat 3: dfcastro.net (31822 in chips) 
Seat 7: Orkaanstorm (35678 in chips) 
dfcastro.net: posts the ante 60
Orkaanstorm: posts the ante 60
dfcastro.net: posts small blind 500
Orkaanstorm: posts big blind 1000
*** HOLE CARDS ***
Dealt to dfcastro.net [2s 6h]
dfcastro.net: folds 
Uncalled bet (500) returned to Orkaanstorm
Orkaanstorm collected 1120 from pot
*** SUMMARY ***
Total pot 1120 | Rake 0 
Seat 3: dfcastro.net (button) (small blind) folded before Flop
Seat 7: Orkaanstorm (big blind) collected (1120)



PokerStars Hand #97782214175: Tournament #725058424, $0.23+$0.02 USD Hold'em No Limit - Level XII (500/1000) - 2013/04/27 17:48:28 BRT [2013/04/27 16:48:28 ET]
Table '725058424 4' 9-max Seat #7 is the button
Seat 3: dfcastro.net (31262 in chips) 
Seat 7: Orkaanstorm (36238 in chips) 
dfcastro.net: posts the ante 60
Orkaanstorm: posts the ante 60
Orkaanstorm: posts small blind 500
dfcastro.net: posts big blind 1000
*** HOLE CARDS ***
Dealt to dfcastro.net [8d 2s]
Orkaanstorm: calls 500
dfcastro.net: checks 
*** FLOP *** [6s 7d Td]
dfcastro.net: checks 
Orkaanstorm: bets 1000
dfcastro.net: folds 
Uncalled bet (1000) returned to Orkaanstorm
Orkaanstorm collected 2120 from pot
*** SUMMARY ***
Total pot 2120 | Rake 0 
Board [6s 7d Td]
Seat 3: dfcastro.net (big blind) folded on the Flop
Seat 7: Orkaanstorm (button) (small blind) collected (2120)



PokerStars Hand #97782229907: Tournament #725058424, $0.23+$0.02 USD Hold'em No Limit - Level XII (500/1000) - 2013/04/27 17:48:47 BRT [2013/04/27 16:48:47 ET]
Table '725058424 4' 9-max Seat #3 is the button
Seat 3: dfcastro.net (30202 in chips) 
Seat 7: Orkaanstorm (37298 in chips) 
dfcastro.net: posts the ante 60
Orkaanstorm: posts the ante 60
dfcastro.net: posts small blind 500
Orkaanstorm: posts big blind 1000
*** HOLE CARDS ***
Dealt to dfcastro.net [4c 2s]
dfcastro.net: folds 
Uncalled bet (500) returned to Orkaanstorm
Orkaanstorm collected 1120 from pot
*** SUMMARY ***
Total pot 1120 | Rake 0 
Seat 3: dfcastro.net (button) (small blind) folded before Flop
Seat 7: Orkaanstorm (big blind) collected (1120)



PokerStars Hand #97782235846: Tournament #725058424, $0.23+$0.02 USD Hold'em No Limit - Level XII (500/1000) - 2013/04/27 17:48:53 BRT [2013/04/27 16:48:53 ET]
Table '725058424 4' 9-max Seat #7 is the button
Seat 3: dfcastro.net (29642 in chips) 
Seat 7: Orkaanstorm (37858 in chips) 
dfcastro.net: posts the ante 60
Orkaanstorm: posts the ante 60
Orkaanstorm: posts small blind 500
dfcastro.net: posts big blind 1000
*** HOLE CARDS ***
Dealt to dfcastro.net [4d Qc]
Orkaanstorm: folds 
Uncalled bet (500) returned to dfcastro.net
dfcastro.net collected 1120 from pot
dfcastro.net: doesn't show hand 
*** SUMMARY ***
Total pot 1120 | Rake 0 
Seat 3: dfcastro.net (big blind) collected (1120)
Seat 7: Orkaanstorm (button) (small blind) folded before Flop



PokerStars Hand #97782240996: Tournament #725058424, $0.23+$0.02 USD Hold'em No Limit - Level XII (500/1000) - 2013/04/27 17:48:59 BRT [2013/04/27 16:48:59 ET]
Table '725058424 4' 9-max Seat #3 is the button
Seat 3: dfcastro.net (30202 in chips) 
Seat 7: Orkaanstorm (37298 in chips) 
dfcastro.net: posts the ante 60
Orkaanstorm: posts the ante 60
dfcastro.net: posts small blind 500
Orkaanstorm: posts big blind 1000
*** HOLE CARDS ***
Dealt to dfcastro.net [6c Ts]
dfcastro.net: folds 
Uncalled bet (500) returned to Orkaanstorm
Orkaanstorm collected 1120 from pot
*** SUMMARY ***
Total pot 1120 | Rake 0 
Seat 3: dfcastro.net (button) (small blind) folded before Flop
Seat 7: Orkaanstorm (big blind) collected (1120)



PokerStars Hand #97782248534: Tournament #725058424, $0.23+$0.02 USD Hold'em No Limit - Level XII (500/1000) - 2013/04/27 17:49:08 BRT [2013/04/27 16:49:08 ET]
Table '725058424 4' 9-max Seat #7 is the button
Seat 3: dfcastro.net (29642 in chips) 
Seat 7: Orkaanstorm (37858 in chips) 
dfcastro.net: posts the ante 60
Orkaanstorm: posts the ante 60
Orkaanstorm: posts small blind 500
dfcastro.net: posts big blind 1000
*** HOLE CARDS ***
Dealt to dfcastro.net [Qc 9c]
Orkaanstorm: folds 
Uncalled bet (500) returned to dfcastro.net
dfcastro.net collected 1120 from pot
dfcastro.net: doesn't show hand 
*** SUMMARY ***
Total pot 1120 | Rake 0 
Seat 3: dfcastro.net (big blind) collected (1120)
Seat 7: Orkaanstorm (button) (small blind) folded before Flop



PokerStars Hand #97782254263: Tournament #725058424, $0.23+$0.02 USD Hold'em No Limit - Level XII (500/1000) - 2013/04/27 17:49:15 BRT [2013/04/27 16:49:15 ET]
Table '725058424 4' 9-max Seat #3 is the button
Seat 3: dfcastro.net (30202 in chips) 
Seat 7: Orkaanstorm (37298 in chips) 
dfcastro.net: posts the ante 60
Orkaanstorm: posts the ante 60
dfcastro.net: posts small blind 500
Orkaanstorm: posts big blind 1000
*** HOLE CARDS ***
Dealt to dfcastro.net [Qd 3d]
dfcastro.net: calls 500
Orkaanstorm: checks 
*** FLOP *** [Qs 5c 9d]
Orkaanstorm: checks 
dfcastro.net: bets 2000
Orkaanstorm: calls 2000
*** TURN *** [Qs 5c 9d] [Kc]
Orkaanstorm: bets 2000
dfcastro.net: calls 2000
*** RIVER *** [Qs 5c 9d Kc] [6s]
Orkaanstorm: checks 
dfcastro.net: checks 
*** SHOW DOWN ***
Orkaanstorm: shows [Ac 3c] (high card Ace)
dfcastro.net: shows [Qd 3d] (a pair of Queens)
dfcastro.net collected 10120 from pot
*** SUMMARY ***
Total pot 10120 | Rake 0 
Board [Qs 5c 9d Kc 6s]
Seat 3: dfcastro.net (button) (small blind) showed [Qd 3d] and won (10120) with a pair of Queens
Seat 7: Orkaanstorm (big blind) showed [Ac 3c] and lost with high card Ace



PokerStars Hand #97782294672: Tournament #725058424, $0.23+$0.02 USD Hold'em No Limit - Level XII (500/1000) - 2013/04/27 17:50:02 BRT [2013/04/27 16:50:02 ET]
Table '725058424 4' 9-max Seat #7 is the button
Seat 3: dfcastro.net (35262 in chips) 
Seat 7: Orkaanstorm (32238 in chips) 
dfcastro.net: posts the ante 60
Orkaanstorm: posts the ante 60
Orkaanstorm: posts small blind 500
dfcastro.net: posts big blind 1000
*** HOLE CARDS ***
Dealt to dfcastro.net [7c 4s]
Orkaanstorm: folds 
Uncalled bet (500) returned to dfcastro.net
dfcastro.net collected 1120 from pot
dfcastro.net: doesn't show hand 
*** SUMMARY ***
Total pot 1120 | Rake 0 
Seat 3: dfcastro.net (big blind) collected (1120)
Seat 7: Orkaanstorm (button) (small blind) folded before Flop



PokerStars Hand #97782299851: Tournament #725058424, $0.23+$0.02 USD Hold'em No Limit - Level XII (500/1000) - 2013/04/27 17:50:09 BRT [2013/04/27 16:50:09 ET]
Table '725058424 4' 9-max Seat #3 is the button
Seat 3: dfcastro.net (35822 in chips) 
Seat 7: Orkaanstorm (31678 in chips) 
dfcastro.net: posts the ante 60
Orkaanstorm: posts the ante 60
dfcastro.net: posts small blind 500
Orkaanstorm: posts big blind 1000
*** HOLE CARDS ***
Dealt to dfcastro.net [4h Tc]
dfcastro.net: folds 
Uncalled bet (500) returned to Orkaanstorm
Orkaanstorm collected 1120 from pot
*** SUMMARY ***
Total pot 1120 | Rake 0 
Seat 3: dfcastro.net (button) (small blind) folded before Flop
Seat 7: Orkaanstorm (big blind) collected (1120)



PokerStars Hand #97782308358: Tournament #725058424, $0.23+$0.02 USD Hold'em No Limit - Level XII (500/1000) - 2013/04/27 17:50:18 BRT [2013/04/27 16:50:18 ET]
Table '725058424 4' 9-max Seat #7 is the button
Seat 3: dfcastro.net (35262 in chips) 
Seat 7: Orkaanstorm (32238 in chips) 
dfcastro.net: posts the ante 60
Orkaanstorm: posts the ante 60
Orkaanstorm: posts small blind 500
dfcastro.net: posts big blind 1000
*** HOLE CARDS ***
Dealt to dfcastro.net [9h 2d]
Orkaanstorm: raises 1000 to 2000
dfcastro.net: folds 
Uncalled bet (1000) returned to Orkaanstorm
Orkaanstorm collected 2120 from pot
*** SUMMARY ***
Total pot 2120 | Rake 0 
Seat 3: dfcastro.net (big blind) folded before Flop
Seat 7: Orkaanstorm (button) (small blind) collected (2120)



PokerStars Hand #97782315859: Tournament #725058424, $0.23+$0.02 USD Hold'em No Limit - Level XII (500/1000) - 2013/04/27 17:50:27 BRT [2013/04/27 16:50:27 ET]
Table '725058424 4' 9-max Seat #3 is the button
Seat 3: dfcastro.net (34202 in chips) 
Seat 7: Orkaanstorm (33298 in chips) 
dfcastro.net: posts the ante 60
Orkaanstorm: posts the ante 60
dfcastro.net: posts small blind 500
Orkaanstorm: posts big blind 1000
*** HOLE CARDS ***
Dealt to dfcastro.net [Th 2d]
dfcastro.net: folds 
Uncalled bet (500) returned to Orkaanstorm
Orkaanstorm collected 1120 from pot
*** SUMMARY ***
Total pot 1120 | Rake 0 
Seat 3: dfcastro.net (button) (small blind) folded before Flop
Seat 7: Orkaanstorm (big blind) collected (1120)



PokerStars Hand #97782325417: Tournament #725058424, $0.23+$0.02 USD Hold'em No Limit - Level XIII (600/1200) - 2013/04/27 17:50:38 BRT [2013/04/27 16:50:38 ET]
Table '725058424 4' 9-max Seat #7 is the button
Seat 3: dfcastro.net (33642 in chips) 
Seat 7: Orkaanstorm (33858 in chips) 
dfcastro.net: posts the ante 75
Orkaanstorm: posts the ante 75
Orkaanstorm: posts small blind 600
dfcastro.net: posts big blind 1200
*** HOLE CARDS ***
Dealt to dfcastro.net [3c 5h]
Orkaanstorm: calls 600
dfcastro.net: checks 
*** FLOP *** [4c Kc Jc]
dfcastro.net: checks 
Orkaanstorm: checks 
*** TURN *** [4c Kc Jc] [9s]
dfcastro.net: checks 
Orkaanstorm: checks 
*** RIVER *** [4c Kc Jc 9s] [2c]
dfcastro.net: checks 
Orkaanstorm: checks 
*** SHOW DOWN ***
dfcastro.net: shows [3c 5h] (a flush, King high)
Orkaanstorm: mucks hand 
dfcastro.net collected 2550 from pot
*** SUMMARY ***
Total pot 2550 | Rake 0 
Board [4c Kc Jc 9s 2c]
Seat 3: dfcastro.net (big blind) showed [3c 5h] and won (2550) with a flush, King high
Seat 7: Orkaanstorm (button) (small blind) mucked [8d Ks]



PokerStars Hand #97782352463: Tournament #725058424, $0.23+$0.02 USD Hold'em No Limit - Level XIII (600/1200) - 2013/04/27 17:51:10 BRT [2013/04/27 16:51:10 ET]
Table '725058424 4' 9-max Seat #3 is the button
Seat 3: dfcastro.net (34917 in chips) 
Seat 7: Orkaanstorm (32583 in chips) 
dfcastro.net: posts the ante 75
Orkaanstorm: posts the ante 75
dfcastro.net: posts small blind 600
Orkaanstorm: posts big blind 1200
*** HOLE CARDS ***
Dealt to dfcastro.net [Jc 6d]
dfcastro.net: folds 
Uncalled bet (600) returned to Orkaanstorm
Orkaanstorm collected 1350 from pot
*** SUMMARY ***
Total pot 1350 | Rake 0 
Seat 3: dfcastro.net (button) (small blind) folded before Flop
Seat 7: Orkaanstorm (big blind) collected (1350)



PokerStars Hand #97782359845: Tournament #725058424, $0.23+$0.02 USD Hold'em No Limit - Level XIII (600/1200) - 2013/04/27 17:51:18 BRT [2013/04/27 16:51:18 ET]
Table '725058424 4' 9-max Seat #7 is the button
Seat 3: dfcastro.net (34242 in chips) 
Seat 7: Orkaanstorm (33258 in chips) 
dfcastro.net: posts the ante 75
Orkaanstorm: posts the ante 75
Orkaanstorm: posts small blind 600
dfcastro.net: posts big blind 1200
*** HOLE CARDS ***
Dealt to dfcastro.net [Ac 2d]
Orkaanstorm: calls 600
dfcastro.net: raises 1200 to 2400
Orkaanstorm: calls 1200
*** FLOP *** [9d Qh 3d]
dfcastro.net: checks 
Orkaanstorm: checks 
*** TURN *** [9d Qh 3d] [Qs]
dfcastro.net: checks 
Orkaanstorm: checks 
*** RIVER *** [9d Qh 3d Qs] [8s]
dfcastro.net: bets 2400
Orkaanstorm: folds 
Uncalled bet (2400) returned to dfcastro.net
dfcastro.net collected 4950 from pot
dfcastro.net: doesn't show hand 
*** SUMMARY ***
Total pot 4950 | Rake 0 
Board [9d Qh 3d Qs 8s]
Seat 3: dfcastro.net (big blind) collected (4950)
Seat 7: Orkaanstorm (button) (small blind) folded on the River



PokerStars Hand #97782384327: Tournament #725058424, $0.23+$0.02 USD Hold'em No Limit - Level XIII (600/1200) - 2013/04/27 17:51:47 BRT [2013/04/27 16:51:47 ET]
Table '725058424 4' 9-max Seat #3 is the button
Seat 3: dfcastro.net (36717 in chips) 
Seat 7: Orkaanstorm (30783 in chips) 
dfcastro.net: posts the ante 75
Orkaanstorm: posts the ante 75
dfcastro.net: posts small blind 600
Orkaanstorm: posts big blind 1200
*** HOLE CARDS ***
Dealt to dfcastro.net [6h 4d]
dfcastro.net: folds 
Uncalled bet (600) returned to Orkaanstorm
Orkaanstorm collected 1350 from pot
*** SUMMARY ***
Total pot 1350 | Rake 0 
Seat 3: dfcastro.net (button) (small blind) folded before Flop
Seat 7: Orkaanstorm (big blind) collected (1350)



PokerStars Hand #97782390192: Tournament #725058424, $0.23+$0.02 USD Hold'em No Limit - Level XIII (600/1200) - 2013/04/27 17:51:54 BRT [2013/04/27 16:51:54 ET]
Table '725058424 4' 9-max Seat #7 is the button
Seat 3: dfcastro.net (36042 in chips) 
Seat 7: Orkaanstorm (31458 in chips) 
dfcastro.net: posts the ante 75
Orkaanstorm: posts the ante 75
Orkaanstorm: posts small blind 600
dfcastro.net: posts big blind 1200
*** HOLE CARDS ***
Dealt to dfcastro.net [5d 5s]
Orkaanstorm: calls 600
dfcastro.net: raises 1200 to 2400
Orkaanstorm: calls 1200
*** FLOP *** [9s Ac Jh]
dfcastro.net: checks 
Orkaanstorm: checks 
*** TURN *** [9s Ac Jh] [5h]
dfcastro.net: bets 2400
Orkaanstorm: calls 2400
*** RIVER *** [9s Ac Jh 5h] [2s]
dfcastro.net: bets 12000
Orkaanstorm: raises 14583 to 26583 and is all-in
dfcastro.net: calls 14583
*** SHOW DOWN ***
Orkaanstorm: shows [As 2h] (two pair, Aces and Deuces)
dfcastro.net: shows [5d 5s] (three of a kind, Fives)
dfcastro.net collected 62916 from pot
Orkaanstorm finished the tournament in 2nd place and received $2.22.
dfcastro.net wins the tournament and receives $3.23 - congratulations!
*** SUMMARY ***
Total pot 62916 | Rake 0 
Board [9s Ac Jh 5h 2s]
Seat 3: dfcastro.net (big blind) showed [5d 5s] and won (62916) with three of a kind, Fives
Seat 7: Orkaanstorm (button) (small blind) showed [As 2h] and lost with two pair, Aces and Deuces



